Merge Date,Time to Integration (days),Number of Commits,Total Additions,Total Deletions,Total Lines Changed
2024-05-07 18:20:49,0.1675,1,19,4,23
2024-05-07 08:46:56,0.009594907407407408,1,9,51,60
2024-05-07 08:46:56,0.020925925925925924,1,1,1,2
2024-05-07 09:41:30,0.21917824074074074,1,338,34,372
2024-05-07 12:48:43,0.3735763888888889,1,3,3,6
2024-05-07 09:41:30,0.5077083333333333,1,1,1,2
2024-05-07 09:41:30,0.5079513888888889,1,2,2,4
2024-05-06 17:19:56,0.16288194444444445,1,15,29,44
2024-05-06 12:52:50,0.02011574074074074,1,5,1,6
2024-05-06 08:51:49,0.2389699074074074,1,51,51,102
2024-05-06 08:51:49,0.3490625,1,40,15,55
2024-05-06 08:51:49,0.3493865740740741,1,15,15,30
2024-05-06 08:31:40,0.7862731481481482,1,2,2,4
2024-05-06 08:31:40,1.0827199074074074,1,14,14,28
2024-05-05 02:29:41,0.09746527777777778,1,1,1,2
2024-05-06 08:31:40,1.4326736111111111,1,188,188,376
2024-05-06 08:41:59,0.17800925925925926,1,807,19,826
2024-05-06 12:46:41,2.9307523148148147,3,27,16,43
2024-05-03 15:02:21,0.049895833333333334,1,1,26,27
2024-05-06 09:57:54,2.9000694444444446,2,44,2,46
2024-05-03 09:20:33,0.20488425925925927,1,116,0,116
2024-05-03 08:53:41,0.36471064814814813,1,3,3,6
2024-05-06 11:56:16,3.681377314814815,3,25,25,50
2024-05-02 21:27:46,0.10516203703703704,1,2,2,4
2024-05-03 09:27:55,0.7673958333333334,2,18,2,20
2024-05-02 08:06:14,0.10976851851851852,1,3,6,9
2024-05-02 08:33:19,0.657337962962963,1,3,3,6
2024-05-06 13:37:10,4.977118055555556,1,1,1,2
2024-05-02 09:02:58,0.0234375,1,334,0,334
2024-05-02 08:20:16,1.430787037037037,1,3,3,6
2024-05-02 08:33:19,1.4755787037037038,1,4,4,8
2024-05-02 08:20:16,1.5882407407407408,1,1,1,2
2024-05-02 08:33:19,1.7239699074074073,3,24,11,35
2024-04-30 23:45:00,0.40649305555555554,1,1,1,2
2024-04-30 09:11:04,0.019756944444444445,1,139,3,142
2024-04-30 08:53:12,0.47087962962962965,1,2,0,2
2024-04-30 08:53:12,0.5656712962962963,1,145,145,290
2024-04-30 08:53:12,0.6610185185185186,1,6,6,12
2024-04-30 13:06:10,0.9311689814814815,1,4,4,8
2024-04-29 17:36:41,0.13497685185185185,1,0,1,1
2024-05-02 21:01:53,3.299560185185185,1,46,4,50
2024-05-02 09:45:37,2.8393171296296296,1,4,10,14
2024-04-29 12:54:33,0.008715277777777778,1,0,1,1
2024-05-02 09:45:37,2.9515625,1,1,0,1
2024-05-03 09:27:55,5.714675925925926,2,2,2,4
2024-04-29 08:15:29,0.18275462962962963,1,1,1,2
2024-04-29 08:10:06,0.1790972222222222,1,1,1,2
2024-04-29 08:10:06,0.29041666666666666,1,51,51,102
2024-04-29 08:10:06,0.29083333333333333,1,32,32,64
2024-04-29 08:28:34,0.6840393518518518,3,70,64,134
2024-05-02 12:07:36,3.836145833333333,2,274,196,470
2024-04-29 08:08:14,0.677974537037037,1,32,13,45
2024-04-29 09:35:21,0.9366666666666666,1,1,5,6
2024-04-29 15:54:05,1.3841435185185185,1,3,3,6
2024-04-29 08:10:06,1.062326388888889,1,2,2,4
2024-04-29 08:10:06,1.150474537037037,1,2,2,4
2024-04-29 08:21:29,0.16392361111111112,1,303,253,556
2024-04-26 17:16:43,0.04038194444444444,1,7,4,11
2024-04-29 09:04:50,5.530358796296296,2,4,2,6
2024-04-29 09:04:50,5.525787037037037,3,6,3,9
2024-04-29 10:00:53,33.655590277777776,1,3,1,4
2024-04-29 10:00:53,2.859421296296296,4,68,81,149
2024-04-26 13:24:19,0.026747685185185187,1,9,2,11
2024-04-26 12:47:35,0.02712962962962963,1,13,2,15
2024-04-26 15:38:10,0.18563657407407408,1,4,2,6
2024-04-29 09:51:28,3.0105671296296297,2,17,11,28
2024-04-26 10:10:49,0.24002314814814815,1,212,4,216
2024-04-29 09:04:50,3.4293518518518518,1,6,6,12
2024-04-29 09:15:43,3.746412037037037,1,2,2,4
2024-04-29 09:35:21,3.7621527777777777,1,13,14,27
2024-04-29 09:04:50,3.7783564814814814,1,0,1,1
2024-04-29 09:35:20,3.7700347222222224,1,13,14,27
2024-04-25 17:31:37,0.21307870370370371,3,192,25,217
2024-04-29 12:37:38,3.962476851851852,1,2,10,12
2024-04-25 08:56:26,0.18846064814814814,1,29,8,37
2024-04-26 15:38:10,0.03212962962962963,1,163,163,326
2024-04-26 15:38:10,0.47248842592592594,1,1,1,2
2024-04-25 16:30:53,0.7656597222222222,1,175,5,180
2024-04-26 14:55:26,1.9930671296296296,1,32,11,43
2024-04-24 08:50:44,0.1844097222222222,1,157,31,188
2024-04-24 08:50:45,0.2487962962962963,1,150,136,286
2024-04-30 09:17:43,0.015625,1,197,164,361
2024-04-24 09:02:00,0.5702662037037037,7,21,7,28
2024-04-24 08:37:49,0.5886574074074075,1,5,13,18
2024-05-06 15:10:44,13.035127314814815,14,2565,1499,4064
2024-04-23 16:49:02,0.8917592592592593,1,2,2,4
2024-04-24 08:26:13,0.8145486111111111,1,6,6,12
2024-04-23 13:00:22,0.14166666666666666,1,2,2,4
2024-04-23 09:12:31,0.19945601851851852,1,86,1,87
2024-04-23 08:47:04,0.5649189814814815,1,1,1,2
2024-04-23 08:47:04,0.6943171296296297,1,8,8,16
2024-04-22 14:07:56,0.020104166666666666,1,2,0,2
2024-04-22 14:07:56,0.2082638888888889,2,6,14,20
2024-04-22 08:18:37,0.20856481481481481,1,85,76,161
2024-04-22 08:18:37,0.3171875,1,1,1,2
2024-04-22 08:18:37,0.3172800925925926,1,3,3,6
2024-04-22 08:58:34,0.4874074074074074,2,41,38,79
2024-04-22 09:05:33,0.5169097222222222,1,6,5,11
2024-04-22 08:29:32,0.6718055555555555,1,82,82,164
2024-04-24 09:14:53,3.3740625,3,3,3,6
2024-04-22 08:48:07,0.01238425925925926,1,344,15,359
2024-04-22 09:05:33,2.4992592592592593,2,2,2,4
2024-04-22 09:05:33,2.4967939814814817,1,2,2,4
2024-04-19 20:57:13,0.01605324074074074,1,0,35,35
2024-04-22 08:36:09,2.506099537037037,1,5,5,10
2024-04-22 08:36:09,2.5201504629629627,1,0,2,2
2024-04-19 20:37:31,0.02494212962962963,1,3,10,13
2024-04-19 20:37:31,0.035625,1,8,20,28
2024-04-19 20:57:13,0.058194444444444444,1,3,11,14
2024-04-19 20:43:12,0.04710648148148148,1,2,9,11
2024-04-19 20:37:31,0.028923611111111112,1,1,0,1
2024-04-19 19:50:22,0.06875,1,1,1,2
2024-04-19 19:50:22,0.23695601851851852,1,1,1,2
2024-04-19 19:50:22,1.142037037037037,17,18,18,36
2024-04-19 14:03:04,0.4016898148148148,1,39,9,48
2024-04-18 16:29:41,0.11454861111111111,1,8,8,16
2024-04-18 11:23:57,0.2909027777777778,1,203,2,205
2024-04-17 21:57:53,0.16152777777777777,1,3,3,6
2024-04-18 10:19:07,139.83219907407408,3,10,10,20
2024-04-17 11:19:11,0.06011574074074074,1,3,3,6
2024-04-17 09:08:25,0.19621527777777778,1,186,63,249
2024-04-17 09:08:25,0.4441898148148148,1,3,3,6
2024-04-17 09:08:25,0.5422106481481481,1,3,3,6
2024-04-17 08:36:29,0.5203935185185186,1,5,5,10
2024-04-17 11:19:11,0.8349768518518519,1,1,1,2
2024-04-16 09:03:37,0.013506944444444445,1,1,1,2
2024-04-16 17:35:45,0.38069444444444445,1,3,1,4
2024-04-16 08:50:47,0.02210648148148148,1,3,3,6
2024-04-16 08:41:49,0.17832175925925925,1,124,14,138
2024-04-16 09:22:23,0.6630555555555555,1,4,3,7
2024-04-16 13:22:26,0.8288888888888889,1,9,8,17
2024-04-15 07:28:13,0.17168981481481482,1,3,3,6
2024-04-15 07:28:13,0.17208333333333334,1,1,1,2
2024-04-15 07:33:32,0.20407407407407407,1,6,6,12
2024-04-15 07:28:13,0.20072916666666665,1,9,9,18
2024-04-15 07:28:13,0.5265856481481481,1,3,3,6
2024-04-15 09:35:10,0.015196759259259259,1,40,3,43
2024-04-15 09:20:45,2.7549189814814814,1,4,5,9
2024-04-26 14:55:26,14.019699074074074,1,3,0,3
2024-04-17 10:28:38,4.83255787037037,1,1,1,2
2024-04-15 09:20:45,2.774236111111111,1,2,7,9
2024-04-15 15:30:03,3.1021875,3,11,18,29
2024-04-15 09:10:51,2.9082986111111113,1,7,4,11
2024-04-15 09:10:51,2.9694560185185184,1,2,2,4
2024-04-15 12:02:20,3.144351851851852,1,7,2,9
2024-04-16 09:30:25,4.047280092592593,1,2,2,4
2024-04-12 09:43:38,0.07202546296296296,1,2,2,4
2024-04-12 08:25:19,0.1661226851851852,1,97,10,107
2024-04-12 11:02:22,0.4709837962962963,1,3,3,6
2024-04-11 23:42:21,0.06555555555555556,1,10,4,14
2024-04-12 09:43:38,0.6921643518518519,1,292,60,352
2024-04-12 09:24:13,0.6782638888888889,1,137,28,165
2024-04-12 09:43:38,0.6979398148148148,1,8,8,16
2024-04-12 09:09:47,0.7187037037037037,1,2,3,5
2024-04-12 09:53:45,0.8077546296296296,1,3,4,7
2024-04-12 09:53:45,0.8469097222222223,1,11,9,20
2024-04-11 10:35:33,0.25774305555555554,1,13,13,26
2024-04-11 08:56:05,0.49372685185185183,1,1,1,2
2024-04-16 09:30:25,83.41729166666667,1,5,2,7
2024-04-11 09:04:33,0.6170601851851852,1,2,2,4
2024-04-16 09:49:34,1.0963425925925927,1,21,82,103
2024-04-11 09:04:33,0.8456944444444444,1,2,2,4
2024-04-10 13:09:01,0.3642476851851852,1,2,2,4
2024-04-10 12:52:04,0.9301157407407408,1,2,4,6
2024-04-10 12:52:04,0.9302314814814815,1,2,4,6
2024-04-08 13:50:15,0.2032986111111111,1,2,1,3
2024-04-12 11:02:22,1.5244212962962962,1,1,1,2
2024-04-08 08:22:37,0.18430555555555556,1,6,6,12
2024-04-08 08:17:11,0.18081018518518518,1,4,4,8
2024-04-08 14:14:04,0.5395023148148148,1,6,6,12
2024-04-08 08:17:11,0.29204861111111113,1,6,6,12
2024-04-08 08:22:37,1.5753935185185186,1,1,1,2
2024-04-08 08:17:10,1.745798611111111,1,5,5,10
2024-04-08 08:17:11,2.0087152777777777,1,3,3,6
2024-04-08 13:50:15,2.988148148148148,3,18,90,108
2024-04-08 13:50:15,0.39262731481481483,1,94,30,124
2024-04-05 08:02:52,0.24561342592592592,1,2,2,4
2024-04-05 08:02:52,0.6652199074074074,1,3,1,4
2024-04-05 08:12:02,0.6725347222222222,1,24,0,24
2024-04-04 16:12:49,0.08560185185185185,1,12,0,12
2024-04-05 07:53:25,0.8641087962962963,1,6,0,6
2024-04-04 07:36:57,0.12038194444444444,1,2,2,4
2024-04-04 07:29:21,0.2576967592592593,1,3,3,6
2024-04-03 21:15:25,0.024826388888888887,1,2,2,4
2024-04-04 16:18:42,0.8286921296296297,1,3,6,9
2024-04-05 08:59:45,1.5791550925925926,1,16,3,19
2024-04-04 11:38:35,0.6917939814814815,1,2,2,4
2024-04-04 07:29:21,0.5526851851851852,1,57,44,101
2024-04-04 11:56:35,0.8844907407407407,5,8,7,15
2024-04-05 07:53:26,6.810578703703704,2,29,0,29
2024-04-05 16:57:37,2.3582175925925926,2,17,17,34
2024-04-03 09:10:01,0.19766203703703702,1,117,4,121
2024-04-02 21:39:16,0.006273148148148148,1,5,5,10
2024-04-03 15:24:41,0.803587962962963,1,1,2,3
2024-04-17 09:24:19,14.696631944444444,1,53,2,55
2024-04-02 20:02:25,0.15802083333333333,1,2,4,6
2024-04-02 15:53:12,0.025439814814814814,1,1,1,2
2024-04-03 14:28:20,0.9757870370370371,6,9,10,19
2024-04-02 14:07:18,0.053703703703703705,1,2,1,3
2024-04-02 12:19:14,0.02230324074074074,1,8,8,16
2024-04-02 10:08:55,0.02431712962962963,1,1,1,2
2024-04-02 09:20:55,0.5686226851851852,1,1,1,2
2024-04-03 18:11:11,1.8153703703703703,2,63,61,124
2024-04-02 09:04:13,1.3755671296296297,1,7,7,14
2024-04-02 09:04:13,1.3758796296296296,1,6,14,20
2024-04-02 09:04:13,1.4995601851851852,1,3,3,6
2024-04-02 08:59:07,1.703148148148148,1,138,138,276
2024-04-02 21:27:54,0.01287037037037037,1,3,3,6
2024-04-02 08:59:07,2.4317361111111113,1,18,34,52
2024-04-02 09:31:19,0.2127199074074074,1,355,83,438
2024-04-02 10:08:55,3.5149189814814816,1,11,11,22
2024-03-29 21:09:00,0.08184027777777778,1,1,1,2
2024-04-02 09:20:55,3.6660185185185186,4,17,10,27
2024-04-02 09:40:09,3.6923958333333333,3,10,7,17
2024-04-02 17:05:39,0.22087962962962962,1,2,2,4
2024-03-29 17:22:20,0.03505787037037037,1,1,1,2
2024-04-05 09:58:16,6.738414351851852,1,123,14,137
2024-04-02 10:01:24,3.9064814814814817,1,4,2,6
2024-03-29 13:36:06,0.08260416666666667,1,1,1,2
2024-03-29 13:41:37,0.386712962962963,1,98,5,103
2024-03-29 13:36:06,0.6252314814814814,1,7,2,9
2024-04-05 09:09:42,7.4605902777777775,1,2,2,4
2024-04-02 10:08:54,4.5584375,1,143,1,144
2024-03-29 14:03:03,0.737025462962963,1,28,7,35
2024-03-29 13:36:06,0.7577314814814815,1,17,17,34
2024-03-28 14:06:21,0.20414351851851853,1,7,1,8
2024-03-28 10:10:47,0.09650462962962963,1,3,3,6
2024-03-28 14:53:33,0.43668981481481484,1,22,2,24
2024-03-28 10:10:47,0.7012152777777778,1,8,7,15
2024-03-28 10:10:47,0.7048958333333334,1,9,8,17
2024-03-27 16:37:07,0.023275462962962963,1,1,0,1
2024-03-27 15:54:23,0.013125,1,4,2,6
2024-04-02 08:59:07,5.730416666666667,2,1,2,3
2024-04-08 13:59:09,12.78125,1,45,11,56
2024-03-28 15:38:49,1.121585648148148,1,175,198,373
2024-03-27 21:24:26,0.20921296296296296,1,146,27,173
2024-03-27 10:00:00,0.26927083333333335,1,3,3,6
2024-03-27 10:00:00,0.46019675925925924,1,1,1,2
2024-03-27 14:13:19,0.8498842592592593,1,3,1,4
2024-03-27 10:00:00,0.6481712962962963,1,1,1,2
2024-03-28 10:59:31,1.6640277777777779,1,1,1,2
2024-03-27 10:00:00,0.7466435185185185,1,3,3,6
2024-03-26 23:19:42,0.329849537037037,1,23,24,47
2024-03-28 10:59:31,1.8609143518518518,1,8,10,18
2024-04-03 20:16:31,8.255960648148148,1,8,10,18
2024-03-26 16:02:40,0.08974537037037036,1,3,4,7
2024-03-26 14:50:35,0.04818287037037037,1,1,1,2
2024-03-26 09:54:33,0.22871527777777778,1,171,254,425
2024-03-26 09:31:40,0.23824074074074075,1,1,1,2
2024-03-26 09:28:04,0.45925925925925926,1,13,13,26
2024-03-26 16:02:40,0.9116435185185185,2,71,67,138
2024-03-26 09:28:04,0.7527777777777778,1,3,3,6
2024-03-26 09:38:18,0.8042824074074074,1,0,6,6
2024-03-26 09:28:04,504.0056134259259,7,123,90,213
2024-03-25 12:20:10,0.3514351851851852,1,47,32,79
2024-03-26 09:28:04,1.2322800925925925,1,1,1,2
2024-03-25 11:09:11,0.39663194444444444,1,6,6,12
2024-03-25 11:09:11,0.021944444444444444,1,9,9,18
2024-03-26 09:31:40,1.6235648148148147,1,4,2,6
2024-03-26 09:31:40,1.6305439814814815,1,5,3,8
2024-03-24 14:22:19,0.0711574074074074,1,14,1,15
2024-03-25 11:09:11,1.2995949074074074,1,11,11,22
2024-03-25 12:50:02,1.415925925925926,1,11,5,16
2024-03-25 13:32:50,1.5497222222222222,1,80,61,141
2024-03-25 11:09:11,0.2800925925925926,1,265,56,321
2024-03-22 16:22:55,0.0027430555555555554,1,9,5,14
2024-03-26 09:31:40,3.741111111111111,23,29,30,59
2024-03-26 13:14:52,3.9157175925925927,1,1,1,2
2024-03-22 15:49:52,0.113125,1,30,8,38
2024-03-22 15:49:51,0.12739583333333335,1,4,2,6
2024-04-05 09:23:06,14.107314814814815,1,1,0,1
2024-03-22 14:55:14,0.018900462962962963,1,438,77,515
2024-03-22 12:05:07,0.5686226851851852,1,4,3,7
2024-03-25 13:44:25,3.655949074074074,1,27,17,44
2024-03-21 21:54:00,0.14105324074074074,1,3,0,3
2024-03-26 13:14:52,4.812939814814815,1,6,2,8
2024-04-15 10:24:29,24.72795138888889,6,9,6,15
2024-03-21 18:12:04,0.05865740740740741,1,1,1,2
2024-03-21 21:54:00,0.23244212962962962,1,1,23,24
2024-03-21 21:54:00,0.2484837962962963,2,65,4,69
2024-03-21 16:52:11,0.04627314814814815,1,26,10,36
2024-03-21 14:17:58,0.029594907407407407,1,1,0,1
2024-04-05 09:23:06,14.827407407407408,1,21,24,45
2024-03-22 16:22:55,1.1676041666666668,1,25,0,25
2024-03-21 14:17:58,0.08810185185185185,1,1,0,1
2024-03-21 17:44:55,0.022928240740740742,1,12,13,25
2024-03-21 18:12:04,0.008344907407407407,1,7,7,14
2024-03-21 10:11:46,0.01275462962962963,1,1,3,4
2024-03-22 16:29:40,1.315925925925926,3,32,29,61
2024-03-21 10:03:14,0.23431712962962964,1,519,67,586
2024-03-21 10:46:04,0.3059027777777778,1,1,1,2
2024-03-21 08:32:43,0.21347222222222223,1,3,3,6
2024-03-21 08:32:43,0.3045717592592593,1,8,8,16
2024-03-21 10:46:04,0.39751157407407406,1,3,3,6
2024-03-21 08:32:43,0.521099537037037,1,3,3,6
2024-03-21 08:32:43,0.5256018518518518,1,1,1,2
2024-04-10 09:25:54,20.577094907407407,1,0,1,1
2024-03-20 22:16:14,0.13,1,0,2,2
2024-03-20 22:16:14,0.1322800925925926,1,2,0,2
2024-03-21 08:42:07,0.5708101851851852,1,8,7,15
2024-03-22 14:49:04,1.9031597222222223,1,3,2,5
2024-03-21 08:32:43,0.6293055555555556,1,2,1,3
2024-03-20 17:20:25,0.007442129629629629,1,7,1,8
2024-03-20 17:26:34,0.015462962962962963,1,10,15,25
2024-03-20 17:07:41,0.016296296296296295,2,3,3,6
2024-03-20 16:53:57,0.011979166666666667,1,10,3,13
2024-03-20 16:14:05,0.012523148148148148,1,8,4,12
2024-03-21 10:46:04,0.3968055555555556,1,8,8,16
2024-03-21 10:51:35,0.7908564814814815,1,6,6,12
2024-03-20 15:49:48,0.04400462962962963,1,50,85,135
2024-03-20 15:49:48,0.09047453703703703,1,40,75,115
2024-03-20 11:25:35,0.016435185185185185,1,1,7,8
2024-03-20 11:07:19,0.11152777777777778,2,18,8,26
2024-03-20 08:44:49,0.17982638888888888,1,243,103,346
2024-03-20 08:24:40,0.5232060185185186,1,8,8,16
2024-03-20 11:07:20,0.07840277777777778,4,858,3,861
2024-03-20 11:07:19,0.8393287037037037,1,5,15,20
2024-03-19 15:44:47,0.0540625,1,8,9,17
2024-03-20 11:07:19,0.8727083333333333,1,7,2,9
2024-03-20 13:51:07,0.9901157407407407,1,162,27,189
2024-03-20 13:37:03,0.9811921296296297,1,2,1,3
2024-03-19 13:45:02,0.026157407407407407,1,1,0,1
2024-03-19 14:22:49,0.0587962962962963,1,3,14,17
2024-03-19 13:45:02,0.032789351851851854,1,2,2,4
2024-03-19 13:06:11,0.019270833333333334,1,500,500,1000
2024-03-22 16:22:55,3.278020833333333,1,2,1,3
2024-03-19 09:17:10,0.17325231481481482,1,3,3,6
2024-03-19 08:42:25,0.17875,1,54,3,57
2024-03-19 08:23:36,0.23472222222222222,1,1,1,2
2024-04-02 14:12:38,14.844710648148148,2,10,6,16
2024-03-19 08:23:36,0.6555439814814815,1,11,2,13
2024-04-02 15:53:12,14.96800925925926,2,2,2,4
2024-03-18 10:00:22,0.024618055555555556,1,3,36,39
2024-03-18 10:07:28,0.29355324074074074,1,6,6,12
2024-03-18 08:49:27,0.2397337962962963,1,9,9,18
2024-03-18 08:49:27,0.35609953703703706,1,1,1,2
2024-03-18 08:49:27,0.35618055555555556,1,1,1,2
2024-03-18 08:54:51,0.39241898148148147,1,8,8,16
2024-03-18 09:38:55,1.5636574074074074,1,3,3,6
2024-03-18 08:49:27,0.18409722222222222,1,1533,800,2333
2024-03-18 08:54:51,2.4191203703703703,1,1,1,2
2024-03-21 10:40:14,5.606284722222222,1,16,0,16
2024-03-18 09:00:01,2.5611805555555556,2,0,163,163
2024-03-18 13:02:52,2.7312037037037036,1,35,14,49
2024-03-18 09:00:01,2.5723842592592594,1,1,35,36
2024-03-18 13:30:30,2.76255787037037,1,0,28,28
2024-03-18 09:20:28,2.629328703703704,1,7,7,14
2024-03-15 19:14:24,0.08399305555555556,3,55,14,69
2024-03-18 09:20:28,2.6502314814814816,1,8,8,16
2024-03-19 09:08:47,3.695925925925926,3,13,1,14
2024-03-15 16:12:01,0.012314814814814815,1,2,2,4
2024-04-22 12:27:48,37.86908564814815,2,58,112,170
2024-04-19 14:03:04,34.94967592592592,2,40,63,103
2024-03-16 16:43:39,1.098287037037037,1,5,3,8
2024-03-18 10:17:05,2.8459837962962964,1,4,128,132
2024-03-16 01:17:31,0.6384143518518518,1,1,1,2
2024-03-18 09:38:55,3.0091782407407406,1,1,1,2
2024-03-15 10:07:26,0.23751157407407408,1,259,122,381
2024-03-15 13:14:05,0.8200925925925926,3,237,16,253
2024-03-15 09:36:57,0.5539930555555556,1,19,4,23
2024-03-26 13:26:31,11.741527777777778,1,4,2,6
2024-03-22 15:13:53,7.882337962962963,1,32,6,38
2024-03-15 10:23:17,0.7217708333333334,1,67,46,113
2024-03-19 08:23:36,4.7359837962962965,1,22,0,22
2024-03-14 14:02:31,0.019918981481481482,1,0,1,1
2024-03-14 09:36:31,0.016030092592592592,1,6,0,6
2024-03-14 09:03:46,0.19408564814814816,1,42,6,48
2024-03-15 11:47:14,1.5710300925925926,1,3,3,6
2024-03-14 09:18:59,0.4817708333333333,1,65,60,125
2024-03-14 09:12:29,0.4821875,1,7,23,30
2024-03-14 09:18:59,0.5349884259259259,1,8,6,14
2024-03-14 09:18:59,0.5371412037037037,1,10,8,18
2024-03-14 09:18:59,0.5436805555555555,1,7,5,12
2024-03-14 09:18:59,0.5502083333333333,1,4,2,6
2024-03-14 09:03:46,0.5475694444444444,1,17,0,17
2024-03-14 15:27:53,0.8196296296296296,1,17,1,18
2024-03-15 17:41:53,3.803402777777778,1,632,361,993
2024-03-14 09:03:46,0.8993981481481481,1,1,1,2
2024-03-14 09:12:29,0.7138888888888889,1,104,81,185
2024-03-13 16:53:21,0.08771990740740741,1,65,29,94
2024-03-13 15:47:55,0.0593287037037037,1,8,0,8
2024-03-26 14:50:35,13.045775462962963,4,21,15,36
2024-03-13 13:00:22,0.04590277777777778,1,4,4,8
2024-03-13 10:41:21,0.01150462962962963,1,35,13,48
2024-03-13 10:23:26,0.02966435185185185,1,8,0,8
2024-03-22 16:22:55,0.02665509259259259,1,1,1,2
2024-03-13 12:47:57,0.3493287037037037,1,208,20,228
2024-03-15 10:45:24,2.6753472222222223,3,11,17,28
2024-03-13 14:16:53,0.8691666666666666,3,15,14,29
2024-03-12 09:45:38,0.008402777777777778,1,2,2,4
2024-03-21 18:12:04,0.017280092592592593,1,3,3,6
2024-03-12 09:45:38,0.09372685185185185,1,2,2,4
2024-03-12 09:09:02,0.1963888888888889,1,404,333,737
2024-03-13 11:50:48,1.4747453703703703,3,14,5,19
2024-03-18 10:00:22,6.45650462962963,1,6,6,12
2024-03-14 10:07:24,2.5714004629629628,1,2,2,4
2024-03-12 08:43:57,0.6914699074074074,6,44,22,66
2024-03-11 15:20:17,0.8718865740740741,1,12,14,26
2024-03-11 08:53:40,0.34185185185185185,1,3,3,6
2024-03-11 08:53:40,0.34247685185185184,1,6,6,12
2024-03-11 09:02:26,0.8234606481481481,1,29,4,33
2024-03-11 13:40:41,1.1019097222222223,1,95,123,218
2024-03-11 14:39:09,2.991064814814815,1,6,13,19
2024-03-11 09:02:26,2.7609837962962964,1,3,6,9
2024-03-11 09:33:31,3.049328703703704,2,52,8,60
2024-03-08 09:15:12,0.11876157407407407,1,3,0,3
2024-03-11 08:53:40,3.1640972222222223,1,1,1,2
2024-03-11 09:18:54,3.4556828703703704,2,67,23,90
2024-03-12 09:56:48,6.3521527777777775,1,147,233,380
2024-03-07 11:16:45,0.11421296296296296,1,1,1,2
2024-03-18 14:14:50,11.116458333333334,1,2,2,4
2024-03-12 13:14:43,5.6570023148148145,1,15,3,18
2024-03-11 08:53:40,4.557222222222222,1,6,6,12
2024-03-18 10:00:22,11.71454861111111,1,153,152,305
2024-03-19 15:44:47,13.751018518518519,2,32,30,62
2024-03-05 09:43:06,0.35777777777777775,1,2,2,4
2024-03-05 14:09:52,0.18707175925925926,1,1,1,2
2024-03-05 09:43:06,0.6637847222222222,1,393,332,725
2024-03-05 09:43:05,1.3643055555555557,1,1,1,2
2024-03-05 09:43:05,0.01638888888888889,1,6,6,12
2024-03-15 13:21:56,12.119479166666666,2,351,174,525
2024-03-19 16:16:19,15.952858796296296,1,28,29,57
2024-04-02 13:52:25,30.738993055555557,2,9,8,17
2024-03-11 09:18:54,8.972962962962963,1,8,6,14
2024-03-11 15:51:33,9.731481481481481,2,65,43,108
2024-03-07 17:39:19,0.017291666666666667,1,1,1,2
2024-03-11 09:10:31,9.69326388888889,1,9,9,18
2024-03-13 15:47:55,12.035532407407407,1,29,29,58
2024-03-01 14:56:33,0.0992013888888889,1,47,3,50
2024-03-01 10:22:07,0.016435185185185185,1,10,10,20
2024-03-11 07:42:16,0.13701388888888888,1,3437,1451,4888
2024-03-01 11:10:27,0.5236574074074074,1,5,4,9
2024-02-29 23:30:12,0.12104166666666667,2,2,4,6
2024-03-15 09:05:50,14.558564814814815,1,0,4,4
2024-03-15 14:31:30,14.809965277777778,2,20,1,21
2024-03-18 10:00:22,17.634618055555556,1,3,3,6
2024-03-01 16:23:13,0.9642939814814815,2,68,17,85
2024-02-29 15:21:19,0.05896990740740741,1,18,49,67
2024-02-29 13:54:19,0.11215277777777778,1,5,1,6
2024-02-29 13:54:19,0.14122685185185185,1,1,5,6
2024-02-29 09:51:41,0.22736111111111112,1,23,8,31
2024-02-29 09:51:41,0.4999652777777778,1,4,7,11
2024-02-29 14:27:08,0.7542129629629629,1,47,3,50
2024-04-02 13:59:43,33.81471064814815,1,32,0,32
2024-02-29 10:57:32,0.8273148148148148,1,1,1,2
2024-03-13 08:44:25,15.318900462962963,1,12,11,23
2024-03-26 14:50:35,26.996064814814815,1,12,0,12
2024-02-29 11:13:30,0.8530671296296296,1,11,8,19
2024-03-02 18:37:01,2.134212962962963,1,59,59,118
2024-03-11 15:07:54,3.536377314814815,1,1280,254,1534
2024-02-28 12:19:44,0.32980324074074074,1,78,48,126
2024-02-29 15:21:19,3.731099537037037,3,312,188,500
2024-02-27 15:23:16,0.07743055555555556,1,40,0,40
2024-02-27 14:59:04,0.4405787037037037,1,51,38,89
2024-02-27 11:50:38,0.45971064814814816,1,1,1,2
2024-02-26 22:48:39,0.035555555555555556,1,1,1,2
2024-02-27 11:50:38,0.5733217592592592,1,9,48,57
2024-02-28 12:06:51,4.085011574074074,3,6,6,12
2024-03-13 09:02:01,15.558101851851852,1,10,10,20
2024-02-27 11:57:44,0.677349537037037,1,1,1,2
2024-02-27 16:26:02,0.859525462962963,1,2,2,4
2024-03-14 21:26:32,17.081712962962964,1,1,1,2
2024-02-27 16:26:02,1.0006944444444446,1,6,7,13
2024-02-26 16:32:13,0.027233796296296298,1,1,1,2
2024-02-29 13:53:03,2.9136458333333333,1,10,3,13
2024-02-26 15:31:15,0.0931712962962963,1,0,22,22
2024-02-27 11:46:29,1.0081481481481482,5,226,217,443
2024-02-26 12:52:19,0.4943402777777778,1,6,6,12
2024-03-12 17:15:59,15.871851851851853,1,9,6,15
2024-04-17 08:28:56,52.58005787037037,1,18,32,50
2024-02-26 12:52:19,0.7739930555555555,1,1,1,2
2024-02-27 10:48:59,1.831435185185185,1,2,0,2
2024-02-26 15:31:15,1.0583796296296297,1,3,3,6
2024-02-26 12:42:24,1.5211458333333334,1,1,1,2
2024-02-27 15:04:52,2.7107407407407407,2,68,81,149
2024-02-26 13:51:11,1.8869328703703703,1,37,4,41
2024-02-26 12:42:24,1.9611805555555555,1,82,82,164
2024-02-26 00:58:05,1.6205902777777779,1,4,1,5
2024-02-26 13:08:26,0.01775462962962963,1,268,230,498
2024-02-23 19:10:29,0.05386574074074074,1,1,0,1
2024-02-27 10:48:59,3.797465277777778,1,1,1,2
2024-03-22 16:29:40,28.23375,1,46,77,123
2024-02-23 15:37:23,0.2635416666666667,1,28,20,48
2024-02-23 15:26:12,0.4595138888888889,1,148,26,174
2024-02-27 15:47:09,4.7220254629629625,3,41,35,76
2024-02-22 21:35:31,0.004039351851851852,1,32,25,57
2024-03-07 14:58:41,14.654189814814815,1,1092,243,1335
2024-02-22 21:32:00,0.07613425925925926,1,11,7,18
2024-02-22 21:35:31,0.1830324074074074,1,6,6,12
2024-02-22 17:37:06,0.019849537037037037,1,8,7,15
2024-02-22 14:57:32,0.014618055555555556,1,1,1,2
2024-02-22 10:38:07,0.2595601851851852,1,54,0,54
2024-02-22 10:38:07,0.5206481481481482,1,55,55,110
2024-02-22 10:38:07,0.5538310185185186,1,1,1,2
2024-02-21 21:31:28,0.0038310185185185183,1,3,3,6
2024-02-21 21:23:13,0.10212962962962963,1,1747,1747,3494
2024-02-22 09:03:20,0.34877314814814814,3,8,11,19
2024-02-22 21:27:25,1.1977777777777778,2,33,5,38
2024-02-22 10:40:23,0.7611111111111111,1,40,0,40
2024-02-22 10:40:23,0.7481944444444445,1,30,0,30
2024-02-22 10:48:26,1.6922453703703704,1,30,0,30
2024-02-22 10:48:26,1.6774189814814815,1,46,0,46
2024-02-22 10:51:20,1.6589351851851852,1,36,0,36
2024-02-22 10:51:21,1.6328125,1,37,0,37
2024-02-22 10:58:49,1.6256365740740741,1,28,0,28
2024-02-21 17:13:23,0.8587731481481482,1,24,0,24
2024-02-21 17:13:23,0.8341898148148148,1,40,0,40
2024-02-21 16:58:34,0.8070601851851852,1,31,0,31
2024-02-21 16:58:34,0.7947685185185185,1,16,0,16
2024-03-13 08:38:36,21.431608796296295,1,21,0,21
2024-02-21 17:50:37,0.2103125,4,112,3,115
2024-02-23 09:59:45,2.127800925925926,1,1,1,2
2024-02-21 11:25:36,0.29234953703703703,1,96,41,137
2024-03-04 06:40:45,12.555104166666666,5,123,50,173
2024-03-20 14:43:39,28.970810185185186,1,4,3,7
2024-03-13 08:44:25,21.743460648148147,1,57,57,114
2024-02-26 16:09:58,6.0473842592592595,3,107,41,148
2024-02-21 11:25:36,0.8579861111111111,1,1,1,2
2024-02-23 09:59:45,2.8086342592592595,1,48,0,48
2024-02-20 09:23:56,0.20667824074074073,1,202,49,251
2024-02-20 09:11:37,0.36900462962962965,1,6,4,10
2024-02-20 09:19:52,0.3859837962962963,1,3,3,6
2024-02-20 09:11:37,0.11436342592592592,1,1,1,2
2024-02-20 10:11:15,0.5361689814814815,1,4,21,25
2024-02-20 10:11:15,0.6510532407407408,1,29,25,54
2024-02-20 09:18:21,0.24555555555555555,1,1,1,2
2024-02-20 09:18:21,0.5771064814814815,1,4,1,5
2024-02-20 09:23:56,0.7947453703703704,1,6,4,10
2024-02-22 13:33:36,3.0653935185185186,3,23,2,25
2024-02-20 09:19:52,0.9322800925925926,1,0,35,35
2024-02-19 13:41:13,0.24372685185185186,1,10,0,10
2024-02-26 16:09:58,7.355011574074074,1,16,5,21
2024-02-19 11:15:18,0.3784837962962963,1,3,3,6
2024-02-19 11:10:01,0.5539120370370371,1,34,7,41
2024-05-06 15:10:44,78.83814814814815,3,52,10,62
2024-04-24 15:02:22,66.90199074074074,1,10,2,12
2024-02-19 11:10:01,1.7932523148148147,2,26,19,45
2024-02-19 13:31:07,0.3794675925925926,1,240,32,272
2024-02-22 09:03:20,0.48311342592592593,1,3,3,6
2024-02-19 13:35:30,2.9044907407407408,1,2,2,4
2024-02-19 16:03:05,3.086053240740741,2,97,47,144
2024-02-16 17:02:44,0.09347222222222222,1,1,1,2
2024-02-16 11:12:01,0.008240740740740741,1,99,4,103
2024-02-28 12:12:23,12.101909722222222,4,32,11,43
2024-02-21 21:31:28,0.002349537037037037,1,3,3,6
2024-02-16 13:51:59,0.8297453703703703,1,14,17,31
2024-02-16 13:44:05,0.8171759259259259,1,25,55,80
2024-02-16 13:01:21,0.7857175925925926,1,8,14,22
2024-02-16 13:01:21,0.7824884259259259,1,11,14,25
2024-02-16 08:17:43,0.6641203703703704,1,1,1,2
2024-02-16 13:00:25,0.9606365740740741,1,9,7,16
2024-02-16 13:00:25,0.9439004629629629,1,26,25,51
2024-02-16 07:58:03,0.71125,1,6,7,13
2024-02-16 07:52:45,0.6993287037037037,1,14,14,28
2024-02-16 07:48:02,0.6941435185185185,1,9,6,15
2024-02-16 14:59:48,1.1780902777777778,1,20,20,40
2024-02-19 13:35:30,4.6875231481481485,1,0,5,5
2024-02-16 07:42:17,1.4512152777777778,1,7,4,11
2024-02-16 07:42:17,1.4430092592592592,1,2,1,3
2024-02-16 14:34:41,1.7544791666666666,1,9,8,17
2024-02-14 21:54:59,0.08334490740740741,1,7,1,8
2024-02-14 16:49:59,0.0661111111111111,1,1,1,2
2024-02-14 15:03:09,0.010821759259259258,1,26,9,35
2024-02-14 14:25:33,0.08269675925925926,1,1,1,2
2024-02-14 12:17:23,0.8061921296296296,1,12,1,13
2024-02-21 21:29:10,0.0013310185185185185,1,3,3,6
2024-02-16 13:00:25,2.098738425925926,1,2,2,4
2024-02-16 07:52:45,0.14469907407407406,1,211,98,309
2024-05-06 13:23:28,82.76123842592592,7,157,20,177
2024-02-21 21:29:10,0.0025462962962962965,1,3,3,6
2024-04-02 13:35:19,0.1727662037037037,1,3,3,6
2024-02-13 17:20:08,0.05167824074074074,2,11,2,13
2024-02-13 18:17:10,0.11085648148148149,1,90,2,92
2024-02-13 13:03:54,0.02803240740740741,1,2,0,2
2024-03-06 12:59:10,22.182743055555555,2,19,9,28
2024-02-13 09:14:08,0.20131944444444444,1,46,1,47
2024-02-22 11:31:57,9.322511574074074,1,1,1,2
2024-02-21 22:11:26,0.02519675925925926,1,94,31,125
2024-02-21 21:27:46,0.0006481481481481481,1,3,3,6
2024-02-13 08:02:12,0.4128587962962963,1,1,1,2
2024-02-13 08:07:55,0.4171875,1,3,3,6
2024-04-19 14:30:46,66.7990162037037,2,4,7,11
2024-02-12 10:21:34,0.28574074074074074,1,1,1,2
2024-02-12 10:21:34,0.3703472222222222,1,61,61,122
2024-02-21 21:27:46,0.0017476851851851852,1,9,9,18
2024-02-12 10:44:59,1.6626157407407407,1,3,3,6
2024-02-12 10:04:19,0.23599537037037038,1,51,22,73
2024-02-09 10:00:41,0.23355324074074074,1,230,46,276
2024-02-08 19:19:15,0.18225694444444446,1,34,0,34
2024-02-12 09:59:18,3.967604166666667,1,1,1,2
2024-02-08 11:45:33,0.07704861111111111,2,0,51,51
2024-02-08 09:48:32,0.22494212962962962,1,95,17,112
2024-02-08 10:03:46,0.3560185185185185,1,1,1,2
2024-02-08 14:32:01,0.8205671296296296,3,52,56,108
2024-02-08 09:54:54,0.6830671296296297,1,3,3,6
2024-02-08 10:03:46,0.6894212962962963,1,1,1,2
2024-02-07 17:30:02,0.03329861111111111,1,19,32,51
2024-02-08 10:03:10,0.7487615740740741,1,42,28,70
2024-02-08 10:03:10,0.7599074074074074,3,22,19,41
2024-02-07 11:57:51,0.07784722222222222,1,3,1,4
2024-02-07 12:15:00,0.12006944444444445,1,4,0,4
2024-02-07 12:44:06,0.34663194444444445,1,190,0,190
2024-02-07 10:59:49,0.5527083333333334,1,4,3,7
2024-02-07 10:59:49,0.6004861111111112,1,24,24,48
2024-02-07 14:54:57,0.8995023148148148,2,40,57,97
2024-02-07 14:54:57,0.9273148148148148,1,6,1,7
2024-02-06 16:47:50,0.03550925925925926,1,62,7,69
2024-02-06 17:15:31,0.19850694444444444,2,41,10,51
2024-02-06 09:24:12,0.2127777777777778,1,1,1,2
2024-02-06 14:41:36,0.013460648148148149,1,1,7,8
2024-03-13 08:27:55,36.50994212962963,2,50,37,87
2024-02-06 09:38:43,0.5731944444444445,1,3,3,6
2024-02-06 13:15:32,0.7664699074074074,7,42,76,118
2024-02-06 13:09:18,0.8216666666666667,1,17,9,26
2024-02-06 12:56:38,0.8275810185185185,1,11,12,23
2024-03-07 11:08:54,30.78335648148148,1,1,0,1
2024-02-06 12:49:57,0.8741435185185186,1,7,2,9
2024-02-06 12:49:57,0.927337962962963,1,14,0,14
2024-02-06 12:43:31,1.254375,1,8,1,9
2024-02-06 09:38:43,1.2373958333333333,1,1,1,2
2024-02-27 16:09:44,5.628472222222222,3,46,46,92
2024-02-06 09:24:12,0.5633449074074074,1,12,12,24
2024-04-23 11:52:28,78.65008101851852,1,17,1,18
2024-02-06 09:30:24,1.9830671296296296,1,1,1,2
2024-02-06 09:33:58,3.7481597222222223,1,7,13,20
2024-02-02 15:56:43,0.10304398148148149,1,1,3,4
2024-02-06 13:33:59,0.008935185185185185,1,1,1,2
2024-02-06 20:53:33,4.5542592592592595,1,2,2,4
2024-02-02 06:39:05,0.05204861111111111,1,1,1,2
2024-02-06 09:33:58,4.426145833333333,1,1,1,2
2024-02-06 15:37:23,4.754363425925926,1,1,0,1
2024-02-06 11:45:36,4.638344907407407,1,82,70,152
2024-02-06 10:01:36,4.6662384259259255,1,1,7,8
2024-02-06 11:34:14,4.866608796296297,4,37,10,47
2024-02-06 11:34:14,4.858402777777778,1,3,3,6
2024-02-01 09:57:12,0.009664351851851851,1,2,0,2
2024-02-01 09:38:19,0.02332175925925926,1,62,0,62
2024-02-01 09:51:43,0.4948611111111111,1,1,0,1
2024-02-06 09:35:38,5.6237615740740745,1,1,1,2
2024-02-07 13:37:27,6.792407407407407,1,2,2,4
2024-02-06 14:59:50,5.9349537037037035,1,12,5,17
2024-02-06 13:33:59,5.879571759259259,1,5,1,6
2024-02-06 13:23:56,5.849027777777778,1,12,1,13
2024-02-06 09:35:38,5.755150462962963,1,15,4,19
2024-02-06 09:35:38,5.804618055555555,1,1,1,2
2024-01-31 17:01:06,0.13934027777777777,1,1,1,2
2024-02-06 12:56:38,0.13746527777777778,1,3,3,6
2024-01-30 15:45:51,0.0840625,1,1,1,2
2024-01-30 17:29:50,0.16931712962962964,1,1,1,2
2024-01-30 18:26:56,0.2259722222222222,1,11,7,18
2024-01-30 13:43:57,0.49346064814814816,1,4,1,5
2024-03-13 09:24:58,43.75976851851852,11,69,126,195
2024-03-13 08:51:27,44.66462962962963,1,2,2,4
2024-03-01 16:29:48,33.0387037037037,2,162,159,321
2024-01-30 15:40:15,0.830474537037037,1,59,119,178
2024-01-30 15:40:15,0.5800694444444444,1,9,6,15
2024-03-13 09:24:58,46.43083333333333,1,6,3,9
2024-01-30 15:39:21,3.5805555555555557,2,15,6,21
2024-04-02 14:07:18,66.50354166666666,1,4,2,6
2024-01-30 15:39:22,3.5653819444444443,2,2,2,4
2024-01-31 12:55:31,3.899722222222222,1,6,6,12
2024-01-31 12:55:31,4.339513888888889,1,2,2,4
2024-02-06 18:52:47,0.0810300925925926,1,1804,716,2520
2024-01-30 15:34:23,3.527210648148148,1,0,4,4
2024-04-02 13:35:19,4.757569444444444,1,2,2,4
2024-01-30 15:34:23,3.8881944444444443,1,11,12,23
2024-03-13 08:51:27,46.617916666666666,1,23,33,56
2024-03-14 09:29:17,47.670081018518516,2,21,2,23
2024-01-26 17:51:26,0.030972222222222224,1,30,50,80
2024-01-26 17:44:16,0.09049768518518518,1,21,66,87
2024-01-26 17:44:16,0.0934837962962963,1,21,66,87
2024-01-26 17:41:55,0.036944444444444446,1,8,13,21
2024-01-26 17:41:55,0.045023148148148145,1,4,8,12
2024-01-26 17:40:56,0.050694444444444445,3,12,18,30
2024-01-26 17:40:56,0.04653935185185185,1,10,11,21
2024-01-26 16:42:38,0.04167824074074074,1,2,10,12
2024-01-26 16:36:26,0.07135416666666666,1,6,10,16
2024-01-26 16:36:26,0.07553240740740741,1,2,8,10
2024-01-26 16:35:36,0.07758101851851852,1,6,8,14
2024-01-26 16:35:36,0.08126157407407407,1,30,102,132
2024-01-26 16:30:47,0.08677083333333334,1,6,8,14
2024-01-26 16:30:47,0.08841435185185186,1,3,13,16
2024-01-26 16:28:14,0.09028935185185186,1,3,6,9
2024-01-26 16:23:00,0.08905092592592592,1,6,24,30
2024-01-26 16:23:00,0.09354166666666666,1,3,14,17
2024-01-30 15:30:55,4.054166666666666,1,3,3,6
2024-02-07 13:37:27,12.012152777777779,2,91,42,133
2024-01-26 14:10:37,0.013541666666666667,1,8,5,13
2024-01-26 14:10:37,0.05099537037037037,1,6,4,10
2024-01-26 16:49:20,0.37938657407407406,1,36,36,72
2024-01-26 09:21:21,0.2050462962962963,1,568,1727,2295
2024-01-26 16:49:20,0.7971180555555556,1,3,3,6
2024-01-26 16:49:20,0.8890625,1,86,86,172
2024-03-14 10:07:24,48.67570601851852,1,6,4,10
2024-01-30 15:30:55,4.9247453703703705,1,1,1,2
2024-01-25 15:28:44,0.031782407407407405,1,9,5,14
2024-04-17 09:05:39,131.43686342592594,2,40,25,65
2024-01-25 12:36:31,0.05672453703703704,1,3,3,6
2024-01-25 11:13:50,0.006273148148148148,1,43,0,43
2024-01-25 11:13:50,0.007418981481481481,1,32,0,32
2024-01-25 10:49:56,0.010266203703703704,1,1,1,2
2024-01-25 13:00:50,0.35712962962962963,1,197,36,233
2024-01-25 12:36:31,0.4805902777777778,1,3,3,6
2024-01-25 13:00:50,0.6344907407407407,1,52,10,62
2024-01-25 12:37:39,0.6153703703703703,1,7,22,29
2024-01-25 12:37:39,0.6970717592592592,1,3,3,6
2024-01-25 13:16:07,0.8547222222222223,2,28,41,69
2024-03-01 12:22:25,37.8171875,4,894,593,1487
2024-01-24 17:35:59,0.24488425925925925,1,3,3,6
2024-02-07 14:16:09,13.973043981481482,1,5,5,10
2024-02-01 13:42:29,8.163020833333333,1,507,138,645
2024-01-24 07:08:49,0.09908564814814814,1,7,1,8
2024-01-24 10:12:24,0.24047453703703703,1,84,1,85
2024-01-24 16:51:53,0.789375,1,3,3,6
2024-01-24 10:33:10,0.7136111111111111,1,16,8,24
2024-01-24 09:58:06,0.7171064814814815,1,3,1,4
2024-01-24 10:33:10,67.85883101851852,1,19,11,30
2024-01-24 09:58:06,0.8130092592592593,1,3,6,9
2024-01-24 11:51:25,0.8885763888888889,1,7,11,18
2024-01-24 15:00:34,1.2829629629629629,1,2,1,3
2024-01-23 10:16:59,0.24344907407407407,1,178,10,188
2024-01-24 13:43:11,0.033344907407407406,1,1,1,2
2024-01-23 09:07:25,0.4584490740740741,1,2,4,6
2024-01-23 11:42:11,0.5650578703703704,1,2,4,6
2024-01-23 09:07:25,0.45652777777777775,1,1,2,3
2024-02-27 16:09:44,35.766875,4,79,366,445
2024-01-23 09:15:37,0.5333564814814815,1,35,1,36
2024-01-23 11:42:11,0.8705902777777778,2,18,18,36
2024-01-23 09:37:21,0.7306018518518519,1,4,4,8
2024-03-13 08:56:53,52.479988425925924,1,52,132,184
2024-01-23 11:50:06,1.4224305555555556,2,48,48,96
2024-01-22 11:08:38,0.3938425925925926,1,3,3,6
2024-01-22 11:17:08,0.5633912037037037,1,27,9,36
2024-01-22 11:08:00,0.8977777777777778,1,8,28,36
2024-01-21 07:50:17,0.07931712962962963,1,18,11,29
2024-01-25 14:40:02,4.390347222222222,3,312,399,711
2024-01-22 11:08:00,1.3776736111111112,1,3,3,6
2024-01-22 11:56:07,0.3125462962962963,1,231,53,284
2024-04-17 09:24:19,88.59265046296296,3,41,31,72
2024-01-22 10:07:57,2.5794675925925925,1,48,41,89
2024-01-22 11:08:39,2.6820601851851853,1,3,3,6
2024-01-19 18:58:06,0.0694212962962963,1,8,1,9
2024-01-22 13:55:54,2.901423611111111,1,101,2,103
2024-01-22 13:55:54,2.934340277777778,3,32,6,38
2024-01-22 12:04:13,2.9282175925925924,2,72,51,123
2024-01-22 11:56:07,2.9239699074074075,1,4,4,8
2024-01-19 12:48:41,0.07320601851851852,2,51,9,60
2024-04-17 10:11:10,88.97652777777778,2,25,8,33
2024-01-19 09:29:16,0.013935185185185186,1,2,3,5
2024-01-19 09:21:25,0.04100694444444444,1,3,3,6
2024-01-19 01:44:51,0.11,2,22,2,24
2024-01-19 09:36:15,0.5047222222222222,4,20,22,42
2024-01-19 09:21:24,0.6090509259259259,1,2,76,78
2024-01-19 09:20:04,0.6536458333333334,1,10,11,21
2024-01-18 16:19:49,0.08148148148148149,1,7,3,10
2024-01-18 16:11:56,0.02065972222222222,1,3,6,9
2024-01-18 16:11:55,0.050208333333333334,1,11,13,24
2024-01-19 12:25:20,2.890949074074074,1,48,0,48
2024-01-19 11:22:39,0.9820023148148148,1,2,2,4
2024-01-18 18:49:33,0.4468171296296296,1,3,3,6
2024-01-19 09:42:11,0.21976851851851853,1,48,1,49
2024-01-18 09:33:29,0.4310763888888889,1,3,3,6
2024-01-18 16:02:35,0.8033217592592593,6,110,43,153
2024-01-18 09:33:29,0.5621990740740741,1,15,15,30
2024-01-18 14:01:15,0.8332523148148148,1,1,2,3
2024-01-18 12:27:45,0.782962962962963,1,5,2,7
2024-01-19 09:36:15,1.6296064814814815,2,8,9,17
2024-01-18 09:37:07,0.6697800925925926,1,13,14,27
2024-01-19 09:20:04,1.6530671296296295,4,22,9,31
2024-01-18 09:37:07,0.7208101851851851,1,4,8,12
2024-01-18 10:11:27,0.7410416666666667,3,17,17,34
2024-01-18 10:11:27,0.7359375,10,37,44,81
2024-01-17 16:33:22,0.017395833333333333,1,11,13,24
2024-01-18 12:29:58,5.887013888888889,5,9,152,161
2024-01-17 16:33:22,0.03921296296296296,1,7,0,7
2024-01-18 12:29:58,0.8788888888888889,1,24,11,35
2024-01-17 15:47:35,0.02025462962962963,1,0,7,7
2024-01-17 15:38:28,0.04974537037037037,1,2,1,3
2024-01-17 10:48:04,0.02099537037037037,1,6,2,8
2024-01-17 09:11:35,0.3052662037037037,1,57,57,114
2024-01-17 09:11:35,0.30550925925925926,1,3,3,6
2024-01-17 09:22:32,0.48743055555555553,6,58,30,88
2024-01-25 15:28:44,8.774282407407407,4,214,92,306
2024-01-17 09:22:32,0.5647453703703704,1,2,2,4
2024-01-17 14:37:20,0.7955092592592593,1,109,3,112
2024-01-17 13:44:01,0.8372337962962964,6,111,147,258
2024-01-17 09:08:34,0.6604166666666667,1,5,12,17
2024-01-17 12:25:22,1.0745601851851851,1,40,36,76
2024-01-17 14:37:20,1.168738425925926,3,162,33,195
2024-01-17 09:08:34,0.940949074074074,1,1,1,2
2024-01-16 10:32:34,0.013287037037037036,1,253,249,502
2024-01-16 18:35:10,0.030960648148148147,1,109,49,158
2024-01-17 14:28:31,0.4183912037037037,1,585,471,1056
2024-01-16 08:36:05,0.3058680555555556,1,1,1,2
2024-01-25 16:51:16,9.732685185185185,4,132,49,181
2024-01-15 21:31:16,0.011909722222222223,1,2,2,4
2024-01-16 08:36:05,0.6003125,1,1,1,2
2024-04-17 08:22:03,93.37697916666667,4,45,39,84
2024-01-15 18:10:30,0.24636574074074075,2,33,35,68
2024-01-15 10:51:18,0.01994212962962963,1,6,0,6
2024-01-15 11:09:44,0.07111111111111111,1,7,2,9
2024-01-24 11:51:25,0.01017361111111111,1,4,4,8
2024-01-24 16:51:53,9.247407407407408,1,2,2,4
2024-01-16 17:59:03,0.9909143518518518,1,57,103,160
2024-01-16 18:35:10,1.3187962962962962,2,23,22,45
2024-01-15 11:09:44,0.41292824074074075,1,1,1,2
2024-01-15 11:06:42,0.27848379629629627,1,77,11,88
2024-01-15 11:06:42,2.3974189814814815,1,1,1,2
2024-01-12 22:44:54,0.03878472222222222,1,6,13,19
2024-01-15 09:52:41,2.723738425925926,3,21,23,44
2024-01-19 09:42:11,3.947789351851852,2,5,6,11
2024-01-12 17:05:38,0.18226851851851852,1,1,0,1
2024-01-15 11:22:45,0.017881944444444443,1,1,1,2
2024-01-15 13:52:16,3.1116319444444445,1,12,46,58
2024-01-12 13:10:25,0.09827546296296297,1,6,7,13
2024-01-12 13:10:25,0.8448842592592593,1,26,7,33
2024-01-12 10:36:55,0.039016203703703706,1,257,252,509
2024-01-12 09:17:26,0.20255787037037037,1,5,2,7
2024-01-12 09:21:17,0.4098148148148148,5,81,8,89
2024-01-12 09:10:13,0.4400810185185185,1,1,6,7
2024-01-12 09:10:13,0.4421643518518519,1,17,7,24
2024-01-12 09:21:17,0.46207175925925925,1,29,10,39
2024-01-12 09:38:14,0.5114120370370371,1,9,1,10
2024-01-12 03:44:25,0.2763773148148148,1,4,1,5
2024-01-19 11:22:39,35.88488425925926,3,139,71,210
2024-01-12 09:11:46,0.63875,1,2,0,2
2024-01-12 09:11:46,0.71125,2,63,23,86
2024-01-11 15:13:27,38.75508101851852,1,7,5,12
2024-01-11 15:13:27,38.751724537037035,1,10,9,19
2024-01-11 13:19:55,0.4439699074074074,1,12,2,14
2024-01-24 09:43:42,13.262974537037037,1,480,1,481
2024-01-11 10:14:08,0.24211805555555554,1,21,5,26
2024-01-11 09:32:43,0.6212384259259259,1,23,0,23
2024-01-11 10:50:39,0.6029629629629629,4,40,3,43
2024-01-11 10:41:58,0.6320717592592593,8,88,35,123
2024-01-11 09:32:43,0.5886574074074075,1,24,7,31
2024-01-11 10:58:08,0.7440046296296297,1,13,15,28
2024-01-11 10:58:08,0.7609490740740741,1,12,13,25
2024-01-12 09:17:26,1.7301041666666668,1,20,0,20
2024-01-10 14:59:43,0.05204861111111111,1,31,2,33
2024-03-15 11:24:16,66.68730324074075,1,576,146,722
2024-01-09 22:03:53,0.008506944444444444,1,33,0,33
2024-01-10 09:43:08,0.5275925925925926,2,4,1,5
2024-01-11 12:53:08,0.07118055555555555,1,1,1,2
2024-01-10 09:36:27,0.5474189814814815,1,15,0,15
2024-01-10 09:36:27,0.7478125,3,31,7,38
2024-01-10 15:11:01,0.9973958333333334,2,7,2,9
2024-01-09 16:08:48,0.03958333333333333,1,130,28,158
2024-01-09 15:34:29,0.020057870370370372,1,137,30,167
2024-01-09 15:22:24,0.05138888888888889,1,3,3,6
2024-01-09 14:07:10,0.06243055555555556,2,15,106,121
2024-01-09 11:50:37,0.012094907407407407,1,2,2,4
2024-01-09 09:31:39,0.21248842592592593,1,6,5,11
2024-01-09 08:10:46,0.48971064814814813,1,13,24,37
2024-01-09 09:31:40,0.6062384259259259,2,9,4,13
2024-01-10 10:40:28,1.7106018518518518,1,37,188,225
2024-01-08 16:49:08,0.013275462962962963,1,2,2,4
2024-01-09 09:45:35,0.7622222222222222,3,95,1,96
2024-01-10 13:41:37,2.077361111111111,3,48,36,84
2024-01-08 15:26:48,0.8727662037037037,1,0,30,30
2024-01-08 13:36:10,0.7888425925925926,1,0,1,1
2024-01-08 13:53:46,0.6209490740740741,1,2,5,7
2024-01-08 15:26:48,0.8760185185185185,1,0,17,17
2024-01-08 13:36:10,0.8548958333333333,1,0,2,2
2024-01-08 13:39:02,1.6284027777777779,1,0,10,10
2024-01-08 13:39:02,1.7424652777777778,1,0,5,5
2024-01-08 10:25:42,0.021435185185185186,1,1,1,2
2024-01-08 09:59:23,0.14476851851851852,1,1,1,2
2024-01-08 09:59:23,0.36811342592592594,1,1,1,2
2024-01-08 11:03:20,0.41260416666666666,1,6,6,12
2024-01-09 14:45:56,1.6866319444444444,1,1,1,2
2024-02-22 13:25:21,130.72840277777777,2,105,44,149
2024-01-15 10:41:48,1.660925925925926,1,95,33,128
2024-03-01 17:56:57,55.181736111111114,1,1,0,1
2024-01-08 12:51:48,0.03167824074074074,1,510,39,549
2024-01-09 12:56:28,3.6000694444444443,11,20,22,42
2024-01-08 10:17:40,2.500509259259259,1,0,9,9
2024-01-08 11:22:33,2.576261574074074,1,17,10,27
2024-01-08 10:17:40,2.5230092592592595,1,10,10,20
2024-01-08 10:19:13,2.5932291666666667,1,3,3,6
2024-01-08 11:03:20,2.624108796296296,1,3,3,6
2024-01-08 11:05:15,2.7347106481481482,1,11,4,15
2024-01-09 11:50:37,3.7856134259259258,9,541,598,1139
2024-01-08 11:20:54,2.8333680555555554,1,3,2,5
2024-01-08 15:36:23,2.9975578703703705,1,10,10,20
2024-01-08 13:31:43,2.946851851851852,2,2,2,4
2024-01-08 11:15:22,2.8582060185185183,1,1,1,2
2024-01-08 11:22:33,2.872986111111111,1,12,2,14
2024-01-08 11:05:15,0.9264583333333334,1,32,12,44
2024-01-08 10:19:13,2.7908796296296297,1,1,1,2
2024-01-08 12:34:35,2.8988078703703706,1,5,7,12
2024-01-05 22:03:01,0.4007523148148148,2,10,182,192
2024-01-15 17:16:20,10.245219907407407,1,92,3,95
2024-01-05 11:13:29,0.04144675925925926,3,16,1,17
2024-01-05 10:46:11,0.059953703703703703,1,1,1,2
2024-01-05 11:34:41,0.29768518518518516,1,309,10,319
2024-01-11 15:49:16,6.486504629629629,1,3,3,6
2024-01-05 10:52:47,0.6107870370370371,1,3,3,6
2024-01-05 12:36:45,0.7217824074074074,1,2,7,9
2024-01-05 15:19:13,0.8802083333333334,2,45,6,51
2024-01-05 12:31:34,0.8164814814814815,1,7,17,24
2024-01-04 17:00:32,0.10234953703703703,1,4,2,6
2024-01-05 10:46:48,0.8522685185185185,1,2,2,4
2024-01-05 10:46:48,0.8525578703703703,1,3,3,6
2024-01-04 14:17:54,0.05,1,1,1,2
2024-01-04 09:24:17,0.2076851851851852,1,70,3,73
2024-01-04 09:29:54,0.2367824074074074,1,13,13,26
2024-01-04 09:16:28,0.3753009259259259,1,1,1,2
2024-01-04 09:16:28,0.4403240740740741,1,3,3,6
2024-01-04 09:18:19,0.44181712962962966,1,8,8,16
2024-01-08 11:02:44,4.5173958333333335,4,177,114,291
2024-01-09 12:11:52,5.7098148148148145,1,2,2,4
2024-01-04 09:20:49,0.5912615740740741,1,98,98,196
2024-01-03 19:08:25,0.10033564814814815,1,2,1,3
2024-01-04 16:45:36,1.0144212962962964,1,54,41,95
2024-01-04 09:24:17,0.7229861111111111,1,19,7,26
2024-01-04 14:17:54,0.9693981481481482,1,11,8,19
2024-01-04 09:20:49,0.7849652777777778,2,49,49,98
2024-01-03 15:08:24,0.14024305555555555,1,5,7,12
2024-01-03 09:25:04,0.20840277777777777,1,79,8,87
2024-01-03 09:06:04,0.37153935185185183,1,3,3,6
2024-01-03 09:06:04,0.3719791666666667,1,1,1,2
2024-01-03 13:27:14,0.7189583333333334,3,346,258,604
2024-01-03 15:08:24,0.8741319444444444,3,69,34,103
2024-01-03 13:07:08,0.7537152777777778,2,110,1,111
2024-01-03 09:15:46,0.5967939814814814,1,6,6,12
2024-01-03 13:07:08,0.8588194444444445,3,12,12,24
2024-01-05 10:46:11,2.766539351851852,1,22,1,23
2024-01-02 15:07:31,0.16402777777777777,1,6,1,7
2024-01-02 12:33:24,0.06465277777777778,1,3,1,4
2024-01-03 10:29:30,1.0178125,2,2,2,4
2024-01-02 08:50:24,0.06188657407407407,1,2,2,4
2024-01-02 09:11:57,0.5035300925925926,1,1,1,2
2024-01-01 19:13:33,0.047928240740740743,1,1,1,2
2024-01-02 08:50:24,0.6670949074074074,1,1,0,1
2024-01-02 08:51:02,1.3590046296296296,1,59,48,107
2024-01-02 08:51:02,1.3591550925925926,1,9,9,18
2024-01-02 10:18:53,1.5307523148148148,1,7,7,14
2024-01-02 09:11:57,0.1992013888888889,1,111,3,114
2024-01-02 08:52:14,3.4199537037037038,1,65,65,130
2024-01-02 08:52:14,3.682372685185185,1,3,3,6
2024-01-04 09:18:19,52.56155092592593,1,27,16,43
2023-12-29 16:39:27,0.020162037037037037,1,5,2,7
2023-12-29 16:28:27,0.06652777777777778,1,26,3,29
2023-12-29 09:53:52,0.3661111111111111,1,1,1,2
2023-12-29 10:27:54,0.4318287037037037,1,3,3,6
2023-12-29 10:11:51,0.4209027777777778,1,3,3,6
2023-12-29 10:27:54,1.362974537037037,1,1,1,2
2023-12-29 10:13:38,1.6031365740740742,1,3,3,6
2023-12-29 09:38:21,1.9372685185185186,1,6,43,49
2023-12-29 10:11:51,2.3726041666666666,1,3,3,6
2023-12-29 10:23:36,2.5318171296296295,1,1,1,2
2023-12-29 10:13:38,2.600115740740741,1,2,2,4
2023-12-29 10:21:25,2.7371527777777778,1,3,3,6
2023-12-29 10:21:25,1.3588194444444444,1,3,3,6
2023-12-29 10:15:59,3.869247685185185,1,2,1,3
2023-12-29 10:23:36,4.285729166666667,1,3,3,6
2023-12-29 10:15:59,3.6088425925925924,1,71,69,140
2023-12-29 10:16:33,4.347337962962963,1,1,1,2
2023-12-29 10:55:55,0.02013888888888889,1,1,1,2
2023-12-29 10:16:33,4.8478819444444445,1,1,1,2
2023-12-29 10:19:58,5.037083333333333,1,2,1,3
2023-12-29 11:37:41,5.712314814814815,1,9,4,13
2023-12-29 10:44:19,0.26341435185185186,1,800,16,816
2023-12-29 10:19:57,6.5028703703703705,1,4,4,8
2023-12-29 10:19:58,6.503009259259259,1,1,1,2
2024-01-03 11:34:43,591.984525462963,3,95,4,99
2023-12-29 10:55:55,30.750266203703703,1,3,3,6
2024-01-11 16:17:37,19.97013888888889,5,47,22,69
2024-01-11 16:23:16,19.95744212962963,1,5,3,8
2023-12-22 15:35:22,0.01704861111111111,1,14,14,28
2023-12-22 15:15:58,0.050462962962962966,2,15,4,19
2024-01-04 09:12:22,12.982604166666667,2,84,16,100
2023-12-22 08:03:36,0.15134259259259258,1,356,94,450
2023-12-22 07:46:51,0.1568287037037037,1,1,1,2
2023-12-21 20:24:48,0.010289351851851852,1,2,0,2
2023-12-22 08:09:31,0.5646180555555556,1,12,13,25
2023-12-22 08:37:47,0.7381134259259259,2,52,19,71
2023-12-22 13:02:49,0.9155092592592593,2,424,128,552
2023-12-21 14:29:23,0.015601851851851851,1,73,86,159
2024-03-25 10:35:12,94.90665509259259,1,159,171,330
2023-12-21 08:37:57,0.011909722222222223,1,4,2,6
2023-12-21 09:49:34,0.07201388888888889,1,18,5,23
2023-12-21 09:13:27,0.1999074074074074,1,241,3,244
2023-12-21 08:56:20,0.7222916666666667,18,446,26,472
2023-12-21 10:15:37,1.6197337962962963,6,61,26,87
2023-12-21 11:20:28,1.6130092592592593,4,12,7,19
2023-12-21 09:33:51,1.5832638888888888,6,39,20,59
2023-12-21 11:20:28,1.3677662037037037,5,10,7,17
2023-12-21 09:23:53,1.2989583333333334,1,4,4,8
2023-12-22 19:01:54,2.226840277777778,2,340,313,653
2023-12-21 09:13:27,0.8353472222222222,1,4,4,8
2023-12-20 09:20:36,0.20657407407407408,1,1571,6,1577
2023-12-20 08:54:37,0.676863425925926,1,59,1,60
2023-12-20 14:41:27,1.0118055555555556,1,1,1,2
2023-12-20 08:54:37,0.7766319444444445,1,3,3,6
2023-12-20 09:49:14,0.8785416666666667,1,0,4,4
2023-12-19 10:53:12,0.014837962962962963,1,1,1,2
2023-12-19 15:22:51,0.24221064814814816,1,8,189,197
2023-12-19 09:45:55,0.22275462962962964,1,2874,44,2918
2023-12-18 23:24:45,0.03128472222222222,1,55,31,86
2024-01-25 15:18:32,40.77109953703704,1,27,33,60
2023-12-18 21:54:48,0.17753472222222222,1,2,2,4
2023-12-18 16:52:55,40.07703703703704,1,1,1,2
2024-01-15 18:24:31,31.060347222222223,34,1496,2398,3894
2024-01-24 16:51:53,37.10508101851852,1,8,8,16
2023-12-18 14:07:41,0.12991898148148148,1,7,0,7
2023-12-18 09:28:23,0.37796296296296295,1,74,94,168
2023-12-18 09:28:23,0.37846064814814817,1,8,28,36
2024-01-11 16:17:37,25.744618055555556,1,105,16,121
2024-04-18 16:29:41,124.00060185185185,1,13,20,33
2023-12-18 10:31:39,1.8222685185185186,1,21,21,42
2023-12-18 09:28:23,2.2876273148148147,1,2,2,4
2023-12-18 12:41:38,0.019756944444444445,1,3,3,6
2023-12-18 09:31:39,2.5125231481481483,1,5,25,30
2023-12-18 16:27:27,2.8014699074074074,1,5,25,30
2023-12-18 09:56:23,2.5953703703703703,1,16,20,36
2023-12-18 09:36:24,2.6001967592592594,1,1,6,7
2023-12-18 12:41:38,3.768125,1,123,0,123
2024-01-25 13:34:02,40.82938657407407,1,1,8,9
2023-12-18 09:36:24,2.6723032407407405,1,1,8,9
2023-12-18 10:04:21,2.7241435185185185,1,6,13,19
2023-12-18 10:12:01,2.7585185185185184,3,16,28,44
2023-12-18 09:31:39,2.788599537037037,1,211,237,448
2023-12-15 14:34:41,0.5233680555555555,1,5,10,15
2024-01-25 15:18:32,6.1850810185185185,1,5,5,10
2023-12-15 14:34:41,0.49983796296296296,1,6,14,20
2023-12-15 15:57:17,0.5611342592592593,1,3,11,14
2023-12-18 16:20:03,3.972789351851852,9,124,78,202
2023-12-18 08:30:45,0.17021990740740742,1,1779,133,1912
2023-12-15 14:43:57,0.6776620370370371,1,5,17,22
2023-12-18 12:27:01,3.6444560185185186,1,5,17,22
2024-04-02 15:53:12,110.0141087962963,4,32,35,67
2023-12-14 14:05:11,2.851446759259259,1,1,1,2
2024-01-25 13:42:39,42.47888888888889,1,59,106,165
2024-03-14 13:48:19,91.62456018518519,1,25,32,57
2023-12-14 10:52:15,0.49246527777777777,1,34,47,81
2023-12-14 14:13:21,0.6873842592592593,2,33,27,60
2023-12-14 10:38:23,0.5066087962962963,2,26,22,48
2023-12-14 14:05:11,0.7106134259259259,1,28,24,52
2023-12-14 10:38:23,0.6068865740740741,1,76,280,356
2023-12-14 10:29:27,1.6559837962962962,5,231,8,239
2023-12-14 10:29:27,0.5375347222222222,1,2,2,4
2023-12-13 09:52:51,0.0903587962962963,1,2,2,4
2023-12-13 09:52:51,0.2270949074074074,1,71,13,84
2023-12-13 09:52:51,0.47466435185185185,1,3,3,6
2023-12-13 09:52:51,0.5779282407407408,1,1,1,2
2023-12-13 10:19:43,0.8185532407407408,3,110,58,168
2023-12-13 07:53:06,0.726712962962963,1,12,12,24
2023-12-12 14:37:05,0.0784375,1,0,5,5
2023-12-12 11:45:56,0.30605324074074075,1,26,26,52
2023-12-12 11:45:56,0.4368402777777778,1,32,32,64
2023-12-12 10:41:10,0.39222222222222225,1,2,2,4
2023-12-19 13:16:04,11.837002314814814,7,105,32,137
2024-05-02 09:37:09,143.7473611111111,15,211,67,278
2023-12-12 10:41:10,0.7579976851851852,2,34,1,35
2023-12-12 12:00:40,4.592118055555556,1,17,13,30
2024-01-26 08:59:09,46.42967592592593,6,155,325,480
2023-12-11 14:58:46,0.04431712962962963,1,1,1,2
2023-12-12 14:24:03,0.013958333333333333,1,3,3,6
2023-12-11 14:58:46,0.05375,1,80,79,159
2023-12-11 14:28:49,0.1519097222222222,1,1,1,2
2023-12-11 08:51:01,0.04190972222222222,1,3,3,6
2023-12-19 11:06:25,8.170960648148148,8,329,324,653
2023-12-11 07:52:58,0.1641550925925926,1,64,64,128
2023-12-11 07:53:48,0.165,1,6,6,12
2023-12-11 07:53:48,0.261712962962963,1,3,3,6
2023-12-11 07:54:38,0.2624652777777778,1,12,12,24
2023-12-11 07:54:38,1.5180671296296295,1,3,3,6
2023-12-11 07:55:57,1.6563657407407408,1,24,18,42
2023-12-11 07:55:57,2.485497685185185,1,8,12,20
2023-12-11 07:57:03,2.487465277777778,1,19,23,42
2023-12-11 07:57:03,2.4869328703703704,1,25,25,50
2023-12-11 07:59:04,2.488136574074074,1,19,23,42
2023-12-11 07:59:04,2.486400462962963,1,7,11,18
2023-12-11 08:00:57,2.4893287037037037,1,41,40,81
2023-12-11 08:14:13,2.4983449074074073,1,18,22,40
2023-12-11 08:00:57,2.4754513888888887,1,19,23,42
2023-12-11 08:14:13,2.5498148148148148,1,18,22,40
2023-12-11 08:05:01,1.7867476851851851,1,1,1,2
2023-12-11 08:28:24,0.1685648148148148,1,156,11,167
2024-01-18 14:58:45,40.8471875,1,22,22,44
2023-12-11 08:05:01,2.6254976851851852,1,1,1,2
2023-12-11 10:29:17,2.7721412037037036,20,135,248,383
2023-12-19 10:56:29,11.810405092592593,3,42,13,55
2024-01-25 13:55:06,48.660752314814815,2,97,85,182
2023-12-08 13:55:05,0.016435185185185185,1,3,3,6
2023-12-19 10:56:29,3.8477314814814814,1,5,25,30
2023-12-08 09:52:45,0.22736111111111112,1,17,4,21
2023-12-08 09:52:46,0.4116550925925926,1,4,0,4
2023-12-08 13:55:05,0.7043171296296297,2,78,4,82
2023-12-08 09:52:45,0.6773726851851852,1,51,2,53
2023-12-08 09:32:51,0.7646759259259259,1,15,19,34
2023-12-12 08:35:18,4.717094907407407,1,1,1,2
2024-01-03 14:18:22,33.14972222222222,4,56,1,57
2023-12-07 15:33:10,6.030960648148148,1,26,0,26
2023-12-07 09:41:17,0.21917824074074074,1,51,51,102
2023-12-07 08:44:23,0.29412037037037037,1,2,1,3
2023-12-07 12:50:58,0.5833912037037037,1,1,0,1
2023-12-07 13:54:45,0.9362731481481481,5,600,557,1157
2023-12-07 08:44:23,0.41854166666666665,1,4,4,8
2023-12-07 08:50:18,0.6016666666666667,1,1,1,2
2023-12-07 09:10:41,0.7157986111111111,1,1,0,1
2023-12-19 05:14:16,12.573576388888888,1,11,140,151
2023-12-06 22:27:56,0.39269675925925923,1,11,5,16
2023-12-06 13:56:14,0.04940972222222222,1,1,1,2
2023-12-06 08:58:09,0.1891087962962963,1,104,13,117
2024-03-02 18:37:01,87.94211805555555,6,36,20,56
2023-12-06 08:33:44,0.538449074074074,1,3,3,6
2023-12-06 08:33:44,0.5386805555555556,1,2,2,4
2023-12-06 10:24:53,0.6470486111111111,7,10,43,53
2023-12-05 14:04:48,0.13699074074074075,1,2,2,4
2023-12-05 12:59:37,0.25078703703703703,1,1,1,2
2023-12-05 12:59:37,0.47453703703703703,1,3,3,6
2024-01-02 15:25:26,21.865613425925925,1,56,10,66
2023-12-06 13:47:44,1.8140972222222222,4,8,10,18
2023-12-06 08:44:58,2.4691435185185187,2,27,19,46
2023-12-06 08:44:58,2.465787037037037,1,17,11,28
2023-12-06 08:50:39,2.4796643518518517,2,5,4,9
2023-12-06 08:52:46,2.4845486111111112,1,16,9,25
2023-12-04 15:33:50,0.7783217592592593,1,11,8,19
2023-12-04 15:47:16,0.7910185185185186,1,29,11,40
2023-12-07 14:54:37,3.811111111111111,2,6,10,16
2023-12-04 08:50:45,0.25732638888888887,1,102,40,142
2023-12-04 08:50:45,0.2575462962962963,1,6,6,12
2023-12-04 08:52:38,0.5050462962962963,1,2,2,4
2023-12-04 08:52:38,0.7177777777777777,1,15,3,18
2023-12-04 09:08:11,0.7316203703703704,1,22,18,40
2023-12-04 13:01:38,0.9293287037037037,2,78,34,112
2023-12-04 08:58:23,2.2367708333333334,1,8,8,16
2023-12-07 14:46:03,5.646307870370371,5,53,40,93
2023-12-11 07:52:58,9.377361111111112,1,2,3,5
2023-12-06 08:52:46,4.458784722222222,2,55,1,56
2023-12-04 09:50:24,2.5685416666666665,5,97,4,101
2023-12-04 09:09:22,2.6991550925925925,1,19,0,19
2023-12-04 09:09:22,2.740289351851852,1,17,0,17
2023-12-04 09:15:08,2.7014699074074073,1,2,2,4
2023-12-01 16:27:46,0.01423611111111111,1,2,2,4
2023-12-01 16:06:16,0.0791087962962963,1,6,6,12
2023-12-01 15:53:51,0.06833333333333333,1,4,4,8
2023-12-01 15:53:51,0.06584490740740741,1,2,2,4
2023-12-01 16:12:45,0.08060185185185186,1,1,1,2
2023-12-01 15:53:05,0.06893518518518518,1,2,2,4
2023-12-01 15:53:04,0.06612268518518519,1,1,1,2
2023-12-04 09:44:21,0.018506944444444444,1,3,3,6
2023-12-01 15:53:05,3.745150462962963,1,20,30,50
2023-12-01 12:00:50,0.05085648148148148,1,12,0,12
2023-12-01 14:24:17,0.16635416666666666,1,74,0,74
2023-12-01 12:00:50,0.11287037037037037,1,28,81,109
2023-12-01 10:43:34,0.5335763888888889,1,16,16,32
2024-03-14 13:24:53,104.97462962962963,1,2,2,4
2024-03-14 09:36:31,104.50446759259259,1,5,6,11
2023-12-06 14:21:22,5.736840277777778,3,24,28,52
2023-12-01 11:06:13,0.733761574074074,3,62,62,124
2024-03-14 09:36:31,104.74569444444444,1,3,3,6
2023-12-07 09:41:17,6.748634259259259,3,10,10,20
2023-12-01 11:12:09,0.8390740740740741,1,1,1,2
2023-11-30 16:16:53,0.06417824074074074,2,4,2,6
2023-11-30 13:22:42,0.09921296296296296,1,3,3,6
2023-11-30 13:22:42,0.10820601851851852,1,4,4,8
2023-11-30 10:49:03,0.4995486111111111,1,76,60,136
2023-11-30 11:46:10,0.6677314814814815,5,66,64,130
2023-12-07 12:21:22,7.719479166666667,5,36,41,77
2023-11-30 14:33:37,0.8798611111111111,1,80,78,158
2023-11-30 10:58:56,1.0151388888888888,1,130,130,260
2023-11-30 11:04:34,1.0422453703703705,1,1,1,2
2023-12-05 16:13:24,0.4916435185185185,2,366,19,385
2024-01-25 15:47:01,57.73017361111111,6,1586,1802,3388
2023-11-29 09:05:39,0.4447337962962963,1,1,1,2
2023-12-19 12:59:34,20.607407407407408,1,9,9,18
2023-11-28 22:28:47,0.11938657407407408,3,8,28,36
2023-11-28 20:49:17,0.07559027777777778,2,1,23,24
2024-02-06 09:13:28,69.61890046296297,4,46,45,91
2023-11-30 10:49:03,1.9774305555555556,1,5,1,6
2023-11-28 14:52:53,0.20158564814814814,1,1,1,2
2023-11-28 10:04:56,0.010231481481481482,1,1,0,1
2023-11-28 09:05:20,0.19443287037037038,1,23,2,25
2023-11-28 08:24:14,0.6074537037037037,1,2,3,5
2023-11-28 09:17:43,0.6094791666666667,1,7,3,10
2023-11-28 07:43:33,0.5503009259259259,2,0,13,13
2023-11-28 09:17:43,0.6659259259259259,1,1,1,2
2023-11-28 18:43:26,1.0663541666666667,1,16,1,17
2023-11-28 18:36:32,1.113576388888889,1,1,1,2
2023-11-28 07:43:33,0.6769212962962963,1,5,12,17
2023-11-28 18:36:33,1.1179976851851852,1,1,1,2
2023-11-27 13:31:24,0.05997685185185185,1,26,4,30
2023-11-27 10:07:31,0.08159722222222222,1,2,2,4
2023-11-28 00:56:33,0.8682986111111111,1,4,1,5
2023-11-27 13:01:00,0.5219675925925926,1,6,6,12
2023-11-27 10:07:31,0.40174768518518517,1,39,39,78
2023-11-27 10:06:52,0.4961921296296296,1,1,1,2
2023-11-27 10:06:52,0.7548726851851851,1,81,43,124
2023-11-27 10:06:52,0.23697916666666666,1,180,52,232
2023-11-27 10:45:23,2.8210300925925926,1,0,3,3
2024-01-12 20:22:16,49.30997685185185,6,1035,699,1734
2023-11-24 10:30:55,0.2540162037037037,1,23,3,26
2023-11-28 14:30:13,15.78894675925926,2,139,92,231
2023-11-28 14:14:34,15.99582175925926,7,102,37,139
2023-11-30 15:43:43,7.005856481481482,1,57,58,115
2023-11-23 10:42:27,0.05748842592592593,1,1,1,2
2023-11-23 09:40:07,0.21849537037037037,1,34,19,53
2023-11-23 10:34:13,0.27119212962962963,1,6,6,12
2023-11-23 09:26:15,0.4688773148148148,1,7,7,14
2023-11-23 09:48:58,0.5162037037037037,2,28,65,93
2023-11-23 12:38:23,0.6526273148148148,1,18,3,21
2023-11-30 13:35:51,7.83224537037037,4,14,15,29
2023-11-23 09:26:15,0.6992013888888889,1,3,3,6
2023-12-19 12:45:27,21.110983796296296,1,1,1,2
2023-11-22 15:53:40,0.47756944444444444,1,50,6,56
2023-11-22 11:43:25,0.40020833333333333,2,22,16,38
2023-11-22 15:28:31,0.7183101851851852,1,1,1,2
2023-11-22 15:28:31,0.7185532407407408,1,3,3,6
2023-11-22 15:45:07,0.9718865740740741,1,88,6,94
2023-11-29 10:40:16,7.78306712962963,3,20,16,36
2023-11-30 13:47:18,8.910925925925927,1,17,17,34
2023-11-29 10:40:16,7.80230324074074,2,11,11,22
2023-11-30 13:47:18,8.931967592592592,1,0,6,6
2023-11-21 15:56:49,0.04667824074074074,1,3,1,4
2023-11-21 13:28:48,0.014976851851851852,1,9,9,18
2023-11-21 11:21:47,0.05458333333333333,1,1,1,2
2023-11-21 10:40:35,0.26034722222222223,1,131,22,153
2024-04-29 07:47:30,160.43658564814814,1,8,8,16
2023-11-21 10:57:51,0.5927314814814815,2,15,138,153
2023-11-29 08:40:07,8.582002314814815,3,15,2,17
2023-11-21 14:30:22,0.8696759259259259,1,105,69,174
2023-11-21 10:25:56,0.732025462962963,1,9,9,18
2023-11-21 10:34:24,0.8121180555555556,1,30,0,30
2023-11-21 11:05:43,0.8133912037037037,1,29,0,29
2023-11-21 13:06:09,0.8972916666666667,1,74,0,74
2023-11-20 10:22:24,0.26707175925925924,1,1,1,2
2023-11-20 08:58:45,0.2090625,1,61,121,182
2024-04-02 13:52:25,22.21497685185185,1,2,2,4
2023-11-20 08:46:06,0.26761574074074074,1,6,6,12
2023-11-20 11:05:40,0.7812268518518518,13,353,196,549
2023-11-20 09:40:00,0.7537615740740741,1,42,23,65
2023-11-20 09:40:00,0.7251041666666667,1,62,23,85
2023-11-20 11:05:40,0.7777662037037038,3,47,20,67
2023-11-20 09:32:44,0.7273958333333334,1,61,17,78
2023-11-23 10:05:17,3.5821180555555556,5,82,57,139
2023-11-20 08:46:06,0.5326736111111111,1,3,3,6
2023-11-20 08:47:50,0.9763541666666666,1,2,1,3
2023-11-18 10:20:06,0.016458333333333332,1,1,0,1
2023-11-20 08:47:50,0.18204861111111112,1,552,106,658
2023-11-21 11:10:42,3.5419560185185186,1,6,6,12
2023-11-21 16:46:31,3.789837962962963,2,13,2,15
2023-11-20 08:50:07,2.4986574074074075,1,0,0,0
2023-11-21 13:06:09,3.692650462962963,1,24,24,48
2023-11-20 09:09:10,2.526666666666667,1,4,4,8
2023-11-20 09:09:10,2.5270486111111112,1,11,7,18
2023-11-20 09:07:27,2.524699074074074,1,23,22,45
2023-11-20 09:07:27,2.5250694444444446,1,7,7,14
2023-11-20 09:32:44,2.5922337962962962,1,1,1,2
2023-11-20 08:50:07,2.6741087962962964,1,1,1,2
2023-11-24 09:31:44,6.770868055555556,1,6,2,8
2024-01-24 12:43:15,67.94309027777778,1,16,2,18
2023-11-24 09:31:44,6.929386574074074,1,9,3,12
2023-11-17 08:56:55,0.04335648148148148,1,5,5,10
2023-11-17 09:21:43,0.20542824074074073,1,162,44,206
2023-11-17 08:56:55,0.23766203703703703,1,3,3,6
2023-11-17 09:55:35,0.5238310185185185,3,197,155,352
2023-11-28 17:53:26,12.038784722222223,5,128,119,247
2023-11-17 09:08:58,0.7815162037037037,1,121,6,127
2023-11-17 11:36:20,0.9575462962962963,1,73,59,132
2023-11-16 13:48:27,0.07456018518518519,1,1,2,3
2023-11-16 12:05:09,0.008842592592592593,1,2,1,3
2023-11-17 11:36:20,1.0141435185185186,1,137,107,244
2023-11-16 09:55:08,0.09670138888888889,1,3,3,6
2023-11-16 10:08:38,0.23782407407407408,1,383,98,481
2023-11-17 11:57:41,1.5422800925925926,1,14,17,31
2023-11-16 14:38:09,5.714837962962963,5,73,36,109
2023-11-16 10:08:38,4.711030092592592,2,26,10,36
2023-11-16 10:01:26,4.610648148148148,1,76,54,130
2023-11-17 10:42:34,1.5350925925925927,1,63,23,86
2023-11-16 09:55:08,5.5266319444444445,3,169,122,291
2023-11-16 14:38:09,1.035636574074074,14,460,8,468
2023-11-28 18:25:33,13.06363425925926,8,85,61,146
2024-05-06 15:24:35,412.461875,5,116,30,146
2023-11-15 23:14:34,0.41552083333333334,3,27,26,53
2023-11-15 09:34:13,0.14480324074074075,1,1,1,2
2023-11-15 09:46:56,0.22314814814814815,1,207,111,318
2023-11-16 10:28:47,1.343738425925926,1,81,9,90
2023-11-15 09:21:32,0.48126157407407405,1,3,3,6
2023-11-15 09:21:32,0.532337962962963,1,13,0,13
2023-11-15 09:16:08,0.5890046296296296,1,8,3,11
2023-11-15 13:20:23,1.5958101851851851,14,95,61,156
2023-11-14 17:58:06,0.006168981481481482,1,1,1,2
2023-11-15 13:26:50,0.8764814814814815,1,11,0,11
2023-11-15 19:17:31,1.1828472222222222,5,340,345,685
2023-11-14 16:53:54,0.26510416666666664,1,13,45,58
2023-11-14 11:12:45,0.0284375,1,1,1,2
2023-11-14 10:30:56,0.12265046296296296,1,107,47,154
2023-11-14 10:59:19,0.2734375,1,96,8,104
2023-11-30 14:45:08,16.838483796296295,8,26,26,52
2023-11-14 14:40:02,0.7419212962962963,6,137,86,223
2023-11-14 10:37:32,0.7819907407407407,1,13,1,14
2023-11-30 14:00:03,16.884305555555557,6,81,10,91
2023-11-14 14:53:49,2.682824074074074,14,81,109,190
2023-11-14 10:30:56,0.8296180555555556,2,16,8,24
2023-11-13 16:06:56,2.8512037037037037,1,3,12,15
2023-11-13 14:38:09,0.9793402777777778,2,112,27,139
2023-11-13 12:25:13,0.03774305555555556,1,4,1,5
2023-11-13 14:46:00,0.019710648148148147,1,140,199,339
2023-11-13 14:40:27,0.5674652777777778,1,90,90,180
2023-11-15 11:19:23,2.547997685185185,1,519,411,930
2024-01-18 18:42:23,4.992928240740741,3,600,259,859
2023-11-13 13:24:30,1.2428703703703703,1,72,72,144
2024-01-09 21:13:27,0.12386574074074073,1,1,1,2
2023-11-13 14:40:27,2.1137847222222224,2,33,7,40
2023-11-13 13:24:30,0.3745717592592593,1,210,13,223
2023-11-13 13:28:06,2.606377314814815,1,1,0,1
2023-11-13 13:14:10,2.6029976851851853,1,61,60,121
2023-11-13 13:14:10,2.603287037037037,1,3,3,6
2023-11-14 14:53:49,7.07962962962963,2,72,62,134
2023-11-10 15:19:13,140.0159837962963,1,65,216,281
2023-11-13 13:28:06,3.1247569444444445,4,163,83,246
2023-11-10 13:12:35,0.36622685185185183,1,222,31,253
2023-11-10 12:46:15,0.3871759259259259,1,14,100,114
2023-11-09 22:41:24,0.010092592592592592,1,4,0,4
2023-11-10 12:46:13,0.9270486111111111,1,16,34,50
2023-11-13 14:58:25,4.015150462962963,1,29,104,133
2024-01-24 10:54:47,86.33599537037037,9,310,174,484
2023-11-09 12:58:13,0.10427083333333333,2,12,3,15
2023-11-09 10:16:47,0.04776620370370371,1,434,343,777
2023-11-09 14:35:38,0.4198263888888889,2,3,2,5
2023-11-09 09:54:31,0.22880787037037037,1,75,5,80
2023-11-09 10:16:47,0.33890046296296295,1,1,0,1
2023-11-10 12:54:28,1.5833680555555556,1,9,1,10
2023-11-09 09:54:31,0.5201851851851852,2,36,24,60
2023-11-30 15:43:43,21.783391203703705,4,36,28,64
2024-04-23 16:49:02,84.9480787037037,14,117,98,215
2023-11-09 09:46:45,0.6956712962962963,1,17,11,28
2023-11-09 09:46:45,0.7503472222222223,1,6,15,21
2023-11-09 12:58:13,0.8542013888888889,2,33,24,57
2023-11-13 16:22:37,5.024837962962963,1,2,6,8
2023-11-09 10:16:47,0.7757638888888889,1,3,3,6
2023-11-08 12:02:25,0.4406481481481481,1,2,10,12
2023-11-08 13:04:33,0.48540509259259257,1,2,4,6
2023-11-08 12:02:25,0.4447337962962963,1,0,2,2
2023-11-08 12:40:25,0.3438657407407407,1,27,11,38
2023-11-08 08:23:15,0.29756944444444444,1,17,17,34
2023-11-08 15:47:52,0.7438888888888889,1,97,124,221
2023-11-14 00:45:10,6.303645833333333,1,1,1,2
2023-11-08 13:04:33,0.7230902777777778,3,64,31,95
2023-11-08 12:55:17,0.7895138888888888,2,59,31,90
2023-11-07 15:20:08,0.026886574074074073,1,0,5,5
2023-11-07 14:24:32,0.0115625,1,1,1,2
2023-11-07 09:51:59,0.46650462962962963,1,161,93,254
2023-11-07 09:15:47,0.4838310185185185,1,2,7,9
2023-11-07 09:11:20,0.4926157407407407,1,6,19,25
2023-11-07 09:11:20,0.47824074074074074,1,16,30,46
2023-11-07 22:04:42,0.9973148148148148,1,99,53,152
2023-11-07 13:06:41,0.6749305555555556,2,26,33,59
2023-11-07 09:15:47,0.5684722222222223,1,9,5,14
2023-11-07 15:20:08,0.7911458333333333,1,3,5,8
2023-11-08 14:48:49,1.7735416666666666,2,20,21,41
2023-11-08 13:09:54,1.781574074074074,1,6,1,7
2023-11-09 16:21:13,2.9211574074074074,1,1,0,1
2023-11-07 09:27:32,0.6637037037037037,1,1,0,1
2024-04-26 15:23:13,173.72739583333333,9,69017,38593,107610
2023-11-06 16:31:11,0.10003472222222222,6,17,13,30
2023-11-06 14:33:52,0.029722222222222223,1,11,11,22
2023-11-07 15:26:05,1.070138888888889,1,121,119,240
2023-11-07 22:04:42,1.4466898148148148,1,2,2,4
2023-11-07 22:05:53,1.5030092592592592,1,2,2,4
2023-11-07 22:05:53,1.503287037037037,1,3,3,6
2023-11-07 22:14:32,1.5273148148148148,1,3,3,6
2023-11-06 09:53:29,0.012951388888888889,1,1,1,2
2023-11-06 09:53:29,0.07847222222222222,1,2,3,5
2023-11-06 10:00:15,0.08340277777777778,1,1,1,2
2023-11-16 09:39:20,0.6197222222222222,1,1,1,2
2023-11-06 10:26:27,0.10100694444444444,1,91,40,131
2023-11-06 10:28:00,0.36800925925925926,1,1,1,2
2023-11-06 10:27:58,0.3680671296296296,1,14,14,28
2023-11-06 11:20:18,1.4466087962962964,1,2,0,2
2023-11-04 21:58:28,0.018877314814814816,1,30,11,41
2023-11-07 15:22:15,3.09599537037037,3,27,86,113
2023-11-06 10:26:27,1.4921296296296296,1,4,0,4
2023-11-07 09:09:30,0.19721064814814815,1,191,32,223
2023-11-09 16:21:13,5.808148148148148,2,23,49,72
2023-11-07 15:52:33,3.893125,7,68,66,134
2023-11-08 12:40:25,4.793425925925926,1,32,76,108
2023-11-08 07:54:37,4.6809259259259255,1,50,550,600
2023-11-03 14:17:45,0.0924537037037037,2,11,4,15
2023-11-09 14:55:52,6.173634259259259,4,164,128,292
2023-11-03 15:00:21,0.8110416666666667,2,2,13,15
2023-11-06 09:33:46,3.837685185185185,2,45,6,51
2023-11-02 15:04:10,0.24524305555555556,2,116,4,120
2023-11-07 22:03:47,6.261284722222222,1,1,1,2
2023-11-01 07:27:33,0.3935648148148148,1,1,1,2
2023-11-03 10:15:44,0.24357638888888888,1,97,29,126
2024-03-27 15:25:06,147.72394675925926,7,259,259,518
2024-03-27 12:52:40,147.67505787037038,1,202,185,387
2023-11-29 10:15:28,35.497453703703705,1,6,6,12
2023-11-29 10:09:09,34.89239583333333,1,2,2,4
2023-11-30 14:00:03,36.02144675925926,1,11,10,21
2023-10-31 16:11:16,0.08300925925925925,1,28,9,37
2023-11-08 10:36:38,7.881909722222222,2,34,13,47
2023-11-07 22:00:24,7.450648148148148,1,3,3,6
2023-10-31 08:48:50,0.18311342592592592,1,75,12,87
2023-11-01 13:58:45,1.641886574074074,1,1,1,2
2023-10-30 22:31:38,0.15013888888888888,1,3,3,6
2023-10-30 22:30:43,0.14969907407407407,1,3,3,6
2023-10-30 22:38:36,0.3641087962962963,1,1,1,2
2023-10-31 08:24:19,1.696585648148148,1,24,19,43
2023-10-31 10:22:43,0.8822453703703703,4,155,152,307
2023-10-31 08:24:19,0.8747106481481481,1,4,4,8
2023-10-30 14:19:37,0.5084722222222222,1,1,1,2
2023-10-30 22:30:43,0.8495949074074074,1,3,3,6
2023-11-13 22:53:01,16.223761574074075,2,40,9,49
2024-03-13 08:51:27,137.568125,1,9,5,14
2023-10-30 14:19:37,0.41292824074074075,1,140,40,180
2023-10-31 08:32:07,3.4371180555555556,1,2,2,4
2023-10-30 14:09:43,2.8685069444444444,1,4,12,16
2023-10-31 15:26:56,4.00537037037037,1,1,5,6
2023-10-27 15:34:09,0.09709490740740741,4,11,11,22
2023-10-27 14:03:38,0.16461805555555556,1,1,1,2
2023-10-27 14:55:16,0.20998842592592593,3,7,6,13
2023-10-27 13:43:16,0.1564236111111111,1,1,1,2
2023-10-27 14:05:07,0.2142361111111111,1,5,1,6
2023-10-27 09:38:20,0.21748842592592593,1,127,8,135
2023-10-27 02:36:39,0.06885416666666666,2,13,0,13
2023-10-30 22:31:38,3.953101851851852,1,3,3,6
2023-10-26 23:38:15,0.134375,1,32,12,44
2023-10-31 11:10:24,4.642326388888889,1,9,0,9
2023-11-29 10:09:09,33.80189814814815,4,62,4,66
2023-11-29 10:03:16,33.75755787037037,1,13,1,14
2023-11-07 15:26:05,12.047800925925927,1,110,109,219
2023-10-31 09:52:17,4.845185185185185,1,20,4,24
2023-10-26 13:10:04,0.0034837962962962965,1,6,1,7
2023-10-26 11:06:03,0.27846064814814814,1,122,13,135
2023-10-26 10:49:11,0.27002314814814815,1,3,3,6
2023-10-26 10:49:55,0.2707523148148148,1,3,3,6
2023-11-09 13:11:28,14.75494212962963,3,57,4,61
2023-10-26 10:52:30,0.7113194444444444,1,4,4,8
2023-11-29 10:03:16,34.73293981481481,3,29,5,34
2023-10-27 13:21:23,1.908414351851852,3,114,126,240
2023-10-25 12:47:54,0.0007986111111111112,1,4,2,6
2023-10-25 13:56:14,0.0753587962962963,1,1,1,2
2023-10-25 12:01:38,0.10883101851851852,1,4,2,6
2023-11-15 14:24:14,21.24452546296296,2,5,1,6
2023-10-26 11:00:26,1.0932523148148148,4,251,209,460
2023-10-25 07:36:24,0.1329861111111111,1,51,6,57
2023-10-24 20:44:11,0.009131944444444444,1,2,4,6
2023-10-24 20:43:22,0.011655092592592592,1,8,4,12
2023-10-24 20:38:35,0.05887731481481481,1,24,24,48
2023-10-25 07:12:48,0.5441550925925925,1,4,10,14
2023-10-25 07:16:36,0.5718634259259259,1,1,1,2
2023-10-24 17:32:26,0.0146875,1,1,1,2
2023-10-25 12:01:16,0.8658217592592593,2,1040,817,1857
2023-10-25 12:38:18,1.7862847222222222,8,12,41,53
2023-10-26 20:35:31,2.966458333333333,1,7,60,67
2023-10-24 09:30:30,0.004039351851851852,1,2,2,4
2023-10-24 13:25:13,0.18104166666666666,2,44,24,68
2023-10-24 09:51:50,0.22666666666666666,1,144,8,152
2023-10-25 13:56:14,1.7597800925925926,9,317,57,374
2023-10-24 10:06:26,116.67795138888889,5,7,25,32
2023-10-26 21:20:58,43.35914351851852,1,2,2,4
2023-10-24 11:43:41,0.7825115740740741,2,104,201,305
2023-10-24 08:08:47,0.7424537037037037,2,55,69,124
2023-10-23 14:21:48,0.014143518518518519,1,5,0,5
2024-03-20 15:42:54,149.1767013888889,11,824,97,921
2023-10-23 12:38:36,0.07353009259259259,1,0,1,1
2023-10-23 09:39:54,0.07564814814814814,2,3,2,5
2023-10-27 09:57:01,4.344039351851852,1,1,1,2
2023-10-26 20:34:31,3.8421064814814816,1,1,1,2
2023-10-23 07:43:00,1.9577546296296295,1,86,118,204
2023-10-23 08:04:55,0.15274305555555556,1,36,36,72
2023-10-23 15:07:13,2.473738425925926,1,49,8,57
2023-11-07 18:21:03,18.116446759259258,2,28,7,35
2023-10-27 09:57:32,108.83578703703704,10,81,67,148
2023-10-23 07:50:02,2.6913078703703706,1,29,1,30
2023-10-23 10:20:01,3.1252430555555555,1,3,3,6
2023-10-20 08:11:41,0.1575925925925926,1,9,9,18
2023-10-20 02:08:14,0.031747685185185184,1,14,18,32
2023-10-19 17:36:09,0.021979166666666668,1,19,12,31
2023-10-20 08:45:47,0.7514351851851852,2,38,2,40
2023-11-20 10:51:21,31.85332175925926,1,6,7,13
2023-10-19 14:55:07,0.05935185185185185,1,22,50,72
2023-10-31 09:46:01,11.934976851851852,1,15,5,20
2023-10-19 12:25:57,0.32947916666666666,1,1,1,2
2023-10-19 12:31:25,0.3377777777777778,1,5,5,10
2023-11-07 22:02:44,19.960486111111113,1,1,1,2
2023-10-19 11:22:44,0.5994907407407407,1,3,3,6
2024-04-22 08:09:38,186.52667824074075,13,289,59,348
2023-10-27 08:35:38,8.765555555555556,2,54,25,79
2023-11-07 10:49:47,19.937118055555555,5,5,14,19
2023-10-18 13:20:24,0.17774305555555556,1,1,1,2
2023-10-18 09:08:11,0.19626157407407407,1,34,18,52
2023-10-18 08:18:35,0.641724537037037,1,2,1,3
2023-10-18 08:32:09,0.7165393518518518,1,1,7,8
2023-10-18 12:26:23,0.8947800925925926,1,33,43,76
2023-10-17 14:57:19,0.014884259259259259,1,12,12,24
2023-10-26 17:03:48,9.23366898148148,1,1,1,2
2023-10-17 11:06:16,0.02396990740740741,1,43,0,43
2023-10-17 11:03:54,0.07450231481481481,1,40,0,40
2023-10-16 16:20:58,135.9346875,3,69,0,69
2024-03-10 10:30:29,145.78857638888888,1,1,0,1
2023-10-23 12:35:57,6.886585648148148,2,606,2933,3539
2023-10-16 14:36:28,0.03023148148148148,1,16,14,30
2023-10-16 16:02:16,88.8180324074074,1,185,206,391
2023-10-16 16:07:17,88.79831018518519,1,126,127,253
2023-10-16 14:04:29,88.72309027777777,1,39,45,84
2023-10-23 12:30:46,6.977916666666666,1,5,0,5
2023-10-16 13:24:15,0.07487268518518518,1,12,1,13
2023-10-23 10:18:17,7.0478703703703705,1,10,3,13
2023-10-23 10:13:12,0.15143518518518517,1,218,106,324
2023-10-23 10:12:17,0.09930555555555555,1,424,226,650
2023-10-23 10:35:54,0.013888888888888888,1,182,203,385
2023-10-16 11:39:26,0.7628935185185185,1,1,0,1
2023-10-16 09:09:20,0.674074074074074,1,7,6,13
2023-10-16 09:31:52,0.2129861111111111,1,107,110,217
2023-11-09 10:23:58,0.9720949074074074,1,125,135,260
2023-10-16 09:08:14,1.9296875,1,4,4,8
2023-10-13 17:00:54,0.03646990740740741,1,4,4,8
2023-10-17 13:30:12,3.9291319444444444,2,41,46,87
2023-10-13 14:10:44,0.025300925925925925,1,13,93,106
2023-12-12 12:00:40,60.02364583333333,1,0,7,7
2023-12-12 12:07:07,60.029456018518516,1,2,6,8
2023-10-13 09:15:47,0.015925925925925927,1,39,0,39
2023-10-13 10:01:33,0.04981481481481481,1,0,3,3
2023-10-13 09:46:25,0.04334490740740741,1,1,1,2
2023-10-13 09:01:41,0.1920601851851852,1,84,84,168
2023-10-24 17:45:25,11.895162037037037,17,1692,1490,3182
2023-10-13 08:52:55,0.6094328703703704,1,3,3,6
2023-10-17 12:59:07,5.15105324074074,1,3,0,3
2023-10-12 14:47:18,0.28922453703703704,1,9,2,11
2023-10-12 08:07:41,0.15489583333333334,1,25,9,34
2023-10-12 07:35:26,0.25730324074074074,1,3,3,6
2023-10-12 07:44:20,2.730983796296296,1,10,8,18
2023-10-11 14:36:50,0.061516203703703705,1,4,4,8
2023-10-11 14:24:29,0.07064814814814815,1,1,1,2
2023-10-25 21:34:01,14.42170138888889,3,57,17,74
2023-10-11 14:37:02,0.4252199074074074,1,81,44,125
2023-10-11 14:22:00,0.7067013888888889,1,5,5,10
2023-10-11 14:02:52,0.901724537037037,1,1,1,2
2023-10-10 14:00:51,0.012083333333333333,1,21,2,23
2023-10-11 13:14:18,1.1321064814814814,1,7,1,8
2023-10-10 09:35:32,0.009918981481481482,1,1,1,2
2023-10-10 08:06:37,0.1542476851851852,1,17,17,34
2023-10-10 07:52:09,0.5675347222222222,1,1,1,2
2023-10-17 12:59:40,7.927060185185185,1,2,0,2
2023-10-11 15:06:27,2.048414351851852,1,5,6,11
2023-10-11 14:20:26,2.0002199074074074,1,12,13,25
2023-10-11 13:58:34,1.981064814814815,1,8,9,17
2023-10-09 14:46:10,0.0344212962962963,1,13,3,16
2023-10-31 11:00:44,21.98783564814815,5,30,126,156
2023-10-09 10:21:02,0.021747685185185186,1,17,1,18
2023-10-23 12:33:17,14.118078703703704,1,12,5,17
2023-10-09 07:43:42,0.26537037037037037,1,72,78,150
2023-10-09 08:19:14,0.29030092592592593,1,15,15,30
2023-10-09 08:32:06,0.17105324074074074,1,39,23,62
2023-10-07 19:12:21,0.2725578703703704,1,1,0,1
2023-11-13 10:03:59,37.6277662037037,1,70,30,100
2023-10-06 10:58:03,0.024652777777777777,2,16,1,17
2023-10-06 10:58:17,0.06815972222222222,2,50,22,72
2023-10-06 09:49:10,0.22541666666666665,1,31,31,62
2023-10-06 09:43:30,0.35541666666666666,1,3,3,6
2023-10-06 15:02:56,0.7417361111111112,3,23,5,28
2023-10-06 09:33:43,0.5752662037037037,1,0,54,54
2023-10-05 19:23:43,0.1842939814814815,1,0,4,4
2023-10-05 14:35:06,0.029131944444444443,1,1,1,2
2023-10-05 14:33:54,0.03270833333333333,1,1,1,2
2023-10-05 11:10:18,0.028009259259259258,1,2,1,3
2023-10-05 11:13:14,0.2838541666666667,1,98,95,193
2023-10-05 08:28:47,0.3425,1,3,3,6
2023-10-05 07:50:08,0.9054282407407407,2,7,6,13
2023-10-23 12:19:39,19.12613425925926,2,17,13,30
2023-10-04 08:53:05,0.1862037037037037,1,511,484,995
2023-10-04 08:17:37,0.6832175925925926,1,8,0,8
2023-10-03 13:52:48,0.015775462962962963,3,27,6,33
2023-10-03 08:47:28,0.18246527777777777,1,42,24,66
2023-10-03 08:47:51,0.28055555555555556,1,3,1,4
2023-10-03 10:21:33,0.721875,1,1,1,2
2023-10-03 08:48:05,0.7092708333333333,1,5,5,10
2023-10-03 08:48:33,0.7693171296296296,1,7,2,9
2023-10-02 14:20:05,0.01380787037037037,1,1,1,2
2023-10-03 08:09:00,0.9856365740740741,1,11,11,22
2023-10-02 11:16:03,0.4250462962962963,1,1,1,2
2023-10-02 11:17:55,0.4264351851851852,1,9,9,18
2023-10-02 11:21:43,0.44439814814814815,1,21,12,33
2023-10-02 11:18:06,0.5086805555555556,1,3,3,6
2023-10-02 11:18:16,0.7320486111111111,1,4,0,4
2023-10-02 11:18:29,1.3048958333333334,1,5,5,10
2023-10-02 11:35:30,0.29912037037037037,1,132,103,235
2023-09-29 13:34:55,0.008229166666666666,1,1,1,2
2023-09-29 13:51:27,0.01980324074074074,1,58,53,111
2023-09-29 13:34:32,0.008333333333333333,1,61,54,115
2023-09-29 13:51:37,0.038738425925925926,1,11,2,13
2023-10-06 15:46:04,7.242222222222222,1,12,3,15
2023-10-03 10:21:42,4.065636574074074,1,20,2,22
2023-09-29 08:04:18,0.15265046296296297,1,94,94,188
2023-09-29 07:50:15,0.15693287037037038,1,1,1,2
2023-10-03 09:48:58,4.43806712962963,1,1,1,2
2023-09-29 07:50:34,0.3691087962962963,1,3,3,6
2023-09-28 14:52:23,0.9964120370370371,1,1,1,2
2023-09-28 14:52:11,95.08743055555556,1,2,1,3
2023-09-28 14:25:15,0.038217592592592595,1,1,1,2
2023-10-03 11:12:40,4.922743055555555,4,67,74,141
2023-09-28 11:41:24,0.052662037037037035,1,1,1,2
2023-09-28 13:29:08,0.1571759259259259,1,4,0,4
2023-09-28 08:14:44,0.15605324074074073,1,4,3,7
2023-09-28 08:16:16,0.3718518518518519,5,10,9,19
2023-09-28 08:39:38,0.48322916666666665,1,5,2,7
2023-09-28 08:30:19,1.049236111111111,1,3,3,6
2023-09-28 08:44:17,0.1801273148148148,1,544,506,1050
2023-09-28 08:17:09,1.5661342592592593,1,10,4,14
2023-10-04 07:23:51,8.584791666666666,6,92,44,136
2023-10-23 12:27:58,27.121423611111112,1,52,46,98
2023-09-26 09:12:22,0.016921296296296295,1,3,3,6
2023-09-26 09:11:53,0.02162037037037037,1,13,1,14
2023-09-26 08:47:04,0.05924768518518519,1,8,9,17
2023-09-26 08:47:17,0.18241898148148147,1,26,23,49
2023-10-18 12:10:08,22.52869212962963,1,79,6,85
2023-09-26 08:47:34,0.21225694444444446,1,2,2,4
2023-10-23 10:16:03,25.072777777777777,1,8,10,18
2024-03-01 17:41:52,158.0072800925926,1,1,0,1
2023-09-25 15:07:53,0.10171296296296296,1,2,1,3
2023-09-25 13:07:10,0.07748842592592593,1,3,1,4
2023-09-25 13:06:57,0.08641203703703704,1,1,1,2
2023-09-25 16:41:21,0.27319444444444446,1,1,1,2
2023-09-25 16:40:42,0.27282407407407405,1,2,2,4
2023-09-25 16:40:03,0.2724537037037037,1,1,1,2
2023-09-25 16:39:14,0.27196759259259257,1,2,2,4
2023-09-25 16:38:55,0.2718287037037037,1,1,1,2
2023-10-23 10:36:47,0.012094907407407407,1,124,198,322
2024-03-01 17:41:52,158.4030324074074,1,1,1,2
2023-09-25 13:06:43,0.2294212962962963,1,4,4,8
2024-03-07 11:08:54,164.14903935185185,1,1,0,1
2023-09-25 08:09:52,0.20158564814814814,1,27,32,59
2023-09-25 08:23:12,0.21109953703703704,1,1,1,2
2023-09-25 17:21:07,0.6300694444444445,1,7,7,14
2023-09-25 08:36:46,0.34174768518518517,1,4,3,7
2023-09-25 09:56:21,0.011724537037037037,1,45,39,84
2023-09-25 10:59:38,0.9755092592592592,1,1,0,1
2023-09-28 08:13:45,3.8869907407407407,1,1,0,1
2024-02-26 00:58:05,155.1764351851852,2,10,1,11
2023-09-25 08:50:10,0.18416666666666667,1,356,97,453
2023-09-25 09:03:20,0.4452314814814815,1,3,3,6
2023-11-08 11:02:52,15.788298611111111,7,17976,13043,31019
2023-09-25 15:07:02,3.081099537037037,1,4,2,6
2023-09-22 14:02:00,0.060520833333333336,1,16,3,19
2023-11-30 11:46:10,69.15439814814815,1,31,3,34
2023-10-17 13:24:45,25.299537037037037,1,1,1,2
2023-09-22 09:06:48,0.19597222222222221,1,20,13,33
2023-09-22 08:13:10,0.4987847222222222,1,4,0,4
2023-09-22 08:13:53,0.5116203703703703,1,2,2,4
2023-09-28 11:40:44,6.841608796296296,1,2,2,4
2023-10-02 14:42:53,10.971354166666666,1,3,1,4
2023-09-21 12:42:15,0.00494212962962963,1,889,765,1654
2023-09-21 14:51:32,0.11363425925925925,1,11,10,21
2023-09-21 11:57:24,0.016412037037037037,1,1,1,2
2023-09-21 11:51:22,0.040081018518518516,1,37,39,76
2023-09-21 10:33:31,0.043541666666666666,2,9,3,12
2023-09-21 12:00:51,0.17186342592592593,1,16,18,34
2023-10-17 14:10:16,22.212847222222223,1,1,1,2
2023-09-21 09:06:04,0.19541666666666666,1,2,2,4
2023-10-23 10:15:31,5.385509259259259,1,3,3,6
2023-10-23 10:45:14,0.00034722222222222224,1,44,76,120
2023-09-21 09:06:17,0.3237847222222222,1,6,7,13
2023-09-21 09:00:15,0.45287037037037037,1,19,24,43
2023-11-07 22:00:24,41.98349537037037,1,3,3,6
2023-09-20 16:25:17,0.0707175925925926,2,67,0,67
2023-09-20 10:12:20,0.08092592592592593,1,3,3,6
2023-09-20 11:05:57,0.27836805555555555,1,25,17,42
2023-10-03 09:52:22,13.29525462962963,6,17,13,30
2023-10-17 14:10:51,27.91199074074074,2,39,39,78
2023-10-23 10:14:17,33.75225694444445,1,3,3,6
2023-09-19 15:31:58,0.010115740740740741,1,2,2,4
2023-09-19 14:26:51,0.009143518518518518,1,42,19,61
2023-10-17 14:12:03,28.025949074074074,2,4162,3466,7628
2023-09-19 15:04:24,0.24614583333333334,1,38,17,55
2023-09-19 10:25:58,0.05571759259259259,1,8,5,13
2023-09-19 08:41:49,0.17803240740740742,1,36,3,39
2023-09-19 09:03:43,0.389212962962963,1,3,3,6
2023-09-19 09:16:45,0.5479861111111111,1,1,1,2
2023-09-19 10:25:40,0.8639351851851852,1,2,2,4
2023-09-18 09:20:10,0.07241898148148149,1,4,2,6
2023-09-18 07:37:29,0.024895833333333332,1,1,1,2
2023-09-18 07:51:52,0.047893518518518516,1,2,1,3
2023-09-18 06:52:50,0.012083333333333333,1,59,66,125
2023-09-19 10:51:14,0.6129629629629629,1,67,57,124
2023-09-19 10:24:26,0.5950578703703704,1,105,60,165
2023-10-17 14:16:13,21.870868055555555,1,1,1,2
2023-09-18 06:34:05,1.4682638888888888,1,83,96,179
2023-09-19 10:25:30,2.6980671296296297,1,59,17,76
2023-09-15 17:54:33,0.21390046296296297,1,26,25,51
2023-09-15 17:53:28,0.23791666666666667,2,11,6,17
2023-09-15 17:52:28,0.27997685185185184,1,2,10,12
2023-11-07 22:01:24,53.490833333333335,1,1,1,2
2023-09-15 08:44:01,0.008587962962962962,1,2,2,4
2023-09-15 08:23:25,0.02771990740740741,1,2,2,4
2023-09-14 21:11:37,0.03040509259259259,1,9,2,11
2023-09-15 07:09:23,0.598900462962963,1,55,19,74
2023-09-14 16:46:00,0.4245833333333333,1,22,10,32
2023-09-14 07:20:14,0.012604166666666666,1,1,1,2
2023-09-15 08:03:55,1.1208912037037038,1,3,3,6
2023-09-18 11:46:08,0.30549768518518516,1,260,169,429
2023-09-13 08:01:31,0.2508796296296296,1,53,53,106
2023-10-27 16:20:56,45.047164351851855,6,207,32,239
2023-09-12 14:30:03,0.08392361111111112,1,1,0,1
2023-09-13 17:54:05,1.2372453703703703,2,16,10,26
2023-09-12 10:38:52,0.013622685185185186,1,3,3,6
2023-09-12 10:18:19,0.04212962962962963,1,3,7,10
2023-09-12 08:00:00,0.2092013888888889,1,1,1,2
2023-09-12 08:45:55,0.2731712962962963,1,1,1,2
2023-09-12 02:20:57,0.03436342592592593,1,5,0,5
2023-11-06 16:21:20,56.06118055555555,1,208,107,315
2023-10-23 12:27:07,41.90569444444444,1,5,1,6
2023-11-06 15:53:46,56.119224537037034,2,10,10,20
2023-11-06 15:53:46,56.11863425925926,2,4,4,8
2023-09-11 18:23:13,0.44707175925925924,1,1,0,1
2023-09-11 08:11:59,0.06405092592592593,1,1,1,2
2023-09-11 08:41:27,0.19690972222222222,1,21,21,42
2023-09-11 08:25:55,0.18625,1,146,147,293
2023-09-11 08:26:07,0.3294675925925926,1,1,1,2
2023-09-11 08:26:23,0.3297569444444444,1,6,6,12
2023-09-11 08:54:59,0.01945601851851852,1,108,111,219
2023-09-13 09:22:53,3.373425925925926,3,290,72,362
2023-09-11 09:32:30,1.4620717592592594,1,3,3,6
2023-09-11 09:51:43,1.702650462962963,1,1,1,2
2023-09-11 07:59:18,2.5547800925925928,1,3,3,6
2023-09-08 18:39:29,0.11989583333333333,1,10,8,18
2023-09-12 11:04:51,3.855347222222222,1,25,3,28
2023-09-08 15:01:02,0.025497685185185186,1,3,1,4
2023-09-11 09:12:22,0.011423611111111112,1,1,22,23
2023-11-28 10:04:56,81.3763425925926,122,50901,35860,86761
2023-09-08 12:25:00,0.6696527777777778,1,52,7,59
2023-09-08 10:42:55,0.7403472222222223,1,125,96,221
2023-09-07 16:55:25,0.09503472222222223,2,26,7,33
2023-09-07 14:49:32,0.07796296296296296,1,3,3,6
2023-09-07 13:38:11,0.05548611111111111,2,8,10,18
2023-09-07 10:53:41,0.27671296296296294,1,1,1,2
2023-09-07 12:56:19,0.3680324074074074,1,62,22,84
2023-09-07 12:59:42,0.44083333333333335,1,3,3,6
2023-09-08 11:45:35,1.6102777777777777,4,24,24,48
2023-09-07 02:24:11,0.22666666666666666,1,1,2,3
2023-09-07 02:24:01,0.2783449074074074,1,1,1,2
2023-09-07 02:24:25,0.2853472222222222,1,8,6,14
2023-09-06 20:25:03,0.05447916666666667,1,27,17,44
2023-09-06 19:04:49,221.77569444444444,5,30,9,39
2023-09-06 15:25:40,0.010671296296296297,1,9,8,17
2023-09-08 10:43:22,1.842962962962963,1,3,3,6
2023-09-06 14:28:32,0.012824074074074075,1,2,1,3
2023-09-06 10:17:51,0.08390046296296297,1,1,1,2
2023-09-06 10:17:23,0.11056712962962963,1,1,1,2
2023-09-06 08:00:25,0.01940972222222222,1,6,6,12
2023-09-06 07:19:43,0.4060300925925926,1,1,1,2
2023-09-06 04:46:27,0.3299074074074074,1,1,0,1
2023-09-05 16:19:59,0.034618055555555555,1,6,6,12
2023-09-05 18:05:59,0.11890046296296296,1,2,2,4
2023-09-05 21:49:49,0.39805555555555555,2,51,7,58
2023-09-06 07:18:10,0.9103587962962963,1,1,1,2
2023-09-05 13:37:23,0.2047337962962963,2,25,22,47
2023-09-04 15:56:48,0.03625,1,205,184,389
2023-09-04 15:56:32,0.1275462962962963,1,58,2,60
2023-09-04 07:08:53,0.24934027777777779,1,14,3,17
2023-09-04 07:26:33,0.2618171296296296,1,28,17,45
2023-09-05 21:54:25,1.9783101851851852,1,253,169,422
2023-09-04 07:09:26,0.47694444444444445,1,3,3,6
2023-09-04 08:18:46,0.5384375,1,44,12,56
2023-09-04 09:02:36,0.6560763888888889,1,42,31,73
2023-09-04 07:46:33,1.6677662037037038,1,6,2,8
2024-01-18 18:42:23,28.394363425925928,1,2,2,4
2023-09-05 21:57:04,3.933912037037037,1,6,27,33
2023-09-02 12:46:26,0.5546412037037037,1,11,11,22
2023-09-02 07:02:44,0.32329861111111113,1,1,0,1
2023-11-07 22:03:47,0.0008449074074074074,1,3,3,6
2023-11-07 22:01:24,26.600601851851852,1,5,3,8
2023-09-04 15:20:36,2.78775462962963,2,98,60,158
2023-09-04 08:14:01,2.600601851851852,1,2,2,4
2023-09-06 15:23:59,5.04744212962963,1,16,13,29
2023-09-01 13:13:28,0.011481481481481481,1,13,9,22
2023-09-01 13:09:45,0.017858796296296296,1,1,3,4
2023-09-04 19:20:20,3.277650462962963,1,44,12,56
2023-09-01 08:48:50,0.02130787037037037,1,1,1,2
2023-09-01 08:17:09,0.034074074074074076,1,1,1,2
2023-08-31 15:21:07,0.02767361111111111,1,2,0,2
2023-08-31 12:59:51,0.009814814814814814,1,2,2,4
2023-08-31 13:35:58,0.0953125,1,1,1,2
2023-08-31 13:47:31,0.1662847222222222,1,13,1,14
2024-04-17 09:08:25,229.98386574074075,1,8,18,26
2023-08-31 07:49:35,0.24333333333333335,1,12,13,25
2023-08-31 07:52:23,0.49938657407407405,1,53,21,74
2023-08-31 08:23:25,0.5211342592592593,1,111,113,224
2023-09-06 14:40:20,7.236203703703704,3,47,9,56
2023-08-30 14:29:52,0.0052430555555555555,1,2,2,4
2023-08-30 15:36:17,0.2251388888888889,1,4,7,11
2023-09-06 15:49:52,7.224039351851852,3,4,3,7
2023-08-30 07:34:07,0.39538194444444447,1,2,2,4
2023-08-31 17:04:27,1.9080092592592592,1,34,33,67
2023-08-30 07:44:14,0.5176620370370371,1,3,3,6
2023-08-30 07:45:13,0.6618055555555555,1,1,1,2
2023-08-29 15:51:13,0.0656712962962963,3,27,53,80
2023-10-09 11:38:30,40.95809027777778,1,39,38,77
2023-08-29 12:06:22,0.011747685185185186,2,8,17,25
2023-08-29 07:14:44,0.45792824074074073,1,13,1,14
2023-09-08 14:17:55,10.790787037037036,15,465,168,633
2023-09-01 07:43:13,3.579548611111111,1,200,60,260
2023-08-31 17:04:45,2.9805787037037037,1,1,1,2
2023-08-28 15:10:58,0.0867824074074074,1,1,1,2
2023-08-28 13:04:58,0.027199074074074073,1,1,1,2
2023-08-28 08:20:02,0.2700810185185185,1,78,66,144
2023-08-28 09:04:06,0.30092592592592593,1,73,62,135
2023-08-27 20:38:01,0.01980324074074074,1,13,4,17
2023-08-27 20:37:35,0.17048611111111112,1,1,1,2
2023-08-27 16:58:21,0.03763888888888889,1,2,0,2
2023-09-01 07:27:04,4.673495370370371,1,3,1,4
2023-08-28 09:36:17,0.7791782407407407,1,25,12,37
2023-08-31 12:15:59,4.163784722222222,1,1,0,1
2023-08-29 08:50:27,2.5423032407407407,1,3,3,6
2023-08-26 15:34:36,0.04392361111111111,1,3,1,4
2023-09-07 03:26:25,11.588368055555556,1,1,1,2
2023-08-28 15:08:38,2.1279166666666667,1,6,17,23
2023-08-28 08:31:51,1.8621875,1,13,4,17
2023-08-28 17:49:38,2.9020717592592593,1,15,10,25
2023-08-28 08:32:13,2.5269560185185185,1,2,2,4
2023-08-25 20:03:04,0.04017361111111111,1,3,1,4
2023-08-30 14:07:26,4.797164351851852,1,17,1,18
2023-08-28 11:18:39,2.69744212962963,1,52,5,57
2023-08-28 10:43:00,2.7480555555555557,2,9,6,15
2023-08-25 16:16:08,0.01814814814814815,1,1,1,2
2023-08-25 16:17:22,0.04048611111111111,1,1,1,2
2023-08-25 15:01:57,0.040671296296296296,1,3,14,17
2023-08-25 15:02:34,0.04447916666666667,1,3,3,6
2023-08-25 16:26:45,0.2363310185185185,2,27,19,46
2023-08-25 10:02:10,0.02232638888888889,1,17,1,18
2023-08-25 10:01:56,0.03847222222222222,2,3,0,3
2023-08-25 09:31:21,0.06969907407407408,1,1,1,2
2023-08-25 08:08:45,0.7275694444444445,1,86,43,129
2023-08-24 19:07:39,0.26895833333333335,1,2,1,3
2023-08-29 08:29:08,4.840011574074074,1,2,0,2
2023-08-24 12:06:27,0.02696759259259259,1,1,1,2
2024-03-01 17:36:16,190.2913773148148,3,723,144,867
2023-08-24 12:10:48,0.10364583333333334,1,13,1,14
2023-08-28 17:40:09,4.861689814814815,1,14,12,26
2023-08-24 07:59:13,0.4681828703703704,1,13,13,26
2023-08-24 07:56:23,0.5252314814814815,1,1,100,101
2023-08-24 07:03:40,0.600474537037037,1,8,6,14
2023-08-24 12:43:44,0.8379050925925926,1,3,3,6
2023-08-23 13:40:09,0.027870370370370372,1,1,1,2
2023-08-23 13:45:22,0.045960648148148146,1,3,3,6
2023-08-29 08:53:02,6.504375,1,4,4,8
2023-08-23 13:40:31,0.7110416666666667,1,5,3,8
2023-08-23 06:18:08,0.41173611111111114,1,38,11,49
2023-08-23 06:22:49,0.4002777777777778,1,53,53,106
2023-09-22 14:41:51,30.89258101851852,1,24,33,57
2023-08-23 13:43:42,0.8584722222222222,1,9,6,15
2023-08-23 06:44:56,14.490729166666666,2,9,7,16
2023-08-23 06:26:30,0.565324074074074,1,3,3,6
2023-08-23 13:44:52,0.9219675925925926,1,8,9,17
2023-08-22 16:51:33,0.07453703703703704,1,1,1,2
2023-09-26 09:25:02,34.934953703703705,1,77,0,77
2023-09-11 14:09:23,20.163101851851852,3,149,162,311
2023-08-22 11:24:16,0.04774305555555555,1,11,0,11
2023-08-22 14:47:19,0.1783449074074074,1,5,2,7
2023-08-24 12:43:00,2.8088888888888888,1,10,4,14
2023-08-22 14:47:40,0.32038194444444446,1,1,1,2
2023-08-22 07:12:00,0.028645833333333332,2,44,6,50
2023-08-24 11:07:27,2.2459375,5,31,31,62
2023-08-23 06:27:25,1.460775462962963,1,5,2,7
2023-09-01 15:47:08,10.877222222222223,18,933,49,982
2023-09-01 15:44:28,10.890069444444444,21,2587,1234,3821
2023-08-21 18:18:49,0.3015393518518519,1,27,8,35
2023-08-29 08:56:20,7.745497685185185,1,85,13,98
2023-11-14 15:39:31,85.03555555555556,1,1,1,2
2023-08-29 12:42:20,7.968032407407407,2,2462,941,3403
2023-08-21 13:47:09,0.09483796296296296,1,31,44,75
2023-09-04 09:00:56,6.073055555555555,1,1,1,2
2023-08-21 08:13:21,0.29247685185185185,1,197,168,365
2023-11-03 15:00:21,75.19728009259259,14,984,881,1865
2023-08-31 11:46:27,11.446099537037037,5,109,32,141
2023-08-21 07:06:33,2.4763888888888888,1,3,3,6
2023-08-29 08:16:19,10.641493055555555,3,9,72,81
2023-08-18 16:20:56,0.08033564814814814,1,65,10,75
2023-08-18 14:06:46,0.016979166666666667,1,3,5,8
2023-08-18 16:24:32,0.44298611111111114,3,345,265,610
2023-08-18 06:33:34,0.12153935185185186,1,1,1,2
2023-08-18 09:10:05,0.23049768518518518,1,3,3,6
2023-08-23 13:45:57,4.5140625,1,3,3,6
2023-08-18 10:06:09,0.5702546296296296,1,234,237,471
2023-08-18 06:18:41,21.541747685185186,6,86,11,97
2024-01-25 10:42:41,160.92744212962964,4,73509,52179,125688
2023-08-17 10:49:52,0.04027777777777778,1,3,3,6
2023-08-23 13:45:39,6.5521875,1,1,1,2
2023-08-17 14:43:37,0.5928703703703704,1,3,3,6
2023-08-23 13:46:15,6.903738425925926,1,43,4,47
2023-08-21 14:09:26,4.9915972222222225,1,26,0,26
2023-08-16 14:38:33,0.06225694444444444,2,7,1,8
2023-08-17 07:13:27,0.820925925925926,1,20,7,27
2023-08-16 09:47:59,0.0837962962962963,2,2,2,4
2023-08-16 07:08:57,0.40650462962962963,1,3,3,6
2023-08-18 06:32:47,2.763310185185185,1,3,0,3
2023-08-21 17:39:02,4.9089583333333335,5,524,152,676
2023-09-13 13:10:42,0.03167824074074074,1,6748,1294,8042
2023-08-16 07:06:04,1.1822916666666667,1,2,1,3
2023-08-14 21:42:31,0.14199074074074075,1,80,0,80
2023-08-14 17:00:57,0.019560185185185184,1,6,0,6
2023-11-08 13:21:15,85.88203703703704,1,1,1,2
2023-08-14 16:54:51,0.0783912037037037,1,22,1,23
2023-08-14 16:52:45,0.0780787037037037,1,131,689,820
2023-08-14 15:46:16,5.8000694444444445,1,35,12,47
2023-08-14 17:02:47,0.15489583333333334,1,2,7,9
2023-08-14 12:53:13,0.015636574074074074,1,9,9,18
2023-08-28 10:19:43,13.918425925925925,2,11,18,29
2023-08-14 12:10:46,0.021608796296296296,1,1,1,2
2023-08-14 11:38:41,0.06159722222222222,1,1,1,2
2023-08-14 11:39:30,0.06243055555555556,1,12,12,24
2023-09-12 16:27:02,29.284375,1,6,1,7
2023-08-13 00:06:05,0.3646875,1,1,1,2
2023-08-14 10:04:04,3.092719907407407,2,9,4,13
2023-08-14 07:40:07,1.9443171296296295,1,4,10,14
2023-08-11 22:06:37,0.09325231481481482,1,4,1,5
2023-08-23 13:51:07,11.988530092592592,3,3,2,5
2023-08-21 14:50:22,10.07394675925926,11,118,20,138
2023-08-14 07:38:09,2.8735416666666667,1,10,2,12
2023-08-14 12:54:32,0.3537268518518519,2,461,221,682
2023-08-11 07:59:58,0.5016435185185185,3,513,560,1073
2023-08-10 19:51:48,0.09363425925925926,1,0,2,2
2023-10-23 15:46:38,74.14486111111111,5,211,75,286
2023-08-10 12:15:19,0.1936226851851852,1,8,2,10
2023-08-10 08:23:01,0.049756944444444444,1,6,5,11
2023-08-10 08:23:38,0.050798611111111114,1,4,3,7
2023-08-10 08:39:47,0.06261574074074074,1,7,1,8
2023-08-10 08:24:34,0.05244212962962963,1,4,4,8
2023-08-10 09:07:16,0.015439814814814814,1,17,34,51
2023-08-10 08:44:00,0.012777777777777779,1,56,56,112
2023-08-10 09:07:34,0.004247685185185185,1,1,6,7
2023-08-10 08:59:42,0.07856481481481481,1,11,5,16
2023-08-10 07:48:41,0.029409722222222223,1,2,6,8
2023-08-10 07:50:22,0.03076388888888889,1,1,1,2
2023-08-10 07:47:55,0.02929398148148148,1,2,2,4
2023-08-10 08:44:14,0.06868055555555555,1,4,3,7
2023-08-10 09:01:41,0.014131944444444445,1,210,195,405
2023-08-29 08:17:57,19.64554398148148,1,5,3,8
2023-08-09 14:32:40,0.029988425925925925,1,1,1,2
2023-08-09 11:15:04,0.5107638888888889,1,9,5,14
2023-08-17 14:11:48,8.184814814814814,3,36,4,40
2023-08-09 09:26:57,0.4106828703703704,1,0,0,0
2023-08-29 08:20:36,20.50960648148148,3,3747,2526,6273
2023-08-09 09:58:46,0.665,1,3,0,3
2023-08-09 07:39:37,0.6355208333333333,1,25,1,26
2023-08-09 09:26:43,0.81,5,74,21,95
2023-08-08 13:41:38,0.01704861111111111,1,3,1,4
2023-08-08 11:59:40,0.010405092592592593,1,6,6,12
2023-08-08 09:41:53,0.05775462962962963,1,1,1,2
2023-08-21 06:51:37,13.641076388888889,1,7,9,16
2023-08-08 07:09:14,0.4631018518518519,1,144,89,233
2023-08-08 07:09:58,0.6152314814814814,1,13,1,14
2023-08-10 07:47:43,0.14108796296296297,2,652,191,843
2023-08-07 15:59:21,0.2606597222222222,1,11,2,13
2023-08-07 15:58:29,0.3726041666666667,3,16,35,51
2023-08-07 07:46:11,0.4113773148148148,1,118,28,146
2023-08-31 10:17:10,25.902118055555555,4,11,7,18
2023-08-24 14:40:05,19.98238425925926,13,770,273,1043
2023-08-04 14:13:48,0.05344907407407407,1,1,1,2
2023-08-04 13:48:29,0.06310185185185185,1,2,9,11
2023-08-04 14:25:44,0.11599537037037037,1,5,4,9
2023-08-08 14:12:13,4.206493055555556,1,237,3,240
2023-08-03 18:39:46,0.8218171296296296,1,12,2,14
2023-08-22 07:31:40,18.55465277777778,5,51,77,128
2023-08-03 14:17:09,0.01138888888888889,1,4,4,8
2023-08-09 20:21:41,0.3228125,1,207,164,371
2023-08-03 14:17:22,0.08533564814814815,1,1,1,2
2023-08-03 14:29:18,0.012569444444444444,1,2,2,4
2023-08-03 14:11:37,0.08226851851851852,1,8,7,15
2023-08-03 14:10:55,0.0821412037037037,1,3,3,6
2023-08-03 14:10:42,0.08216435185185185,1,1,1,2
2023-08-09 20:19:12,6.338333333333333,1,9,4,13
2023-08-03 14:10:23,0.08238425925925925,1,3,3,6
2023-08-04 07:00:32,0.7864583333333334,1,1,1,2
2023-08-03 14:10:11,0.0943287037037037,1,1,1,2
2023-08-04 07:41:17,0.8578472222222222,1,4,0,4
2023-08-03 18:28:14,0.37305555555555553,3,33,4,37
2023-08-14 10:08:44,11.494270833333333,7,4181,2176,6357
2023-08-03 09:04:05,0.5095486111111112,1,11,13,24
2023-08-03 18:39:34,0.9163078703703704,1,1,1,2
2023-08-02 23:51:10,1.208599537037037,1,27,1,28
2023-08-04 14:11:30,1.8372453703703704,4,188,64,252
2023-08-03 08:05:35,0.6365972222222223,1,1,1,2
2023-08-18 13:05:35,15.966597222222223,1,5,0,5
2023-08-01 23:57:31,0.2625,1,9,9,18
2023-08-02 02:17:23,0.3685763888888889,1,2,0,2
2023-08-02 17:32:29,0.9956018518518519,2,73,14,87
2023-08-02 15:24:32,0.9744791666666667,2,504,44,548
2023-08-14 16:47:43,13.084710648148148,1,3,3,6
2023-08-02 17:33:41,1.3231018518518518,1,12,3,15
2023-07-31 19:11:25,4.168935185185185,1,12,4,16
2023-07-31 09:17:41,0.0171875,1,4,1,5
2023-08-01 12:52:33,1.2296875,1,1,1,2
2023-08-01 15:11:31,1.3443865740740741,1,3,0,3
2023-08-01 17:34:11,1.8421064814814814,2,87,36,123
2023-07-29 20:28:06,0.011585648148148149,1,0,16,16
2023-08-02 17:32:49,3.977222222222222,1,57,55,112
2023-07-30 01:35:17,3.1517013888888887,1,97,61,158
2023-07-29 18:18:38,0.290474537037037,1,1,1,2
2023-08-23 13:50:24,25.76380787037037,1,9,2,11
2023-08-31 11:53:24,33.694085648148146,1,53,18,71
2023-07-28 17:11:59,0.04420138888888889,1,5,3,8
2023-07-28 15:59:32,0.0627662037037037,1,1,1,2
2023-07-28 10:06:29,82.34325231481482,3,18,10,28
2023-08-03 11:53:25,6.129560185185185,1,4,4,8
2023-07-28 08:45:52,0.42627314814814815,1,2,2,4
2023-07-31 21:17:38,4.121921296296296,8,154,15,169
2023-07-28 21:11:05,1.2129050925925926,3,33,18,51
2023-07-27 13:38:19,1.7784259259259259,7,140,82,222
2023-08-02 18:54:56,6.426585648148148,1,3,3,6
2023-08-07 11:37:55,0.30122685185185183,2,1093,579,1672
2023-07-28 21:02:08,2.107627314814815,1,179,527,706
2023-07-27 12:27:22,0.8630555555555556,1,12,18,30
2023-07-28 21:11:45,3.0581944444444447,1,11,55,66
2023-07-27 14:11:57,1.2353935185185185,1,30,1,31
2023-08-03 13:41:51,8.754583333333333,7,4671,4499,9170
2023-07-26 07:44:52,0.4996875,1,8,1,9
2023-07-26 07:45:27,0.4998148148148148,1,2,0,2
2023-07-26 07:45:51,0.498912037037037,1,31,4,35
2023-07-26 07:46:11,0.5019097222222222,1,8,1,9
2023-07-26 07:49:15,0.5035879629629629,1,33,4,37
2023-07-26 07:50:49,0.5043402777777778,1,39,4,43
2023-07-27 14:19:33,1.780462962962963,1,3,4,7
2023-07-25 18:29:32,0.09973379629629629,1,30,9,39
2023-07-26 01:33:31,0.4294212962962963,1,5,1,6
2023-07-25 13:32:59,0.02003472222222222,1,12,4,16
2023-07-25 11:39:15,0.040706018518518516,1,5,0,5
2023-07-27 13:12:10,2.2755092592592594,1,19,17,36
2023-07-24 22:57:16,0.14224537037037038,1,47,13,60
2023-07-25 11:40:35,0.8103125,1,225,221,446
2023-07-24 17:53:33,0.07475694444444445,1,4,1,5
2023-07-24 15:55:36,0.015219907407407408,1,1,1,2
2023-07-24 21:01:32,0.23431712962962964,1,6,3,9
2023-07-25 07:46:57,0.7054513888888889,11,232,80,312
2023-07-25 12:45:36,0.9342708333333334,1,3,3,6
2023-07-24 14:18:20,0.008252314814814815,1,2,2,4
2023-07-24 14:03:50,0.013495370370370371,1,3,3,6
2023-07-24 14:06:32,0.03799768518518518,1,1,1,2
2023-07-24 13:43:09,0.06707175925925926,1,1,1,2
2023-07-24 11:48:10,0.3374652777777778,1,14,7,21
2023-07-24 11:47:29,0.552337962962963,1,89,98,187
2023-07-24 20:04:38,0.9519560185185185,1,14,4,18
2023-07-24 11:46:55,0.7764699074074074,1,160,286,446
2023-07-24 12:05:12,0.8393287037037037,1,1,1,2
2023-09-28 14:22:05,68.74190972222222,1,16,8,24
2023-07-23 15:55:20,0.08648148148148148,1,1,3,4
2023-07-23 15:55:14,0.09103009259259259,1,42,36,78
2023-07-23 13:57:57,3.8262037037037038,3,10,6,16
2023-07-23 15:48:16,0.8536458333333333,1,1,7,8
2023-07-22 18:42:31,0.3278240740740741,1,2,2,4
2023-07-23 13:58:20,1.2663773148148147,1,1,0,1
2023-07-24 15:56:21,2.4456944444444444,4,3,3,6
2023-07-24 11:48:23,2.670983796296296,2,5,3,8
2023-07-21 19:12:57,0.044131944444444446,1,2,0,2
2023-07-21 19:13:21,0.07042824074074074,1,1,1,2
2023-07-21 19:23:15,0.2864467592592593,1,24,4,28
2023-07-21 12:21:11,0.035208333333333335,1,15,15,30
2023-07-21 11:34:15,3.0383333333333336,1,28,1,29
2023-07-21 09:14:27,0.6763773148148148,1,14,6,20
2023-11-07 22:02:44,89.62166666666667,1,1,1,2
2023-10-26 14:08:41,100.4168287037037,3,7,7,14
2023-08-01 17:34:41,13.007013888888888,7,4728,5633,10361
2023-08-03 14:43:15,20.247685185185187,3,84,35,119
2023-07-27 14:13:45,7.815057870370371,1,16,3,19
2023-07-27 14:11:17,84.17412037037037,16,1013,1422,2435
2023-07-21 09:30:53,2.0199189814814815,1,1,1,2
2023-07-26 11:46:17,0.30679398148148146,2,1073,1840,2913
2023-07-20 12:46:02,1.697974537037037,1,1,0,1
2023-07-28 21:07:22,10.10818287037037,1,11,4,15
2023-09-28 13:40:28,72.6910300925926,5,38,29,67
2023-09-28 14:36:25,72.74886574074074,1,35,34,69
2023-09-28 14:23:36,72.7359837962963,1,19,18,37
2023-07-18 16:10:52,0.8066550925925926,2,22,24,46
2023-09-28 13:48:48,72.00479166666666,1,18,34,52
2023-07-18 15:43:05,6.710775462962963,2,3,3,6
2023-07-18 15:25:42,6.701006944444444,2,3,3,6
2023-07-18 15:02:02,6.683055555555556,3,4,4,8
2023-07-18 14:56:43,0.05670138888888889,2,14,4,18
2023-07-18 18:51:20,0.2577777777777778,1,17,7,24
2023-07-18 19:13:25,0.2704050925925926,3,8151,13890,22041
2023-09-28 14:52:37,72.72556712962962,2,5,58,63
2023-07-19 06:44:16,1.3624421296296296,3,6,431,437
2023-07-18 07:24:49,0.38525462962962964,1,1,1,2
2023-07-18 07:25:37,0.49525462962962963,1,16,20,36
2023-10-03 13:00:41,83.6126736111111,2,29,18,47
2023-07-20 13:13:07,2.1566203703703706,1,5,5,10
2023-07-20 15:03:40,8.688715277777778,1,5,5,10
2023-07-17 11:13:43,0.017418981481481483,1,4,4,8
2023-07-17 12:07:36,0.060034722222222225,1,11,11,22
2023-07-17 10:40:55,0.0184375,1,1,1,2
2023-07-17 10:13:02,0.02238425925925926,1,3,3,6
2023-07-17 09:39:36,0.015509259259259259,1,3,3,6
2023-07-17 11:56:28,0.11603009259259259,2,81,0,81
2023-07-17 10:10:51,0.0797337962962963,1,8,8,16
2024-03-01 17:36:16,228.4032175925926,1,1,0,1
2023-07-21 11:17:43,4.146851851851852,1,7,1,8
2023-07-17 10:15:32,0.15241898148148147,1,0,6,6
2023-07-17 13:51:30,0.33806712962962965,2,3,1,4
2023-08-31 10:18:47,45.45357638888889,3,40,16,56
2023-07-17 07:38:12,0.4057175925925926,1,78,66,144
2024-01-09 11:01:33,176.59758101851853,5,49,17,66
2023-09-04 11:21:43,49.63065972222222,6,56,57,113
2023-08-22 15:50:04,36.835532407407406,1,1,0,1
2023-08-22 14:53:28,36.820462962962964,1,1,0,1
2023-07-20 13:17:41,3.7870833333333334,1,1,1,2
2023-07-21 17:09:13,4.9641319444444445,1,43,43,86
2023-07-18 11:36:12,1.7925347222222223,2,202,128,330
2023-07-17 07:33:23,0.7253819444444445,1,20,4,24
2023-07-16 08:06:33,0.030393518518518518,1,1,0,1
2023-07-17 10:40:27,0.5289236111111111,1,4,10,14
2023-07-17 09:51:01,2.5147916666666665,1,1,1,2
2023-10-31 11:10:24,108.73649305555556,1,3,3,6
2023-07-17 06:26:52,3.6020601851851852,1,34,14,48
2023-07-17 12:08:56,5.569120370370371,2,5,5,10
2023-07-17 13:38:05,5.634178240740741,1,4,4,8
2023-07-13 15:59:15,0.02079861111111111,1,5,3,8
2023-11-09 09:12:29,16.63357638888889,1,10,12,22
2023-07-17 10:39:50,0.6028935185185185,1,8,8,16
2023-07-13 10:58:56,0.011307870370370371,1,13,1,14
2023-07-13 13:53:03,2.2417708333333333,3,196,78,274
2023-10-23 17:58:46,40.22809027777778,9,122,89,211
2023-07-13 10:19:54,0.011585648148148149,1,3,3,6
2023-07-13 10:20:04,0.011875,1,3,3,6
2023-07-13 11:34:39,0.06621527777777778,1,0,7,7
2023-07-13 09:20:22,0.008125,1,22,23,45
2023-07-13 09:17:46,0.00917824074074074,1,3,3,6
2023-07-17 14:57:18,5.682916666666666,1,3,3,6
2023-07-17 16:18:14,5.746458333333333,1,7,7,14
2023-07-17 13:07:29,5.623379629629629,1,23,23,46
2023-07-13 09:12:51,0.6606481481481481,1,1,1,2
2023-07-13 13:52:37,0.937974537037037,2,8,29,37
2023-07-13 09:07:26,0.750011574074074,1,1,1,2
2023-07-20 16:23:48,8.188657407407407,4,101,54,155
2023-07-21 11:20:15,10.196284722222222,1,51,74,125
2023-07-12 12:19:51,0.2170601851851852,1,2,2,4
2023-07-12 01:02:32,0.1295601851851852,1,11,6,17
2023-07-12 07:05:18,0.3709375,1,176,125,301
2023-07-12 10:31:11,0.5217361111111111,1,7,57,64
2023-07-12 08:08:52,0.44090277777777775,1,9,22,31
2023-07-26 13:39:53,14.693344907407408,1,0,19,19
2023-07-17 14:10:44,5.721724537037037,1,1,1,2
2023-07-12 08:03:19,0.4820138888888889,1,2,6,8
2023-07-12 08:03:07,0.507650462962963,1,13,28,41
2023-07-20 15:31:35,8.875243055555556,1,0,11,11
2023-07-12 08:02:41,0.5739236111111111,1,6,15,21
2023-07-12 08:02:33,0.5659027777777778,1,4,9,13
2023-07-11 21:30:21,0.15447916666666667,1,3,3,6
2023-07-11 17:52:37,0.002962962962962963,1,1,1,2
2023-07-27 14:51:02,15.893368055555555,1,2,2,4
2023-07-12 07:51:59,0.6188888888888889,1,1,0,1
2023-07-28 21:17:54,17.290659722222223,1,3,92,95
2023-07-11 17:40:51,0.08075231481481482,1,2,11,13
2023-07-11 15:08:38,0.04082175925925926,1,3,3,6
2023-07-13 09:49:17,1.968900462962963,1,134,108,242
2023-07-11 10:26:09,3.4228703703703705,1,10,82,92
2023-07-13 09:26:46,2.004976851851852,1,83,62,145
2023-09-18 15:41:33,69.5171875,2,2,2,4
2023-07-13 15:18:09,2.7500115740740743,2,77,19,96
2023-07-20 13:50:50,9.799502314814815,1,14,26,40
2023-07-10 17:33:08,0.016944444444444446,1,1,0,1
2023-07-10 16:42:19,0.010787037037037038,1,3,0,3
2023-07-10 16:42:11,0.01275462962962963,1,1,1,2
2023-10-20 13:32:17,106.67741898148148,1,27,40,67
2023-07-12 12:19:20,6.687604166666667,2,20,31,51
2023-10-19 15:25:54,105.78446759259259,1,47,36,83
2023-07-12 08:44:58,6.490127314814814,1,52,63,115
2023-10-17 13:58:42,103.64964120370371,1,5,25,30
2023-07-12 15:06:01,2.0361226851851852,1,31,11,42
2023-07-18 14:56:01,8.174907407407407,3,128,12,140
2023-07-10 16:26:57,0.08581018518518518,5,222,149,371
2023-07-11 12:53:59,1.602835648148148,1,1,1,2
2023-07-12 16:57:40,3.0119212962962965,1,4,1,5
2023-07-10 01:06:09,0.3841435185185185,1,23,4,27
2023-07-08 18:16:49,0.022928240740740742,1,38,14,52
2023-07-08 18:02:14,0.12141203703703704,1,0,35,35
2023-07-12 10:31:24,4.0636226851851855,2,133,127,260
2023-07-11 12:52:01,3.656458333333333,1,1,1,2
2023-07-07 22:12:32,0.1158912037037037,1,5,3,8
2023-07-07 17:42:04,0.05618055555555555,1,9,1,10
2023-07-07 17:31:55,0.018449074074074073,1,3,1,4
2023-09-01 13:41:10,55.93005787037037,2,44,9,53
2023-10-13 12:04:38,97.83663194444445,2,113,72,185
2023-07-07 16:10:18,0.011168981481481481,1,1,1,2
2023-07-07 16:10:01,0.024386574074074074,1,1,1,2
2023-07-07 11:35:22,0.07626157407407408,2,19,1,20
2023-07-07 11:35:55,0.5435763888888889,1,2,2,4
2023-07-28 21:17:35,22.25082175925926,1,5,3,8
2023-07-07 12:15:54,0.8890393518518519,1,1,1,2
2023-07-08 18:03:38,2.716064814814815,5,45,41,86
2023-07-06 13:14:43,15.250844907407407,1,49,1,50
2023-07-06 12:31:38,15.009421296296296,1,7,0,7
2023-07-08 09:07:20,2.6055555555555556,1,28,64,92
2023-07-18 07:15:19,12.43505787037037,2,110,57,167
2023-07-17 14:20:11,11.853981481481481,1,101,44,145
2023-10-13 14:23:17,100.00168981481481,1,129,52,181
2023-07-05 08:32:05,0.3655787037037037,1,10,4,14
2023-07-27 12:58:21,22.74829861111111,1,248,124,372
2023-07-08 18:04:22,3.987025462962963,1,0,5,5
2023-07-10 01:06:23,5.3403125,12,142,124,266
2023-07-08 18:00:13,4.0275694444444445,1,12,10,22
2023-07-05 09:25:28,0.6855671296296296,1,2,0,2
2023-07-08 18:00:53,4.048333333333333,1,103,101,204
2023-07-04 16:58:24,0.009166666666666667,1,1,1,2
2023-07-08 18:05:33,4.0996296296296295,1,26,21,47
2023-07-04 16:36:24,0.07469907407407407,1,4,1,5
2023-07-04 12:57:47,0.018020833333333333,1,8,2,10
2023-07-04 09:25:30,0.008425925925925925,1,9,0,9
2023-07-03 22:37:57,0.04883101851851852,1,1,1,2
2023-07-08 17:45:37,4.853483796296296,7,43,33,76
2023-07-17 14:22:34,20.784548611111113,2,75,49,124
2023-07-03 20:58:10,0.2834143518518519,1,1,1,2
2023-07-03 20:57:19,0.3201967592592593,1,19,16,35
2023-07-18 07:02:46,14.759629629629629,4,16,4,20
2023-07-03 16:06:57,0.13320601851851852,3,44,15,59
2023-07-03 14:51:04,0.1959837962962963,1,2,2,4
2023-07-03 09:32:32,1.7970023148148149,1,66,96,162
2023-07-02 17:41:35,0.09596064814814814,2,2,19,21
2023-07-02 14:56:17,0.06644675925925926,1,11,1,12
2023-07-02 14:08:58,0.049965277777777775,1,18,0,18
2023-07-13 07:36:07,111.526875,11,261,148,409
2023-07-02 09:14:22,0.0029976851851851853,1,144,242,386
2023-07-02 09:12:17,6.931724537037037,2,16,4,20
2023-07-02 08:39:55,0.4442361111111111,1,1,1,2
2023-07-01 22:04:22,0.34866898148148145,1,1,1,2
2023-10-03 15:01:45,94.06229166666667,2,3,7,10
2023-07-27 14:05:25,26.962337962962962,2,65,25,90
2023-06-30 17:09:03,0.09300925925925926,1,11,1,12
2023-07-01 22:05:11,2.2425810185185187,2,454,232,686
2023-07-10 18:58:13,11.188275462962963,2,11,15,26
2023-06-29 12:48:54,0.1349189814814815,2,48,3,51
2023-07-17 14:24:05,18.75673611111111,1,131,57,188
2023-10-13 12:08:21,106.88496527777778,1,72,29,101
2023-06-28 12:57:51,0.1957986111111111,1,0,1,1
2023-07-13 09:11:55,8.679201388888888,1,7,7,14
2023-07-17 14:53:57,19.81278935185185,1,143,123,266
2023-07-01 19:48:17,4.14150462962963,2,140,11,151
2023-07-17 14:51:50,19.895960648148147,1,155,113,268
2023-07-18 11:05:20,20.863125,1,90,65,155
2023-07-21 08:46:12,23.811782407407406,1,141,56,197
2023-06-30 14:32:12,3.096840277777778,1,1,1,2
2023-06-30 12:59:07,3.09875,1,0,4,4
2023-06-27 09:28:07,0.06503472222222222,1,1,1,2
2023-11-13 14:06:38,0.027743055555555556,1,435,395,830
2023-06-27 08:20:47,0.01972222222222222,1,3,3,6
2023-06-27 10:16:18,0.10056712962962963,1,6,7,13
2023-06-27 08:20:10,0.02025462962962963,1,3,3,6
2023-06-27 08:19:52,0.02021990740740741,1,54,54,108
2023-06-27 08:21:55,0.022094907407407407,1,3,3,6
2023-06-27 08:36:22,0.03229166666666667,1,19,14,33
2023-06-27 10:32:51,0.11548611111111111,1,3,3,6
2023-06-29 11:05:22,2.6786226851851853,3,97,36,133
2023-07-17 14:50:01,20.78615740740741,1,47,37,84
2023-07-01 22:05:44,5.147534722222222,1,9,0,9
2023-07-28 21:12:09,40.17381944444445,1,68,6,74
2023-10-16 13:41:24,119.86149305555556,2,110,12,122
2023-07-28 21:12:26,40.17446759259259,3,70,23,93
2023-10-17 11:05:28,120.75270833333333,1,120,28,148
2023-06-27 07:36:12,0.6958680555555555,1,9,1,10
2023-06-26 14:38:20,0.010983796296296297,1,1,1,2
2023-09-22 16:18:47,30.955567129629628,1,69,41,110
2023-06-30 15:03:25,4.143587962962963,1,19,1,20
2023-07-13 09:28:55,16.979108796296295,1,114,87,201
2023-07-08 09:12:20,11.971087962962963,1,54,62,116
2023-06-26 10:30:35,0.03170138888888889,1,2,2,4
2023-06-26 10:31:48,0.06728009259259259,2,18,7,25
2023-06-26 03:26:54,0.19034722222222222,1,12,5,17
2023-07-01 19:48:54,6.082685185185185,5,4,6,10
2023-06-26 03:27:07,0.3575462962962963,1,22,40,62
2023-06-26 03:26:42,0.3924884259259259,1,17,8,25
2023-07-08 18:01:09,14.944918981481482,1,145,84,229
2023-10-16 13:49:12,114.78646990740741,2,401,176,577
2023-06-24 15:24:31,0.9644328703703704,1,17,1,18
2023-06-23 14:34:27,0.747337962962963,1,101,56,157
2023-06-23 12:44:55,0.2798611111111111,2,3,5,8
2023-06-22 15:54:43,0.035104166666666665,1,13,4,17
2023-10-16 15:15:25,116.02708333333334,1,183,137,320
2023-07-12 08:20:11,113.82247685185185,2,2143,1609,3752
2023-07-12 08:02:20,113.78431712962963,2,2091,1520,3611
2023-06-22 12:51:54,0.7354861111111111,1,19,214,233
2023-10-23 15:46:38,123.9430787037037,4,202,122,324
2023-10-13 14:14:23,114.8205787037037,1,38,10,48
2023-07-08 09:11:22,16.849340277777777,1,51,66,117
2023-06-22 09:49:35,0.8839351851851852,1,103,37,140
2023-06-22 10:10:50,2.7156712962962963,1,10,0,10
2023-10-13 13:50:47,114.90939814814814,1,6,14,20
2023-06-22 09:53:29,1.7630439814814816,1,47,34,81
2023-06-20 16:10:19,0.0784837962962963,2,18,4,22
2023-07-18 07:15:51,28.48670138888889,3,74,93,167
2023-06-20 16:04:35,0.864849537037037,3,30,14,44
2023-10-13 12:19:13,115.75311342592593,2,73,82,155
2023-10-16 14:03:36,118.87511574074074,4,89,77,166
2023-10-13 12:42:09,118.67800925925926,1,181,746,927
2023-06-20 16:16:48,1.1219097222222223,4,161,62,223
2023-06-20 16:32:15,1.1354976851851852,1,1,1,2
2023-06-22 12:56:15,3.124212962962963,1,6,1,7
2023-06-22 16:46:43,3.3104282407407406,1,6,0,6
2023-06-19 13:06:07,0.1702662037037037,1,14,1,15
2023-06-19 09:29:00,0.09989583333333334,1,6,3,9
2023-06-22 16:46:33,3.9175115740740742,1,1,9,10
2023-06-20 16:32:27,2.146215277777778,1,6,10,16
2023-06-18 13:47:04,0.05443287037037037,1,2,2,4
2023-07-13 09:44:03,0.01912037037037037,2,2,2,4
2023-07-08 09:11:59,20.132164351851852,6,182,207,389
2023-06-19 07:05:43,1.6796296296296296,1,20,31,51
2023-06-19 07:04:16,1.73,1,0,9,9
2023-06-19 07:50:35,2.4573958333333334,1,55,0,55
2023-06-19 12:11:46,2.375046296296296,4,43,45,88
2023-06-19 07:03:50,2.360775462962963,1,1,1,2
2023-06-21 15:58:01,4.783819444444444,1,1,1,2
2023-06-19 06:53:05,2.435023148148148,1,16,0,16
2023-10-13 13:30:41,118.73122685185186,1,106,0,106
2023-10-13 12:43:51,118.83498842592593,2,66,27,93
2023-06-19 11:48:26,2.8479976851851854,3,27,17,44
2023-06-22 12:55:23,93.91715277777777,1,162,172,334
2023-10-16 14:03:49,121.97512731481481,3,214,116,330
2023-06-22 12:53:13,5.973912037037037,1,12,18,30
2023-06-20 16:15:36,4.182199074074074,1,2,2,4
2023-06-22 12:52:25,6.104583333333333,1,52,7,59
2023-06-16 10:03:07,0.019733796296296298,1,1,1,2
2023-07-28 21:09:50,42.52366898148148,15,339,46,385
2023-06-16 12:23:58,0.6303935185185185,1,4,4,8
2023-06-15 21:14:46,0.33613425925925927,1,0,17,17
2023-10-16 13:38:27,122.92671296296297,2,0,571,571
2023-10-13 13:19:41,119.84921296296297,1,21,20,41
2023-06-15 08:41:04,0.01835648148148148,1,1,1,2
2023-10-24 08:06:30,132.31613425925926,10,70,51,121
2023-06-15 08:19:51,0.5398611111111111,1,247,80,327
2023-06-19 06:51:40,4.567453703703704,1,169,90,259
2023-07-28 21:09:20,44.21259259259259,1,5,5,10
2023-06-15 08:13:13,0.6652314814814815,1,1086,1365,2451
2023-06-26 18:59:59,5.431377314814815,1,3,3,6
2023-06-15 07:36:10,0.695474537037037,1,1,18,19
2023-06-14 16:32:55,0.06861111111111111,1,3,3,6
2023-06-14 16:15:33,0.057164351851851855,1,1,1,2
2023-06-14 16:12:33,0.055185185185185184,1,212,183,395
2023-06-14 09:23:54,0.004097222222222223,1,42,17,59
2023-06-14 09:18:38,0.014085648148148147,1,1,1,2
2023-06-14 09:16:36,0.07023148148148148,1,229,279,508
2023-06-14 08:56:23,0.06497685185185186,1,62,68,130
2023-08-07 15:58:12,54.821296296296296,8,37,63,100
2023-06-14 14:08:54,0.7320601851851852,1,125,69,194
2023-06-14 02:38:08,0.9295138888888889,1,124,263,387
2023-06-14 13:43:51,0.7904398148148148,2,129,82,211
2023-06-14 07:57:06,0.5589004629629629,2,13,10,23
2023-06-14 07:21:30,0.5788888888888889,1,1,1,2
2023-06-14 07:56:12,0.660787037037037,8,60,59,119
2023-06-14 07:22:55,0.6101851851851852,2,785,723,1508
2023-06-14 07:48:57,0.6533564814814815,1,44,45,89
2023-06-14 07:48:48,0.7358564814814815,1,42,15,57
2023-06-13 13:05:40,0.0012037037037037038,1,4,0,4
2023-06-14 06:54:53,0.7757291666666667,1,28,11,39
2023-06-14 07:05:03,1.548298611111111,1,3,6,9
2023-06-13 20:30:41,1.1156712962962962,1,16,6,22
2023-10-17 11:32:10,126.65966435185184,15,469,599,1068
2023-06-13 12:59:05,0.7251620370370371,1,0,89,89
2023-10-16 15:52:06,125.85440972222223,2,40,104,144
2023-06-14 07:34:02,1.5207523148148148,2,23,256,279
2023-06-14 13:21:37,1.820636574074074,3,21,0,21
2023-07-28 21:16:24,46.29657407407407,3,16,0,16
2023-06-12 15:37:43,0.07658564814814815,1,1,1,2
2023-06-12 12:22:47,0.2214236111111111,1,106,11,117
2023-06-13 16:42:51,1.025763888888889,1,14,18,32
2024-01-10 11:12:30,213.74449074074073,1,66,76,142
2023-06-13 17:26:26,2.6111921296296297,3,79,82,161
2023-06-11 02:47:18,0.013726851851851851,2,19,24,43
2023-06-10 16:24:38,0.026180555555555554,1,1,1,2
2023-06-10 16:29:01,0.7677546296296296,1,58,58,116
2023-06-10 16:27:35,0.9974305555555556,1,9,3,12
2023-06-11 02:47:08,7.0087268518518515,1,3,3,6
2023-06-10 16:30:43,0.8686342592592593,1,292,111,403
2023-10-16 15:20:29,129.80157407407407,9,187,0,187
2023-06-09 12:03:36,0.6274884259259259,1,0,10,10
2023-06-10 01:29:37,6.278888888888889,1,32,17,49
2023-07-08 18:00:02,35.11265046296296,1,45,19,64
2023-06-08 15:12:41,0.7327083333333333,1,1,1,2
2023-06-09 12:00:14,1.7044444444444444,1,62,115,177
2023-06-07 20:46:54,0.14436342592592594,1,0,6,6
2023-06-10 16:32:08,2.9158449074074073,1,284,180,464
2023-06-10 16:32:27,3.069872685185185,1,215,141,356
2023-06-10 16:32:47,3.103900462962963,1,275,309,584
2023-06-10 16:33:02,3.144502314814815,2,307,360,667
2023-06-07 10:05:06,0.012789351851851852,1,21,16,37
2023-06-06 23:53:51,0.19756944444444444,2,14,3,17
2023-06-10 16:33:24,21.26189814814815,3,53,14,67
2023-10-16 13:37:23,135.9303587962963,2,28,0,28
2023-06-10 16:37:36,8.940486111111111,5,76,2,78
2023-06-09 14:34:36,2.994212962962963,1,6,0,6
2023-06-06 16:53:43,0.11377314814814815,2,6,1,7
2023-06-07 09:44:09,0.5907175925925926,1,25,11,36
2023-06-10 16:38:22,84.06881944444444,1,186,120,306
2023-07-12 07:49:33,115.69690972222222,1,45,51,96
2023-06-06 13:51:42,79.9700925925926,1,38,68,106
2023-06-06 12:51:03,80.43916666666667,1,4,4,8
2024-03-07 18:07:55,12.184224537037037,2,7,6,13
2023-07-27 14:20:33,51.17913194444444,1,2,2,4
2023-06-07 09:46:41,0.5939814814814814,1,3,3,6
2023-06-06 12:16:41,0.13166666666666665,1,13,13,26
2023-06-06 09:18:57,0.017418981481481483,1,10,15,25
2023-06-14 07:05:30,0.3304398148148148,1,3,3,6
2023-10-19 14:11:16,135.85101851851852,2,188,11,199
2023-06-06 11:34:04,0.7444675925925925,1,18,0,18
2023-06-06 11:57:00,0.8815046296296296,12,277,0,277
2023-07-17 15:32:49,3.935324074074074,1,39,13,52
2023-06-10 16:35:57,5.078819444444444,1,5,1,6
2023-06-05 15:32:24,0.03577546296296296,1,1,1,2
2023-06-09 17:29:17,4.130856481481482,1,38,22,60
2023-06-05 14:52:34,0.03346064814814815,2,297,44,341
2023-07-21 11:20:53,45.91627314814815,1,1,1,2
2023-06-06 09:05:26,0.9888425925925926,1,1,2,3
2023-06-05 12:40:35,0.17005787037037037,1,8,14,22
2023-06-05 15:35:05,0.3990625,1,1,1,2
2023-06-05 07:52:36,0.09565972222222222,1,1,0,1
2023-06-22 21:48:40,19.79712962962963,1,131,39,170
2023-06-05 06:22:04,11.396770833333333,1,4,4,8
2023-06-04 23:57:05,0.20866898148148147,1,0,23,23
2023-06-06 09:28:51,3.1263425925925925,2,29,33,62
2023-06-06 08:42:24,3.573159722222222,4,128,105,233
2023-11-07 15:22:15,158.00282407407408,3,103,31,134
2023-06-05 12:49:51,2.9347337962962965,1,1,1,2
2023-06-05 12:51:26,2.9357291666666665,1,139,0,139
2023-06-02 17:58:18,1.8008333333333333,4,102,27,129
2023-06-02 13:40:23,0.01832175925925926,1,3,3,6
2023-08-03 09:12:53,61.99084490740741,4,95,7,102
2023-06-02 18:01:37,0.6138310185185185,1,0,4,4
2023-06-02 13:00:27,0.7051504629629629,3,200,686,886
2023-06-05 06:20:19,3.440324074074074,1,48,0,48
2023-06-10 16:36:10,8.939641203703705,4,113,14,127
2023-06-05 18:46:05,4.152627314814815,1,307,117,424
2023-06-01 11:46:19,0.024988425925925924,1,4,4,8
2023-06-01 08:24:11,0.011851851851851851,1,118,118,236
2023-06-01 00:25:38,0.09678240740740741,1,2,2,4
2023-06-01 07:45:10,0.4105787037037037,1,8,8,16
2023-06-01 12:27:58,0.6071527777777778,1,3,3,6
2023-06-01 12:39:44,0.6162962962962963,1,1,1,2
2023-06-01 08:01:22,0.4264236111111111,1,4,3,7
2023-06-01 07:41:45,0.41322916666666665,1,5,5,10
2023-06-01 07:41:03,0.4136458333333333,1,5,5,10
2023-06-01 10:14:50,0.5365509259259259,1,11,1,12
2023-05-31 21:33:10,0.04465277777777778,2,27,117,144
2023-05-31 21:34:48,0.10659722222222222,1,0,9,9
2023-06-01 07:47:06,0.5416203703703704,1,0,23,23
2023-06-01 12:29:30,0.772974537037037,1,74,0,74
2023-05-31 18:01:12,0.030185185185185186,1,12,0,12
2023-06-01 07:49:06,0.6646527777777778,1,51,5,56
2023-06-01 12:31:24,83.91608796296296,4,44,23,67
2023-05-31 17:40:16,76.94724537037037,1,57,60,117
2023-10-18 08:20:51,139.7611574074074,2,80,7,87
2023-06-01 12:47:31,1.0367824074074075,1,132,9,141
2023-06-05 06:16:12,5.416030092592592,1,111,0,111
2023-05-31 06:42:41,0.46565972222222224,1,1,1,2
2023-05-31 07:29:16,0.4996875,1,118,118,236
2023-06-01 08:01:09,1.5857291666666666,1,262,0,262
2023-06-06 11:37:10,6.799548611111111,1,113,0,113
2023-05-31 08:23:32,0.7731597222222222,3,135,0,135
2023-05-30 17:01:42,0.4097222222222222,1,2,2,4
2023-05-30 07:28:01,0.24980324074074073,1,1,1,2
2023-05-30 07:40:23,0.4359722222222222,1,5,5,10
2023-05-30 07:33:21,0.43159722222222224,1,5,5,10
2023-05-31 07:57:49,0.0032175925925925926,1,32,102,134
2023-05-30 07:34:59,0.4332986111111111,1,55,21,76
2023-05-30 07:43:20,0.44081018518518517,1,5,5,10
2023-05-30 07:42:41,0.4413425925925926,1,4,4,8
2023-05-30 07:29:41,0.43309027777777775,1,1,1,2
2023-05-30 07:38:42,0.0017939814814814815,1,9,43,52
2023-05-31 07:51:36,0.005648148148148148,1,10,46,56
2023-05-31 07:27:21,1.434050925925926,2,13,12,25
2023-05-31 07:42:14,0.0009837962962962962,1,18,18,36
2023-05-31 07:39:36,0.0011574074074074073,1,5,5,10
2023-05-30 07:28:39,0.4366203703703704,1,5,5,10
2023-05-31 07:36:44,1.4433449074074074,3,369,208,577
2023-05-30 07:58:55,0.011226851851851852,1,6,11,17
2023-05-31 13:32:38,1.802326388888889,1,38,0,38
2023-05-31 07:33:58,1.6074421296296297,1,47,0,47
2023-05-30 14:13:30,0.9620486111111111,1,45,0,45
2023-05-30 13:00:22,0.9937615740740741,1,87,0,87
2023-05-31 07:57:24,1.797974537037037,1,2,2,4
2023-06-01 12:32:34,3.622453703703704,1,34,17,51
2023-05-29 09:55:17,2.176134259259259,1,3,2,5
2023-05-30 09:59:17,3.6311342592592593,1,100,0,100
2023-05-29 13:32:00,2.837384259259259,1,181,0,181
2023-06-01 07:37:38,5.643935185185185,5,697,69,766
2023-05-29 09:43:19,2.80625,1,155,0,155
2023-06-13 17:28:31,18.58699074074074,15,161,91,252
2023-06-01 00:41:52,6.448287037037037,5,48,17,65
2023-05-31 13:23:49,5.988229166666667,2,79,1,80
2023-06-01 12:47:56,7.204386574074074,5,42,23,65
2023-05-25 11:03:37,0.39587962962962964,1,17,17,34
2023-05-25 07:27:17,0.5135185185185185,4,44,5,49
2023-08-21 06:44:35,88.60223379629629,6,198,56,254
2023-05-30 14:09:58,82.65778935185185,1,2,3,5
2023-05-30 14:21:53,82.67137731481482,1,10,2,12
2023-06-01 12:35:06,76.79104166666667,1,22,9,31
2023-09-28 14:04:06,203.63143518518518,2,25,23,48
2023-05-30 14:09:16,82.65280092592593,1,10,12,22
2023-05-30 14:08:47,82.64818287037038,1,2,3,5
2023-05-26 07:42:16,78.3776736111111,1,21,11,32
2023-05-30 14:07:45,84.74702546296297,3,58,69,127
2023-05-24 10:38:50,0.47193287037037035,1,30,30,60
2023-05-24 08:52:10,0.015590277777777778,1,1,1,2
2023-05-24 08:47:50,0.013865740740740741,1,10,10,20
2023-05-24 08:46:10,0.015370370370370371,1,1,1,2
2023-05-24 08:23:18,15.531805555555556,1,23,38,61
2023-05-24 07:49:27,0.43364583333333334,1,1,1,2
2023-06-06 19:49:50,14.086238425925925,1,48,272,320
2023-05-24 09:55:41,78.75175925925926,2,238,155,393
2023-05-24 09:04:43,0.7384375,2,11,17,28
2023-06-06 11:58:33,80.40270833333334,1,347,414,761
2023-05-26 07:41:13,69.23056712962963,1,21,11,32
2023-05-23 14:49:11,66.531875,1,9,18,27
2023-05-24 09:23:40,67.29417824074073,1,24,41,65
2023-05-23 14:40:21,66.5044212962963,1,11,23,34
2023-05-23 13:44:11,0.01892361111111111,1,26,0,26
2023-05-23 13:00:37,0.03560185185185185,1,1,1,2
2023-05-23 15:15:17,1.003449074074074,3,2433,1495,3928
2023-05-23 09:47:37,0.7960069444444444,2,97,101,198
2023-05-23 07:06:44,0.005532407407407408,1,8,8,16
2023-05-23 08:04:11,0.16747685185185185,2,32,23,55
2023-05-23 06:58:41,0.19034722222222222,1,1,1,2
2023-05-23 07:25:32,0.41230324074074076,1,2,2,4
2023-05-23 07:07:02,0.39993055555555557,1,1,1,2
2023-05-23 07:25:43,0.4240393518518519,1,3,3,6
2023-05-23 07:25:20,0.004409722222222222,1,21,55,76
2023-05-23 07:27:55,0.42996527777777777,1,5,5,10
2023-05-23 07:34:32,0.004918981481481482,1,16,11,27
2023-05-23 07:44:15,0.005798611111111111,1,7,7,14
2023-05-24 10:38:08,1.131550925925926,1,16,17,33
2023-05-23 07:15:43,0.4245833333333333,1,43,9,52
2023-05-23 07:47:59,0.028009259259259258,1,5,5,10
2023-05-23 08:03:51,0.46819444444444447,1,55,0,55
2023-05-23 07:01:11,0.4998842592592593,5,206,28,234
2023-05-23 12:27:37,0.7997106481481482,1,0,4,4
2023-05-22 17:14:55,0.017002314814814814,2,2,2,4
2023-05-22 19:18:22,0.11229166666666666,1,1,1,2
2023-05-23 12:27:18,0.8298842592592592,1,2,2,4
2023-05-23 12:28:21,0.8684722222222222,1,8,1,9
2023-05-23 08:52:27,14.51954861111111,2,366,473,839
2023-05-22 16:11:28,0.08396990740740741,1,1,1,2
2023-05-22 12:03:39,0.07564814814814814,1,14,6,20
2023-05-22 10:25:56,0.027881944444444445,1,1,1,2
2023-05-22 15:38:06,0.31548611111111113,1,36,0,36
2023-05-22 10:45:30,0.23494212962962963,1,1,9,10
2023-05-23 06:58:09,1.0933796296296296,3,22,21,43
2023-05-22 10:46:20,0.29875,1,0,5,5
2023-10-19 17:44:55,151.89119212962962,9,445,387,832
2023-05-24 07:20:40,4.077326388888889,3,39,40,79
2023-05-19 10:04:18,0.01513888888888889,1,21,0,21
2023-05-19 09:27:10,0.609224537037037,1,2,2,4
2023-05-19 08:53:50,0.7574537037037037,1,34,0,34
2023-05-22 10:50:44,4.771238425925926,6,292,6,298
2023-05-22 11:15:22,4.555671296296296,1,62,11,73
2023-10-13 08:42:59,148.68193287037036,3,365,19,384
2023-05-22 11:17:56,5.245925925925926,1,7,40,47
2023-05-16 21:27:36,0.09350694444444445,2,148,2,150
2023-06-01 07:23:28,15.53241898148148,1,15,9,24
2023-05-22 11:28:12,5.819571759259259,7,267,6,273
2023-05-16 22:09:22,32.60828703703704,1,5,1,6
2023-05-16 22:08:42,32.58453703703704,1,6,1,7
2023-05-23 13:17:09,6.956550925925926,2,23,13,36
2023-05-16 16:03:53,0.15064814814814814,2,94,3,97
2023-05-16 12:59:44,0.16364583333333332,1,1,1,2
2023-05-22 09:40:01,6.478020833333333,1,1,1,2
2023-05-16 08:52:08,0.47984953703703703,1,2,2,4
2023-05-16 08:52:00,0.48572916666666666,1,1,6,7
2023-05-16 08:58:37,0.4924189814814815,1,1,1,2
2023-05-16 08:45:54,0.488125,1,43,9,52
2023-05-16 13:39:19,0.6930787037037037,1,5,10,15
2023-05-16 08:51:02,0.0025810185185185185,1,21,55,76
2023-05-23 07:52:54,0.018171296296296297,1,1,1,2
2023-05-16 08:10:03,0.4671296296296296,1,15,15,30
2023-05-16 12:56:50,0.8482407407407407,2,74,0,74
2023-05-22 13:27:35,9.837407407407408,8,292,5,297
2023-05-15 07:40:24,0.768587962962963,1,6,8,14
2023-05-15 15:25:05,3.064398148148148,2,65,67,132
2023-05-12 16:53:31,0.1258101851851852,2,38,1,39
2023-05-15 20:42:07,3.8808796296296295,7,326,197,523
2023-05-22 11:44:49,10.737523148148147,1,9,1,10
2023-06-06 02:14:29,25.585,1,30,25,55
2023-06-04 23:42:17,24.50576388888889,1,3,3,6
2023-05-12 11:46:16,1.6780787037037037,4,54,6,60
2023-05-10 15:22:34,0.01857638888888889,1,2,14,16
2023-05-10 18:17:56,0.1399189814814815,1,23,23,46
2023-05-10 06:38:02,0.4200347222222222,1,15,1,16
2023-05-11 08:19:25,1.6499421296296297,4,319,27,346
2023-05-09 14:42:02,0.007534722222222222,1,1,1,2
2023-05-09 13:48:53,0.009537037037037037,1,0,6,6
2023-05-16 13:36:26,7.081030092592592,1,4,1,5
2023-05-10 10:59:29,1.5839351851851853,7,441,158,599
2023-05-09 12:56:03,0.33805555555555555,1,1,1,2
2023-05-23 07:44:47,14.44212962962963,1,6,6,12
2023-05-09 13:42:21,0.010150462962962964,1,21,55,76
2023-05-09 13:25:50,0.6828703703703703,1,43,9,52
2023-05-14 13:09:34,4.088240740740741,1,27,27,54
2023-05-09 12:43:07,0.705,1,10,14,24
2023-05-22 13:48:01,13.772847222222222,4,129,150,279
2023-05-09 01:07:13,0.2632638888888889,1,3,2,5
2023-05-09 01:08:48,0.3677314814814815,1,79,41,120
2023-05-09 01:09:11,0.4381365740740741,1,12,0,12
2023-05-09 01:11:56,0.45819444444444446,3,175,186,361
2023-05-10 06:58:22,1.7014004629629629,4,4,6,10
2023-05-09 01:10:04,0.47519675925925925,1,1,0,1
2023-05-09 12:55:36,1.0017245370370371,1,25,99,124
2023-05-31 21:43:39,23.487743055555555,15,430,5063,5493
2023-05-08 09:12:14,0.14164351851851853,2,1,1,2
2023-05-08 06:26:02,0.6628009259259259,3,2,2,4
2023-05-08 09:12:54,1.006574074074074,2,23,28,51
2023-05-08 13:12:12,1.2107060185185186,4,39,40,79
2023-05-08 09:28:36,1.0863773148148148,3,45,4,49
2023-05-09 21:08:28,0.31806712962962963,1,5,5,10
2023-05-08 09:12:45,1.1319907407407408,2,20,26,46
2023-05-07 07:10:58,0.09638888888888889,2,14,25,39
2023-05-11 05:55:10,4.616238425925926,3,61,35,96
2023-05-05 17:48:24,0.02753472222222222,1,8,18,26
2023-05-05 16:10:11,0.10184027777777778,1,1,1,2
2023-05-05 16:58:35,0.05140046296296296,1,2,2,4
2023-05-05 16:58:58,0.07065972222222222,1,4,0,4
2023-07-21 11:13:17,76.84866898148148,1,66,0,66
2023-05-09 12:46:01,3.9824421296296295,1,1,1,2
2023-05-15 18:20:13,10.215925925925927,1,4,4,8
2023-05-11 02:40:04,5.58056712962963,2,14,2,16
2023-05-05 13:13:28,0.3292013888888889,1,1,1,2
2023-05-05 12:41:07,2.6364699074074074,1,6,3,9
2023-05-08 13:10:21,3.5007175925925926,1,2,1,3
2023-05-09 12:45:47,3.9909143518518517,1,19,0,19
2023-05-04 19:33:33,0.03902777777777778,1,4,4,8
2023-05-04 18:37:43,0.051284722222222225,1,64,0,64
2023-05-12 11:13:04,7.802129629629629,2,61,1,62
2023-05-12 10:25:33,55.35596064814815,2,14,26,40
2023-05-23 08:49:24,66.2830324074074,1,93,85,178
2023-05-11 08:32:10,54.288275462962964,1,9,23,32
2023-05-12 07:25:44,55.24024305555555,1,3,8,11
2023-05-22 12:49:11,65.4593287037037,1,0,5,5
2023-05-09 14:56:26,5.184027777777778,1,61,35,96
2023-06-20 16:54:06,47.34476851851852,1,6,0,6
2023-05-04 08:13:01,0.020439814814814813,1,15,0,15
2023-05-05 07:06:51,0.9871296296296296,2,45,36,81
2023-05-04 07:48:51,0.05347222222222222,2,2,3,5
2023-05-04 06:14:04,0.026157407407407407,2,6,3,9
2023-05-04 05:43:55,0.03232638888888889,1,6,27,33
2023-05-25 13:42:37,21.849594907407408,27,500,258,758
2023-05-04 09:06:23,0.22741898148148149,1,3,3,6
2023-05-04 12:14:02,0.3641550925925926,1,10,10,20
2023-05-04 09:16:40,0.24134259259259258,1,5,5,10
2023-05-04 09:30:58,0.2515046296296296,1,18,18,36
2023-05-19 09:28:56,4.846377314814815,1,6,9,15
2023-05-04 03:22:50,0.014861111111111111,2,9,5,14
2023-05-04 03:44:28,0.4076736111111111,3,22,5,27
2023-05-04 11:45:39,0.7752893518518519,1,22,3,25
2023-05-04 03:47:53,58.45975694444444,2,2,2,4
2023-05-04 12:06:20,5.7961226851851855,1,79,65,144
2023-05-04 03:31:05,0.462337962962963,1,1,1,2
2023-05-04 03:33:55,0.4686689814814815,1,35,30,65
2023-05-23 08:16:50,19.677627314814814,1,1,7,8
2023-05-04 03:25:43,0.4762268518518519,1,2,16,18
2023-05-11 10:41:56,7.777650462962963,1,39,38,77
2023-05-09 10:09:33,5.8255787037037035,1,48,4,52
2023-05-03 17:19:25,0.1400925925925926,1,108,32,140
2023-05-03 14:28:14,0.01974537037037037,1,8,7,15
2023-05-03 17:17:41,0.22523148148148148,1,8,4,12
2023-05-03 12:03:39,0.031006944444444445,1,54,16,70
2023-05-03 11:32:11,0.07287037037037038,1,3,8,11
2023-05-03 08:29:45,0.01619212962962963,1,2,1,3
2023-05-03 13:28:40,0.7647222222222222,3,37,34,71
2023-05-03 07:11:20,0.4938078703703704,1,0,1,1
2023-05-03 08:30:10,0.604525462962963,1,1,7,8
2023-05-03 08:30:55,0.5967592592592592,1,7,12,19
2023-05-23 08:49:13,20.603622685185186,2,4474,1799,6273
2023-05-02 19:07:45,0.03152777777777778,1,9,24,33
2023-05-02 19:06:51,0.8707638888888889,1,4,7,11
2023-05-02 16:06:43,0.019039351851851852,1,4,10,14
2023-05-02 18:39:07,0.21783564814814815,2,23,7,30
2023-05-02 16:07:17,0.09763888888888889,1,15,24,39
2023-05-02 14:10:40,0.010185185185185186,1,3,11,14
2023-05-03 09:43:30,1.4111342592592593,17,36,49,85
2023-05-03 08:31:41,0.8924421296296297,2,58,9,67
2023-05-02 08:26:40,0.06405092592592593,1,16,13,29
2023-05-02 12:47:04,0.25699074074074074,2,39,60,99
2023-05-03 09:13:50,1.4886574074074075,1,5,5,10
2023-05-02 18:43:12,0.8933217592592593,1,75,58,133
2023-05-02 16:08:03,0.7860532407407408,1,22,22,44
2023-05-02 19:03:26,0.008159722222222223,1,8,8,16
2023-05-02 19:04:37,0.9104513888888889,1,5,5,10
2023-05-02 18:06:14,0.870636574074074,1,43,9,52
2023-05-02 18:50:42,0.0016550925925925926,1,57,68,125
2023-05-02 16:08:44,0.7953125,1,1,1,2
2023-05-02 18:46:45,0.9054282407407407,1,5,5,10
2023-05-02 18:35:14,0.019224537037037037,1,54,64,118
2023-05-02 17:40:45,0.8610763888888889,1,5,5,10
2023-05-02 18:24:49,0.011979166666666667,1,21,55,76
2023-05-02 16:40:35,0.8205208333333334,1,10,10,20
2023-05-02 10:57:11,0.5908912037037037,1,56,31,87
2023-05-03 08:32:30,1.6449305555555556,1,112,110,222
2023-05-02 16:10:40,1.1059837962962964,7,166,6,172
2023-05-01 15:45:18,0.00917824074074074,1,2,0,2
2023-05-01 09:23:57,0.20444444444444446,2,75,76,151
2023-05-02 10:53:33,1.656226851851852,2,38,36,74
2023-05-09 21:08:54,8.90005787037037,7,107,71,178
2023-08-07 13:41:35,98.65783564814815,2,66,43,109
2023-05-02 10:54:01,1.6208333333333333,3,15,35,50
2023-04-30 22:51:31,0.13684027777777777,2,27,24,51
2023-04-30 22:51:01,0.1842361111111111,5,19,28,47
2023-05-23 11:26:10,22.888402777777777,1,2,7,9
2023-05-02 16:39:23,2.1147569444444443,1,6,12,18
2023-05-02 16:16:08,2.076886574074074,2,19,26,45
2023-05-04 03:49:10,47.19983796296296,1,559,668,1227
2023-05-04 03:48:35,47.09657407407408,1,11,25,36
2023-04-30 19:16:08,43.88049768518518,1,0,4,4
2023-05-04 03:49:53,47.09545138888889,1,170,345,515
2023-07-28 21:15:33,132.9211689814815,1,0,222,222
2023-04-30 12:06:53,0.008090277777777778,1,33,35,68
2023-04-30 00:28:52,0.4564814814814815,1,3,3,6
2023-04-30 00:22:20,1.139513888888889,1,1,1,2
2023-04-29 20:03:36,0.2813425925925926,1,23,2,25
2023-04-30 00:29:25,0.6960300925925926,1,4,8,12
2023-04-30 00:29:55,1.2181712962962963,8,107,61,168
2023-11-07 23:43:29,193.25487268518518,16,85214,65023,150237
2023-05-02 16:21:36,3.990902777777778,1,141,99,240
2023-04-30 04:42:44,1.7194791666666667,1,1,0,1
2023-04-28 11:12:35,0.04527777777777778,1,2,3,5
2023-04-30 04:42:22,1.7844328703703705,1,2,1,3
2023-04-28 09:15:43,0.013969907407407407,1,2,2,4
2023-04-28 08:27:27,0.030972222222222224,1,7,7,14
2023-04-28 08:00:34,0.09755787037037036,1,29,8,37
2023-04-28 06:54:21,0.10152777777777777,1,12,9,21
2023-04-28 08:05:35,0.15630787037037036,1,16,6,22
2023-04-28 06:54:44,0.1156712962962963,1,0,1,1
2023-11-14 17:48:21,4.012118055555556,5,113,80,193
2023-04-28 04:35:25,0.3464699074074074,1,0,12,12
2023-04-30 04:43:28,2.424224537037037,1,8,17,25
2023-06-14 14:44:37,48.044212962962966,3,334,322,656
2023-04-28 05:50:32,0.5863657407407408,1,1,1,2
2023-04-30 04:43:50,40.54788194444444,1,7,16,23
2023-04-30 12:07:04,40.77496527777778,1,19,27,46
2023-04-30 04:46:40,40.42974537037037,1,93,120,213
2023-04-30 04:47:16,40.4431712962963,1,10,16,26
2023-04-30 12:07:21,40.747337962962966,1,7,18,25
2023-05-02 16:23:36,42.81383101851852,1,28,41,69
2023-04-30 04:47:51,40.54578703703704,1,1,7,8
2023-04-30 04:48:16,40.54097222222222,1,2,9,11
2023-05-02 11:58:49,4.965162037037037,5,40,136,176
2023-07-21 11:14:31,84.98152777777777,2,16,18,34
2023-04-27 08:15:45,0.2954398148148148,1,1,1,2
2023-04-30 08:02:12,3.4015625,171,15026,14851,29877
2023-04-26 23:45:19,0.11064814814814815,1,2,1,3
2023-04-26 19:29:37,0.024814814814814814,1,5,10,15
2023-04-26 15:45:50,0.02,1,3,3,6
2023-04-26 15:46:02,0.020497685185185185,1,3,3,6
2023-04-27 10:12:56,0.7907407407407407,2,50,19,69
2023-04-26 15:43:38,0.02185185185185185,1,10,10,20
2023-04-26 15:43:52,0.022337962962962962,1,5,5,10
2023-04-30 07:33:37,3.7623379629629627,3,15,15,30
2023-04-28 08:01:38,1.8865625,1,2,2,4
2023-04-26 09:42:26,5.933553240740741,4,10,7,17
2023-04-26 09:42:48,0.08153935185185185,2,9,4,13
2023-04-30 08:03:29,4.397337962962963,1,0,1,1
2023-04-25 21:11:31,0.02189814814814815,2,2,1,3
2023-04-26 09:37:52,0.5860069444444445,1,53,101,154
2023-04-25 20:15:00,0.07482638888888889,2,2,2,4
2023-04-25 20:14:44,5.361006944444444,1,32,0,32
2023-04-25 09:12:38,0.11605324074074073,1,125,8,133
2023-04-30 04:46:16,5.048101851851852,1,1,0,1
2023-04-25 04:33:22,0.09582175925925926,1,82,9,91
2023-04-26 12:57:09,1.6459606481481481,1,3,3,6
2023-04-26 12:34:17,1.6436458333333333,1,5,5,10
2023-04-26 13:35:25,1.6865972222222223,1,43,9,52
2023-04-26 12:34:47,1.6448842592592592,1,1,1,2
2023-04-30 07:01:11,0.009409722222222222,1,15,15,30
2023-04-30 06:38:54,0.07664351851851851,1,34,34,68
2023-04-26 14:10:55,0.023668981481481482,1,22,63,85
2023-04-26 15:36:58,0.05800925925925926,1,49,12,61
2023-04-26 12:41:09,1.6537731481481481,1,5,5,10
2023-04-30 07:00:48,0.013495370370370371,1,6,69,75
2023-04-26 12:41:21,1.655023148148148,1,5,5,10
2023-04-24 18:26:04,0.015358796296296296,1,1,1,2
2023-04-24 17:08:22,31.8478125,1,19,9,28
2023-04-24 17:06:58,0.29335648148148147,2,191,0,191
2023-04-24 07:53:55,0.076875,1,1,1,2
2023-04-24 06:07:19,0.14668981481481483,1,60,56,116
2023-04-23 20:24:54,5.750219907407407,1,1014,352,1366
2023-04-26 19:55:06,2.9410416666666666,250,17956,14531,32487
2023-04-21 16:08:29,0.07082175925925926,2,40,32,72
2023-04-21 16:14:19,0.31655092592592593,2,24,21,45
2023-04-21 14:53:50,0.23913194444444444,3,18,14,32
2023-04-23 20:25:40,3.0755208333333335,1,22,6,28
2023-04-30 04:50:58,5.690509259259259,1,1,1,2
2023-04-23 20:27:24,4.250763888888889,3,62,45,107
2023-04-30 07:01:42,9.818483796296297,3,32,4,36
2023-04-19 19:46:31,0.0038657407407407408,1,1,0,1
2023-04-19 17:20:25,0.550162037037037,1,52,0,52
2023-04-19 15:46:46,0.06618055555555556,1,1,5,6
2023-05-02 11:58:29,13.133217592592592,1,707,0,707
2023-04-20 08:57:11,0.864224537037037,1,2,1,3
2023-04-25 14:51:38,7.047847222222222,3,64,26,90
2023-04-20 15:06:57,2.746377314814815,1,2,2,4
2023-04-18 08:39:47,0.477662037037037,1,3,3,6
2023-04-18 07:51:24,0.45055555555555554,1,2,1,3
2023-04-18 08:00:39,0.4543287037037037,1,1,1,2
2023-04-30 06:39:49,12.399791666666667,1,5,5,10
2023-04-18 08:09:39,0.4628935185185185,1,5,5,10
2023-04-26 14:30:43,8.261898148148148,1,5,5,10
2023-04-24 02:24:06,0.019664351851851853,1,21,55,76
2023-04-18 08:09:53,0.4639351851851852,1,1,1,2
2023-04-18 08:11:40,0.4654513888888889,1,5,5,10
2023-04-18 08:11:54,0.46591435185185187,1,10,10,20
2023-04-24 01:54:07,0.17304398148148148,1,43,9,52
2023-04-18 08:12:05,0.4679861111111111,1,5,5,10
2023-04-17 11:25:15,0.8301967592592593,2,43,61,104
2023-04-17 11:13:36,0.04978009259259259,1,1,0,1
2023-04-23 20:29:32,6.471875,1,1,0,1
2023-04-17 08:15:23,0.026377314814814815,1,1,1,2
2023-04-17 08:12:04,0.09425925925925926,1,5,1,6
2023-04-16 14:09:05,0.07177083333333334,3,56,64,120
2023-04-24 06:07:04,0.25538194444444445,1,76,8,84
2023-04-16 00:10:48,0.030127314814814815,1,53,17,70
2023-04-16 05:01:25,4.096956018518519,1,157,105,262
2023-04-17 05:07:27,1.860462962962963,3,59,61,120
2023-05-02 13:22:20,18.256145833333335,1,3,0,3
2023-04-14 12:41:16,0.696412037037037,1,6,1,7
2023-04-14 12:42:10,0.9699074074074074,2,21,9,30
2023-04-14 09:01:23,1.6523495370370371,1,5,5,10
2023-04-12 14:01:50,0.018541666666666668,1,1,1,2
2023-04-12 13:24:30,0.0036458333333333334,1,2,2,4
2023-04-12 13:24:45,0.012523148148148148,1,10,0,10
2023-04-22 10:37:41,6.214363425925926,250,21953,7087,29040
2023-04-12 10:47:06,0.024930555555555556,2,32,21,53
2023-04-12 10:44:58,0.4877662037037037,1,15,89,104
2023-04-12 08:06:57,0.42680555555555555,1,2,2,4
2023-04-11 21:22:59,11.079108796296296,1,1,1,2
2023-04-12 11:47:39,0.8508217592592593,1,3,3,6
2023-04-11 12:24:27,0.03726851851851852,1,1,0,1
2023-04-11 12:24:45,0.1610300925925926,1,1,1,2
2023-04-11 08:55:40,0.4766898148148148,1,1,1,2
2023-04-11 08:56:18,0.48052083333333334,1,1,1,2
2023-04-11 08:56:30,0.4817592592592593,1,1,1,2
2023-04-11 13:25:55,0.014189814814814815,1,43,9,52
2023-04-11 13:03:44,0.6593402777777778,1,32,48,80
2023-04-11 10:15:54,0.5432407407407407,1,42,7,49
2023-04-11 08:57:09,0.4891666666666667,1,6,11,17
2023-04-11 14:02:20,0.01494212962962963,1,1,36,37
2023-04-11 08:57:42,0.4929398148148148,1,5,5,10
2023-04-11 13:39:08,0.008368055555555556,1,21,55,76
2023-04-11 11:43:54,0.05996527777777778,1,6,16,22
2023-04-11 08:57:58,0.49744212962962964,1,5,5,10
2023-04-11 10:53:13,0.5793865740740741,1,3,3,6
2023-04-11 10:14:10,0.5526504629629629,1,2,2,4
2023-04-11 10:12:33,0.552025462962963,1,1,1,2
2023-04-23 20:33:08,13.1084375,1,3,1,4
2023-05-10 07:05:33,30.064016203703705,2,32,33,65
2023-05-04 09:56:24,3.6383564814814813,1,26,17,43
2023-04-23 20:30:07,13.743136574074073,1,1,7,8
2023-04-08 10:51:15,0.15422453703703703,1,1,0,1
2023-05-19 15:48:16,41.746574074074076,2,55,25,80
2023-04-07 09:55:15,0.022476851851851852,1,1,1,2
2023-04-12 11:21:32,5.8690393518518515,55,2792,2430,5222
2023-04-07 13:44:32,1.5953703703703703,2,5,2,7
2023-08-03 09:25:48,0.5400810185185185,3,84,18,102
2023-04-07 09:57:43,1.6558449074074073,1,0,4,4
2023-04-05 17:31:50,0.10238425925925926,1,1,1,2
2023-04-07 07:01:57,10.637881944444445,1,15,1,16
2023-04-05 08:56:55,0.11126157407407407,1,1,1,2
2023-04-05 08:57:37,0.17832175925925925,1,2,2,4
2023-04-05 11:20:22,0.6716087962962963,1,1,1,2
2023-04-04 14:48:34,0.06202546296296296,3,32,20,52
2023-04-04 08:48:26,0.0749537037037037,2,74,60,134
2023-04-04 14:33:44,0.426099537037037,1,55,55,110
2023-04-04 14:33:33,0.37675925925925924,1,4,4,8
2023-04-04 09:41:06,0.28291666666666665,1,3,0,3
2023-04-04 14:32:08,0.4992476851851852,1,11,2,13
2023-04-05 07:04:09,1.2811689814814815,3,14,2,16
2023-04-05 11:57:22,1.599236111111111,1,4,4,8
2023-04-05 11:26:34,1.5781944444444445,1,4,4,8
2023-04-04 09:02:33,0.47847222222222224,1,1,1,2
2023-04-04 09:04:57,0.4804861111111111,1,2,2,4
2023-04-04 13:05:13,0.17707175925925925,1,5,5,10
2023-04-11 09:54:16,7.52474537037037,1,27,29,56
2023-04-05 11:29:15,1.591238425925926,1,3,3,6
2023-04-11 10:11:14,0.002662037037037037,1,11,11,22
2023-04-04 09:09:34,0.4952199074074074,1,2,2,4
2023-04-04 12:25:09,0.12702546296296297,1,1,1,2
2023-04-30 06:46:03,3.689560185185185,1,5,12,17
2023-04-05 12:01:23,1.6187152777777778,1,4,4,8
2023-04-11 09:47:11,7.525960648148148,1,58,183,241
2023-04-04 09:25:26,0.024606481481481483,1,10,10,20
2023-04-11 10:04:40,0.0062037037037037035,1,199,166,365
2023-04-04 10:42:38,0.8719212962962963,1,1,1,2
2023-04-06 14:24:31,3.0433101851851854,166,14468,14204,28672
2023-04-03 13:06:30,0.031643518518518515,2,31,560,591
2023-04-03 10:31:35,0.02494212962962963,1,53,10,63
2023-04-03 10:41:10,0.21637731481481481,1,36,7,43
2023-07-19 07:02:31,107.63924768518518,5,50444,40758,91202
2023-04-03 14:25:16,1.1665393518518519,1,5,1,6
2023-04-14 15:29:10,12.519421296296295,9,31,23,54
2023-04-05 12:58:10,3.6668055555555554,1,1,1,2
2023-04-02 04:49:37,0.4526967592592593,1,1,1,2
2023-04-25 13:41:34,25.54971064814815,1,67,9,76
2023-04-19 14:07:30,19.587291666666665,1,424,173,597
2023-04-01 07:27:23,1.4283680555555556,1,32,25,57
2023-04-01 06:28:36,0.15175925925925926,1,4,6,10
2023-04-03 14:22:55,2.651087962962963,1,1,1,2
2023-04-05 14:33:55,4.796655092592593,1,21,2,23
2023-03-31 19:42:28,0.057465277777777775,1,1,1,2
2023-04-03 13:05:39,3.2092824074074073,1,14,0,14
2023-03-31 07:33:52,0.5306944444444445,1,2,9,11
2023-03-31 05:33:17,0.4764351851851852,1,34,1,35
2023-03-31 16:28:41,1.1225,2,2,2,4
2023-03-30 12:19:34,0.012650462962962962,1,15,4,19
2023-04-07 12:26:13,8.560289351851852,1,2,2,4
2023-03-30 08:14:50,0.8594907407407407,1,3,1,4
2023-03-29 08:52:41,1.4950347222222222,1,71,5,76
2023-04-01 07:59:10,4.868275462962963,1,446,90,536
2023-03-29 11:27:20,1.4247337962962963,3,20,8,28
2023-03-29 07:58:27,1.27625,1,4,2,6
2023-03-29 08:32:52,1.4661226851851852,1,3,3,6
2023-03-29 08:33:09,1.4727314814814816,1,4,4,8
2023-03-29 08:34:28,1.476539351851852,1,5,5,10
2023-03-29 08:34:49,1.4772222222222222,1,5,5,10
2023-03-30 08:38:01,2.480636574074074,1,213,236,449
2023-03-29 08:35:28,1.4807060185185186,1,5,5,10
2023-03-29 08:37:33,1.4825578703703703,1,5,5,10
2023-03-29 09:03:38,0.017222222222222222,1,7,7,14
2023-03-29 09:27:15,0.009479166666666667,1,5,5,10
2023-03-29 09:11:51,1.5092824074074074,1,5,5,10
2023-04-30 06:45:03,33.408229166666665,3,13,3,16
2023-03-28 00:07:07,0.13898148148148148,1,0,41,41
2023-03-31 17:20:12,3.8577546296296297,1,1,0,1
2023-03-28 04:28:57,0.3928935185185185,1,1,1,2
2023-03-31 12:38:48,5.790763888888889,3,18,14,32
2023-03-27 15:54:42,0.13501157407407408,2,12,2,14
2023-04-03 12:44:43,3.9109837962962963,250,21620,6961,28581
2023-03-27 14:09:10,0.19975694444444445,1,49,49,98
2023-03-27 07:11:10,3.479212962962963,1,4,4,8
2023-04-23 20:32:47,28.408252314814813,1,6,15,21
2023-03-26 08:59:15,0.01863425925925926,1,1,1,2
2023-03-29 11:54:34,4.022048611111111,4,12,3,15
2023-03-31 07:33:25,0.6135185185185185,2,25,214,239
2023-03-27 14:11:45,1.5113310185185185,1,2,1,3
2023-04-18 09:33:31,23.521180555555556,9,502,95,597
2023-03-25 23:39:25,0.3077199074074074,2,78,48,126
2023-03-25 23:38:32,1.3698148148148148,1,3,3,6
2023-03-25 23:40:01,1.449537037037037,1,4,2,6
2023-03-25 23:40:37,1.2139814814814816,1,1,0,1
2023-03-25 23:37:58,1.9098032407407408,1,33,23,56
2023-03-30 13:16:20,5.271944444444444,6,198,33,231
2023-03-25 07:46:32,0.05480324074074074,1,69,13,82
2023-04-07 14:19:44,13.82699074074074,1,3,2,5
2023-03-27 07:14:22,2.615462962962963,1,2,0,2
2023-04-17 12:16:37,24.443148148148147,1,20,1,21
2023-07-02 08:38:54,100.57047453703704,8,242,144,386
2023-04-17 09:06:07,23.81596064814815,1,10,10,20
2023-03-24 03:35:44,0.002013888888888889,1,1,1,2
2023-04-26 23:46:19,33.91416666666667,3,28,43,71
2023-10-03 12:58:41,193.584375,1,1,3,4
2023-04-07 11:03:43,14.524652777777778,1,0,7,7
2023-04-11 09:25:29,18.69175925925926,1,62,25,87
2023-03-23 21:49:47,0.16412037037037036,2,2,2,4
2023-04-07 12:10:13,14.766493055555555,1,0,1,1
2023-03-23 08:47:14,0.04221064814814815,1,0,15,15
2023-04-26 13:33:32,34.25358796296296,2,12267,7163,19430
2023-04-11 09:35:40,19.516550925925927,8,212,27,239
2023-04-07 12:13:53,15.442453703703704,1,0,9,9
2023-03-23 04:17:29,0.3466087962962963,1,3,3,6
2023-04-07 12:39:34,15.840289351851851,3,421,68,489
2023-03-23 22:19:42,0.1422337962962963,1,40,5,45
2023-07-24 15:37:38,124.63315972222222,1,9,3,12
2023-04-30 08:04:15,39.41804398148148,2,2,190,192
2023-08-08 06:57:19,139.49444444444444,3,33,24,57
2023-03-22 13:15:22,0.8399768518518519,2,0,8,8
2023-03-22 13:06:26,0.8911574074074075,1,48,0,48
2023-04-23 20:35:55,33.788333333333334,3,53,45,98
2023-03-22 14:47:44,0.9832986111111112,1,6,2,8
2023-03-21 14:04:22,7.842928240740741,1,52,1,53
2023-03-27 15:07:38,6.176458333333334,2,7,2,9
2023-03-21 09:32:59,0.21805555555555556,2,21,38,59
2023-03-21 09:25:19,0.5382291666666666,1,1,1,2
2023-03-21 01:42:35,0.22391203703703705,1,3,3,6
2023-03-21 01:51:32,0.23293981481481482,1,5,5,10
2023-03-21 01:47:26,0.23234953703703703,1,5,5,10
2023-03-20 23:56:46,0.15715277777777778,1,1,1,2
2023-03-21 01:49:49,0.2362152777777778,1,25,25,50
2023-03-20 19:03:45,0.11009259259259259,1,2,10,12
2023-03-20 19:02:58,0.13144675925925925,1,9,7,16
2023-03-20 19:04:25,0.27167824074074076,1,2,0,2
2023-05-31 22:10:22,83.09099537037036,25,34827,19153,53980
2023-03-18 08:05:02,0.010162037037037037,1,118,23,141
2023-03-18 08:05:17,0.028171296296296295,1,54,67,121
2023-04-26 14:46:20,39.61210648148148,1,1,1,2
2023-04-23 20:43:13,36.85987268518519,1,0,681,681
2023-10-03 13:24:12,200.09613425925926,3,43,69,112
2023-03-17 13:37:30,0.1879398148148148,1,166,3,169
2023-05-23 14:08:27,67.64666666666666,1,150,152,302
2023-03-16 22:07:26,0.01056712962962963,1,1,0,1
2023-03-16 21:47:02,20.214525462962964,1,119,6,125
2023-03-16 21:46:52,13.765671296296297,1,32,4,36
2023-03-19 06:47:54,2.509027777777778,4,27,6,33
2023-03-16 21:24:02,0.2087037037037037,2,13,1788,1801
2023-04-24 17:07:45,39.10438657407408,23,27,27,54
2023-03-27 11:01:47,10.144409722222223,250,7365,7298,14663
2023-03-20 19:02:09,4.827268518518519,1,0,1,1
2023-03-16 01:55:14,0.11681712962962963,1,1,2,3
2023-03-16 03:33:39,0.18689814814814815,2,186,202,388
2023-03-16 01:53:56,0.12336805555555555,1,6,23,29
2023-03-16 01:55:54,0.17460648148148147,1,49,22,71
2023-03-18 07:09:39,2.4300925925925925,1,23,118,141
2023-03-15 15:41:14,0.27186342592592594,1,4,5,9
2023-03-16 01:33:26,0.7601273148148148,1,3,3,6
2023-03-16 01:55:30,0.7860185185185186,1,36,36,72
2023-03-17 08:43:17,1.2810532407407407,1,33,9,42
2023-03-16 01:44:22,0.7821180555555556,1,5,5,10
2023-03-16 01:56:04,0.7911805555555556,1,31,36,67
2023-03-15 19:07:44,0.6060648148148148,2,32,54,86
2023-03-15 15:43:45,0.4061111111111111,1,1,1,2
2023-03-16 02:11:54,0.9645023148148149,1,5,5,10
2023-03-14 19:27:43,0.12061342592592593,1,18,2,20
2023-03-17 09:09:02,3.518101851851852,3,20,7,27
2023-03-14 13:50:09,0.6771296296296296,1,1,1,2
2023-03-14 13:50:19,0.6789467592592593,1,53,53,106
2023-03-14 13:55:42,0.7026041666666667,1,2,2,4
2023-03-13 10:16:24,0.25761574074074073,1,62,26,88
2023-03-16 01:44:57,2.9028819444444443,1,36,36,72
2023-03-16 01:42:28,0.9428472222222222,1,5,5,10
2023-03-13 10:32:16,0.27479166666666666,1,1,1,2
2023-03-12 23:03:07,0.6758564814814815,1,2,9,11
2023-03-16 03:31:08,4.113078703703704,2,2201,250,2451
2023-03-12 23:06:27,1.2392824074074074,1,1,1,2
2023-04-26 16:21:33,46.754247685185184,11,470,287,757
2023-03-10 18:31:10,0.12398148148148148,1,95,0,95
2023-03-14 13:47:57,3.8994444444444443,1,2,0,2
2023-03-10 10:10:47,0.5560069444444444,1,7,7,14
2023-04-26 15:25:08,39.84349537037037,1,3,12,15
2023-04-26 18:21:54,39.97498842592593,1,53,76,129
2023-03-10 14:24:19,0.8720138888888889,1,21,15,36
2023-03-17 09:08:10,0.015185185185185185,1,8,6,14
2023-03-12 22:47:55,3.2566087962962964,1,5,4,9
2023-03-10 10:12:06,0.7758796296296296,1,1,1,2
2023-03-10 13:08:10,0.8999768518518518,1,1,1,2
2023-10-17 16:28:10,222.39128472222222,1,12,0,12
2023-03-16 10:07:24,7.632164351851852,8,309,324,633
2023-03-09 13:27:49,0.8170833333333334,2,24,2,26
2023-03-15 02:45:16,6.511145833333333,1,16,16,32
2023-03-09 13:35:44,1.2147916666666667,1,1,0,1
2023-03-08 18:26:25,0.5049189814814815,1,2,0,2
2023-03-08 06:12:58,0.008912037037037038,1,6,0,6
2023-03-15 02:52:40,27.408877314814816,1,5,1,6
2023-03-08 18:56:41,1.0342939814814816,3,624,742,1366
2023-03-10 11:12:52,3.5436574074074074,5,217,0,217
2023-03-08 10:45:10,1.5998726851851852,1,2,2,4
2023-03-08 15:25:17,1.7953472222222222,1,3,84,87
2023-04-26 15:10:21,41.55179398148148,1,1,1,2
2023-03-08 10:31:47,1.5950462962962964,1,3,3,6
2023-03-08 11:00:06,1.6158333333333332,1,391,238,629
2023-03-08 10:30:36,1.5960300925925925,1,5,5,10
2023-03-08 10:29:57,1.595613425925926,1,1,1,2
2023-03-08 11:53:49,1.3354050925925927,1,4,4,8
2023-03-08 11:14:19,0.008657407407407407,1,11,78,89
2023-03-08 10:32:09,1.5978125,1,1,1,2
2023-03-08 10:32:22,1.598136574074074,1,5,5,10
2023-03-08 11:54:12,1.655173611111111,1,5,5,10
2023-03-08 10:32:44,1.5995949074074074,1,5,5,10
2023-03-08 10:44:24,0.007696759259259259,1,6,6,12
2023-03-06 20:00:10,0.09796296296296296,1,7,13,20
2023-03-06 16:44:55,0.04454861111111111,1,3,1,4
2023-03-10 12:33:31,4.896608796296296,16,336,1,337
2023-03-06 16:33:59,0.06342592592592593,1,0,69,69
2023-03-06 15:25:36,0.03287037037037037,2,0,144,144
2023-04-23 21:11:50,48.67888888888889,2,108,22,130
2023-03-15 02:56:09,9.044166666666667,1,14,0,14
2023-04-05 21:58:45,30.97954861111111,1,6,4,10
2023-04-23 20:46:13,48.99550925925926,1,176,5,181
2023-03-06 14:37:20,1.0557175925925926,2,113,81,194
2023-05-22 11:43:05,77.8871875,1,128,13,141
2023-04-26 15:09:26,52.271388888888886,9,39,0,39
2023-03-10 15:32:38,0.008645833333333333,1,17,72,89
2023-03-06 14:43:21,1.4233796296296297,1,0,2,2
2023-03-17 09:13:28,12.269490740740741,5,413,10,423
2023-03-05 00:52:13,0.06528935185185185,1,38,8,46
2023-03-05 00:52:43,0.11265046296296297,1,1,0,1
2023-03-04 22:17:46,0.12990740740740742,1,3,2,5
2023-03-04 22:18:20,6.13818287037037,1,11,15,26
2023-03-04 17:31:13,0.04292824074074074,1,25,0,25
2023-03-04 23:33:09,1.0809259259259258,2,5,2,7
2023-03-27 08:56:26,23.47476851851852,1,279,571,850
2023-03-04 15:56:10,0.7891319444444445,1,303,0,303
2023-03-03 21:49:16,0.032916666666666664,1,1,1,2
2023-06-06 21:41:59,95.751875,1,7,0,7
2023-03-04 15:43:47,1.0607060185185184,4,121,0,121
2023-03-04 15:58:11,1.73,5,216,10,226
2023-03-06 16:33:10,0.02449074074074074,1,16,1,17
2023-03-04 16:12:54,1.8629398148148149,25,537,0,537
2023-03-04 16:00:00,1.9665625,7,43,5,48
2023-03-04 16:12:10,11.867743055555556,6,27,183,210
2023-03-04 15:57:22,2.72181712962963,18,393,3,396
2023-03-03 21:55:44,1.321412037037037,1,3,131,134
2023-03-04 16:13:29,2.8186921296296297,20,428,0,428
2023-03-04 15:56:43,2.8556712962962965,7,144,0,144
2023-05-02 13:41:20,61.86496527777778,1,584,575,1159
2023-03-03 19:19:29,2.149513888888889,3,85,27,112
2023-03-04 16:16:45,3.0772916666666665,9,128,17,145
2023-03-02 14:55:38,1.7179398148148148,1,19,19,38
2023-03-02 09:04:15,1.5743287037037037,5,114,10,124
2023-03-04 16:16:11,4.103680555555556,5,49,1,50
2023-03-16 12:02:01,9.784201388888889,250,30821,11094,41915
2023-02-27 18:03:35,0.030960648148148147,1,0,4,4
2023-02-28 10:56:50,0.7807060185185185,1,0,11,11
2023-03-02 14:30:40,2.936747685185185,1,54,0,54
2023-02-27 15:35:48,0.012337962962962964,1,3,1,4
2023-02-26 19:13:28,0.13662037037037036,3,82,27,109
2023-03-02 09:05:05,3.6930092592592594,1,45,1,46
2023-05-19 15:14:16,82.36476851851852,1,18,2,20
2023-03-03 21:48:49,5.847974537037037,1,0,2,2
2023-03-03 21:53:09,5.875115740740741,2,1260,509,1769
2023-04-23 20:49:08,57.197604166666665,2,0,12,12
2023-03-03 20:06:31,6.930543981481481,3,342,37,379
2023-03-04 23:33:52,7.850983796296297,2,13,14,27
2023-03-04 23:35:00,8.059189814814815,4,122,120,242
2023-07-12 07:47:55,137.43181712962962,1,3,2,5
2023-02-24 19:04:38,0.06836805555555556,1,3,2,5
2023-11-14 16:53:54,1.426261574074074,1,18,1,19
2023-02-24 19:06:32,0.12142361111111111,3,0,141,141
2023-02-28 13:33:34,4.67130787037037,4,66,4,70
2023-05-04 03:50:41,47.22928240740741,1,10,72,82
2023-02-28 13:59:19,4.428032407407407,1,1,8,9
2023-03-16 00:36:38,19.876828703703705,1,1,9,10
2023-02-23 22:17:49,0.023171296296296297,1,10,10,20
2023-02-23 11:58:43,0.12939814814814815,2,5,1,6
2023-03-15 03:01:11,19.795636574074074,1,333,673,1006
2023-02-23 10:28:56,0.14574074074074075,1,8,8,16
2023-03-02 10:08:23,7.248020833333333,2,5,5,10
2023-03-02 10:41:32,7.272303240740741,2,5,5,10
2023-03-02 10:45:15,7.2861921296296295,2,5,5,10
2023-03-31 14:08:53,36.83361111111111,3,58,16,74
2023-02-27 08:31:16,4.612372685185186,1,73,3,76
2023-03-03 19:25:16,9.15554398148148,1,40,10,50
2023-03-03 19:25:37,9.203715277777778,1,2,2,4
2023-03-06 15:00:08,12.062939814814815,2,3,0,3
2023-02-28 14:01:05,3.748287037037037,250,19579,6426,26005
2023-02-22 10:53:14,0.007916666666666667,1,1,1,2
2023-02-22 09:28:53,0.01980324074074074,1,23,4,27
2023-03-16 01:34:00,21.69295138888889,1,5,14,19
2023-02-28 12:30:29,6.349722222222222,2,3,3,6
2023-07-12 07:47:09,140.26328703703703,1,784,399,1183
2023-02-22 00:54:36,0.08840277777777777,2,28,47,75
2023-02-22 00:55:31,0.13902777777777778,1,738,0,738
2023-03-03 19:36:18,10.160277777777777,1,9,0,9
2023-02-22 00:56:11,1.112337962962963,1,1,0,1
2023-04-23 20:47:58,19.85390046296296,1,7,0,7
2023-02-21 08:29:08,0.46497685185185184,1,3,3,6
2023-02-21 09:59:58,0.008645833333333333,1,6,6,12
2023-02-21 09:44:51,0.5238194444444444,1,7,7,14
2023-02-21 08:30:59,0.47413194444444445,1,7,7,14
2023-02-21 08:33:30,0.47747685185185185,1,7,7,14
2023-02-21 08:41:29,0.4837152777777778,1,7,7,14
2023-02-21 10:35:28,0.01361111111111111,1,25,18,43
2023-02-21 09:46:03,0.5296296296296297,1,90,54,144
2023-02-21 10:14:26,0.007951388888888888,1,12,12,24
2023-02-22 00:57:57,1.1873958333333334,1,1,8,9
2023-02-21 09:06:14,0.5753356481481482,1,1,1,2
2023-02-21 01:21:48,0.25950231481481484,1,2,9,11
2023-03-31 13:07:22,38.77251157407407,1,7,18,25
2023-02-22 00:57:15,1.278125,1,10,22,32
2023-02-20 18:20:57,0.028993055555555557,1,2,9,11
2023-02-20 18:21:19,0.0356712962962963,1,3,10,13
2023-05-04 03:51:19,72.43398148148148,1,4,9,13
2023-05-04 03:57:41,72.44791666666667,1,5,10,15
2023-05-04 03:54:27,72.45315972222222,1,9,22,31
2023-03-15 03:01:50,22.446875,1,1,1,2
2023-03-03 19:37:22,11.146469907407408,1,1,0,1
2023-02-21 08:23:40,0.6999305555555555,1,1,1,2
2023-02-20 10:02:07,0.0979513888888889,4,6,0,6
2023-02-20 10:01:20,0.10844907407407407,2,51,66,117
2023-02-20 06:58:34,0.022893518518518518,1,3,13,16
2023-02-20 06:58:46,0.039976851851851854,1,4,12,16
2023-02-20 05:51:43,0.008263888888888888,1,4,11,15
2023-02-20 05:14:50,0.022314814814814815,1,139,182,321
2023-02-20 05:14:11,0.03584490740740741,1,27,50,77
2023-02-20 04:00:37,0.013993055555555555,1,12,28,40
2023-02-20 02:21:00,0.3088078703703704,5,10,2,12
2023-02-20 01:18:55,0.19047453703703704,1,3,16,19
2023-02-20 01:19:40,0.19315972222222222,1,8,20,28
2023-02-20 01:28:40,0.21318287037037037,2,18,29,47
2023-03-25 09:00:04,33.95568287037037,1,43,251,294
2023-02-20 02:17:41,0.7365856481481482,1,56,83,139
2023-02-20 01:32:11,0.710949074074074,1,6,19,25
2023-02-20 01:33:27,0.7144675925925926,1,94,214,308
2023-02-20 04:00:48,0.9135532407407407,2,184,221,405
2023-02-20 04:01:00,0.921724537037037,1,2,7,9
2023-02-20 01:46:00,0.8320833333333333,1,19,21,40
2023-02-19 05:54:35,0.0071875,1,1,7,8
2023-02-20 02:16:41,0.8800810185185185,4,1043,1208,2251
2023-02-19 06:02:46,0.1535300925925926,1,15,9,24
2023-07-11 13:23:57,105.68371527777778,3,98,10,108
2023-02-20 01:45:50,1.0644791666666666,1,3,11,14
2023-02-18 21:59:00,0.13952546296296298,1,18,26,44
2023-02-18 22:10:20,0.15741898148148148,1,25,21,46
2023-02-18 22:00:18,0.1947800925925926,1,18,31,49
2023-02-18 22:12:07,0.2058449074074074,1,3,9,12
2023-02-20 02:18:09,1.3789236111111112,1,2,10,12
2023-02-18 22:09:40,0.21078703703703705,1,462,699,1161
2023-03-03 19:37:50,10.894560185185185,1,1,1,2
2023-02-18 11:37:48,0.18715277777777778,1,55,271,326
2023-02-18 11:39:00,0.19979166666666667,1,7,19,26
2023-02-18 22:38:14,0.6612152777777778,1,277,359,636
2023-02-18 11:39:58,0.2141550925925926,1,8,18,26
2023-02-18 14:33:41,0.3677199074074074,1,61,89,150
2023-02-18 21:54:30,0.683587962962963,1,10,22,32
2023-02-21 09:41:28,3.1782523148148147,1,7,7,14
2023-06-06 12:50:51,108.37710648148148,5,54,100,154
2023-02-18 05:56:16,0.10072916666666666,1,2,2,4
2023-02-18 03:25:32,0.011018518518518518,1,5,0,5
2023-02-18 03:30:14,0.034131944444444444,1,1,8,9
2023-02-18 02:24:17,0.04393518518518519,1,32,46,78
2023-02-18 02:23:49,0.10232638888888888,1,35,49,84
2023-02-18 03:00:05,0.13664351851851853,1,6,15,21
2023-02-18 03:30:24,0.1824074074074074,1,16,27,43
2023-02-18 02:22:02,0.1409490740740741,1,7,15,22
2023-02-20 05:58:29,2.325289351851852,3,265,261,526
2023-02-18 02:25:48,0.2969097222222222,1,11,14,25
2023-02-18 22:18:00,1.1276967592592593,1,3,9,12
2023-02-20 04:24:14,2.3838773148148147,1,256,338,594
2023-02-18 02:59:58,0.3557986111111111,1,1,11,12
2023-02-18 02:26:20,0.3486342592592593,2,10,20,30
2023-02-18 11:47:37,0.7479976851851852,1,2,9,11
2023-02-18 02:26:42,0.3712847222222222,1,0,4,4
2023-02-17 12:46:01,0.11896990740740741,1,2,7,9
2023-02-17 09:06:25,0.0428125,1,13,13,26
2023-02-17 08:52:30,0.03454861111111111,1,5,5,10
2023-02-17 08:56:04,0.03951388888888889,1,432,273,705
2023-02-17 08:54:15,0.03936342592592593,1,5,5,10
2023-02-17 09:19:24,0.011828703703703704,1,11,85,96
2023-02-17 09:26:17,0.00917824074074074,1,1,87,88
2023-02-17 12:45:27,0.33067129629629627,1,22,41,63
2023-07-12 07:44:15,144.57344907407406,1,5,7,12
2023-02-18 02:32:58,0.9364583333333333,2,2,15,17
2023-02-17 13:47:23,0.40652777777777777,1,2,11,13
2023-02-18 05:20:21,1.0564467592592592,1,2,8,10
2023-02-18 02:05:57,0.9257407407407408,1,18,24,42
2023-02-17 12:43:10,0.37997685185185187,1,1,9,10
2023-02-17 12:36:15,0.37783564814814813,1,6,14,20
2023-02-17 08:51:28,0.6518402777777778,1,1,1,2
2023-02-19 06:12:32,2.636585648148148,1,3,3,6
2023-02-17 21:56:21,1.6254861111111112,1,269,566,835
2023-05-09 17:02:13,6.014328703703704,3,465,303,768
2023-03-30 12:44:00,140.19766203703705,3,819,527,1346
2023-02-16 06:33:50,0.061689814814814815,3,4097,405,4502
2023-02-16 03:59:45,0.0084375,1,8,0,8
2023-02-22 12:16:03,3.9708217592592594,250,26338,9868,36206
2023-02-19 06:06:34,3.2275810185185185,7,329,212,541
2023-02-16 00:24:36,0.011967592592592592,2,52,26,78
2023-02-20 07:11:24,4.556099537037037,2,6973,3965,10938
2023-03-02 15:21:05,9.910185185185185,2,47,3,50
2023-03-04 15:38:28,17.165694444444444,1,37,38,75
2023-04-12 12:50:02,56.12501157407407,1,20,1,21
2023-03-15 03:14:48,27.79232638888889,1,14,14,28
2023-03-07 03:49:44,20.431238425925926,45,1353,1342,2695
2023-07-19 07:02:50,168.07964120370372,2,40,1,41
2023-05-02 15:42:42,76.90552083333333,3,49,14,63
2023-03-03 19:44:47,17.199710648148148,1,8,0,8
2023-02-14 18:05:58,0.31194444444444447,1,2,0,2
2023-02-14 12:50:56,0.15256944444444445,1,17,1,18
2023-02-14 08:07:13,0.4423842592592593,1,2,2,4
2023-02-14 08:27:24,0.008020833333333333,1,440,272,712
2023-02-14 08:14:29,0.4595601851851852,1,5,5,10
2023-02-14 08:44:26,0.010868055555555556,1,1,87,88
2023-02-14 08:35:11,0.00443287037037037,1,11,85,96
2023-02-14 08:14:11,0.46326388888888886,1,12,11,23
2023-02-14 08:12:42,0.4636226851851852,1,5,5,10
2023-02-14 08:12:22,0.4642013888888889,1,5,5,10
2023-02-14 08:12:14,0.4666550925925926,1,5,5,10
2023-02-14 08:11:52,0.46773148148148147,1,1,1,2
2023-03-03 19:44:03,18.157395833333332,1,1,1,2
2023-02-13 15:33:35,0.054467592592592595,1,6,6,12
2023-02-13 13:36:07,0.006990740740740741,1,6,0,6
2023-02-13 12:55:55,0.015497685185185186,1,1,1,2
2023-03-15 03:15:21,29.639282407407407,1,3,3,6
2023-03-03 19:45:13,18.460266203703704,1,1,1,2
2023-02-19 06:11:19,5.900416666666667,1,13,5,18
2023-03-15 02:43:50,29.834328703703704,1,2,2,4
2023-02-16 01:24:06,2.8502662037037036,1,4,0,4
2023-06-01 00:25:13,107.81966435185186,3,33,23,56
2023-02-18 05:21:10,5.033530092592593,1,3,3,6
2023-02-13 03:57:03,0.01747685185185185,1,311,179,490
2023-02-13 03:57:51,0.15690972222222221,1,3,3,6
2023-02-13 03:58:37,0.24606481481481482,1,3,3,6
2023-02-17 07:54:13,4.520185185185185,1,15,0,15
2023-02-13 03:58:56,0.7607523148148149,2,2,1,3
2023-02-13 13:39:24,1.2559375,2,2,2,4
2023-02-12 07:34:17,0.009097222222222222,1,1,0,1
2023-02-13 03:59:31,0.8618865740740741,1,10,10,20
2023-02-18 11:44:45,6.574733796296297,2,14,12,26
2023-02-16 01:23:04,4.7273958333333335,134,5238,4162,9400
2023-02-13 13:54:09,2.2965046296296294,1,7,4,11
2023-03-15 03:15:36,31.8865625,14,340,237,577
2023-02-13 13:38:43,2.4359722222222224,1,3,3,6
2023-02-11 02:00:44,0.011226851851851852,1,3,3,6
2023-02-11 01:15:08,0.014247685185185184,1,9,9,18
2023-02-11 03:02:08,0.19760416666666666,1,1,2,3
2023-02-10 21:48:50,0.007615740740740741,1,1,0,1
2023-02-18 11:49:09,7.611134259259259,2,9,1,10
2023-02-10 21:04:13,0.013090277777777777,1,0,23,23
2023-02-10 21:16:37,15.276030092592592,3,126,22,148
2023-02-10 21:03:36,0.2533564814814815,1,7,0,7
2023-02-10 10:14:58,0.03920138888888889,1,2,2,4
2023-02-10 09:20:43,0.01923611111111111,1,1,1,2
2023-06-02 16:35:38,113.06165509259259,3,22,17,39
2023-02-10 21:21:24,1.402048611111111,3,34,16,50
2023-02-09 10:20:59,0.060127314814814814,1,6,8,14
2023-02-09 10:24:16,0.07064814814814815,1,9,0,9
2023-02-13 13:39:00,4.54337962962963,1,1,1,2
2023-02-18 03:30:03,9.406527777777777,1,3,11,14
2023-02-08 16:57:25,0.013564814814814814,1,2,9,11
2023-03-03 19:45:56,23.263414351851853,1,1,1,2
2023-02-08 06:06:51,0.08013888888888888,1,2,4,6
2023-02-08 06:07:37,0.08630787037037037,1,12,12,24
2023-02-08 06:06:21,0.12540509259259258,1,2,2,4
2023-02-08 06:08:39,0.1360185185185185,1,0,2,2
2023-02-08 09:39:58,0.29399305555555555,2,5,5,10
2023-02-08 09:38:08,0.2956597222222222,1,7,7,14
2023-02-08 02:21:21,0.032615740740740744,1,1,1,2
2023-02-08 01:36:20,0.0067476851851851856,1,3,3,6
2023-02-08 01:25:20,0.014537037037037038,2,2,2,4
2023-02-08 01:06:49,0.02908564814814815,1,1,1,2
2023-02-08 09:36:24,0.38631944444444444,2,7,7,14
2023-02-07 23:58:19,0.010694444444444444,1,2,2,4
2023-02-08 00:10:26,0.28835648148148146,1,2,2,4
2023-02-07 02:44:37,0.06498842592592592,2,21,19,40
2023-02-07 00:03:27,0.008240740740740741,1,2,2,4
2023-02-09 13:46:43,2.719097222222222,3,13,61,74
2023-02-07 15:38:31,0.8002662037037037,1,1,1,2
2023-02-07 15:39:02,0.8009837962962963,1,2,2,4
2023-02-07 15:39:37,0.8075810185185185,1,1,1,2
2023-02-07 15:41:08,0.8111111111111111,1,5,5,10
2023-02-08 09:54:52,1.571388888888889,1,5,5,10
2023-02-07 15:40:16,0.8125,1,5,5,10
2023-02-07 15:40:36,0.8128009259259259,1,1,1,2
2023-02-06 20:00:58,0.010578703703703703,1,1,1,2
2023-02-10 20:42:09,4.118912037037037,71,3777,3260,7037
2023-02-07 00:23:22,0.7907175925925926,1,1,1,2
2023-10-17 12:56:24,254.64429398148147,4,127150,89270,216420
2023-02-06 15:53:32,1.985648148148148,2,2,1,3
2023-02-04 15:34:22,0.27752314814814816,1,5,1,6
2023-02-06 17:41:32,2.416446759259259,250,17795,17052,34847
2023-02-04 03:56:07,0.20248842592592592,1,25,5,30
2023-02-03 20:29:24,0.0425,1,12,0,12
2023-02-06 15:50:09,2.9242476851851853,1,2,10,12
2023-02-03 15:39:39,0.006782407407407407,1,13,2,15
2023-05-02 13:10:09,88.1794212962963,1,1,1,2
2023-02-03 09:16:47,0.2616435185185185,1,0,3,3
2023-02-18 11:46:45,16.282557870370372,4,24,2,26
2023-05-02 13:09:44,89.87902777777778,10,222,128,350
2023-02-02 11:03:50,0.8483449074074074,1,8,2,10
2023-02-04 06:46:09,2.7179398148148146,111,1264,2164,3428
2023-02-01 12:15:42,0.011909722222222223,1,1,0,1
2023-02-01 14:15:12,0.12922453703703704,1,4,0,4
2023-02-01 10:24:23,0.3680671296296296,1,1,1,2
2023-02-01 10:23:55,0.3703125,1,1,1,2
2023-02-01 23:07:49,0.9021064814814815,1,9,1,10
2023-02-01 10:16:38,1.572488425925926,1,5,5,10
2023-02-04 06:55:08,4.4327199074074075,1,3,3,6
2023-02-01 10:19:31,1.574814814814815,1,3,3,6
2023-02-01 10:31:50,0.0061805555555555555,1,1,1,2
2023-02-01 10:16:13,1.5808449074074074,1,1,1,2
2023-02-01 10:18:53,1.5863310185185184,1,5,5,10
2023-02-01 10:44:30,0.011006944444444444,1,427,244,671
2023-02-01 10:18:31,1.5874189814814814,1,5,5,10
2023-02-01 11:09:43,1.6242708333333333,1,1,1,2
2023-02-01 10:14:44,1.5890277777777777,1,5,5,10
2023-02-01 10:53:14,0.004756944444444445,1,2,83,85
2023-02-01 10:33:08,0.00712962962962963,1,1,1,2
2023-02-01 10:53:55,0.005231481481481481,1,11,104,115
2023-02-01 10:07:17,1.5861574074074074,1,5,5,10
2023-02-01 10:12:12,1.5899537037037037,1,5,5,10
2023-02-01 10:07:00,0.004953703703703704,1,54,54,108
2023-02-01 09:58:43,1.5809259259259258,1,5,5,10
2023-02-01 09:58:11,1.5812037037037037,1,3,3,6
2023-02-23 15:52:41,24.101747685185185,2,8,26,34
2023-02-13 12:24:00,14.019976851851851,1,37,0,37
2023-02-07 00:14:45,7.5540162037037035,2,40,1,41
2023-02-13 14:12:31,14.349305555555556,1,22,23,45
2023-02-02 01:14:20,2.8811574074074073,2,19,1189,1208
2023-02-13 14:12:14,14.443506944444444,1,11,12,23
2023-01-30 05:17:46,0.07884259259259259,1,0,1,1
2023-01-30 05:18:13,0.11193287037037038,1,35,38,73
2023-03-27 03:17:19,56.0493287037037,1,285,6,291
2023-01-30 02:07:51,0.012546296296296297,1,5,6,11
2023-01-30 02:07:19,0.028587962962962964,1,5,0,5
2023-01-30 00:45:35,0.026145833333333333,1,833,811,1644
2023-03-08 16:06:54,37.67148148148148,5,20889,9943,30832
2023-01-29 23:23:52,0.014861111111111111,1,48,13,61
2023-06-26 12:17:42,147.61436342592592,1,114,29,143
2023-01-29 18:00:19,0.22989583333333333,1,10,4,14
2023-01-29 14:59:58,0.47069444444444447,1,2,1,3
2023-06-06 08:42:48,128.22199074074075,2,137,14,151
2023-02-03 08:29:33,5.4657175925925925,1,8,2,10
2023-01-29 18:02:04,36.01762731481482,2,9250,3931,13181
2023-01-28 09:12:57,0.3273263888888889,1,1,1,2
2023-02-13 15:04:27,18.038229166666667,2,31,12,43
2023-06-02 16:09:09,127.27989583333333,3,22,12,34
2023-01-25 18:55:41,64.21579861111111,1,23,5,28
2023-01-25 15:28:30,0.08835648148148148,2,1,20,21
2023-01-24 19:18:26,0.1386226851851852,1,3,1,4
2023-01-24 19:18:42,0.19480324074074074,2,29,0,29
2023-01-24 18:40:22,0.23983796296296298,2,152,10,162
2023-01-24 17:50:13,0.3446412037037037,1,1,1,2
2023-01-30 15:46:27,6.2889236111111115,1,15,13,28
2023-01-24 17:49:21,0.37918981481481484,1,10,2,12
2023-01-24 08:46:26,0.5204166666666666,1,1,1,2
2023-01-24 11:43:41,0.6466087962962963,1,19,11,30
2023-01-24 08:48:06,0.5270138888888889,1,1,1,2
2023-01-24 08:48:28,0.5276620370370371,1,5,5,10
2023-01-24 08:48:49,0.5290856481481482,1,5,5,10
2023-01-24 08:49:29,0.5299537037037036,1,22,14,36
2023-01-30 02:15:45,6.258263888888889,1,5,5,10
2023-01-30 15:48:29,6.822962962962963,1,6,1,7
2023-01-24 11:42:45,0.11907407407407407,1,5,5,10
2023-01-24 16:52:07,0.8680671296296296,1,5,5,10
2023-01-24 09:01:30,0.5415046296296296,1,5,5,10
2023-02-13 14:47:51,20.831168981481483,2,7152,4060,11212
2023-02-01 10:59:31,7.627743055555555,250,9263,6080,15343
2023-01-25 15:20:55,2.0258101851851853,1,12,3,15
2023-01-23 16:42:58,0.12313657407407408,1,3,3,6
2023-01-23 17:03:21,0.1880902777777778,1,1,1,2
2023-02-13 12:31:43,21.008530092592594,2,54,55,109
2023-01-23 12:21:51,0.051145833333333335,2,19,4,23
2023-01-23 12:05:31,0.12665509259259258,2,13,1,14
2023-01-23 12:05:55,0.4717939814814815,2,24,2,26
2023-01-23 12:14:12,0.5771643518518519,1,3,3,6
2023-01-30 01:58:00,7.149895833333333,1,6,6,12
2023-01-22 22:09:02,1.0489814814814815,1,4,4,8
2023-01-24 15:24:46,2.9403125,1,18,16,34
2023-01-21 14:33:22,0.02903935185185185,1,1,1,2
2023-03-03 19:50:46,41.27300925925926,1,25,2,27
2023-01-21 09:22:23,0.3174537037037037,1,8,0,8
2023-01-19 14:51:15,0.04840277777777778,1,4,58,62
2023-01-19 14:51:28,0.07289351851851852,1,8,0,8
2023-01-23 15:37:36,4.888796296296296,227,15766,15394,31160
2023-01-18 10:40:22,0.005023148148148148,1,65,56,121
2023-01-18 10:31:56,0.007893518518518518,1,1,1,2
2023-01-18 10:31:40,0.007453703703703704,1,3,3,6
2023-01-18 09:54:19,1.5628935185185184,1,5,5,10
2023-01-18 09:52:12,1.5710648148148147,1,5,5,10
2023-01-18 09:52:35,1.571712962962963,1,5,5,10
2023-01-18 09:52:51,1.573125,1,5,5,10
2023-01-18 10:14:12,1.588125,1,6,3,9
2023-01-30 02:12:35,0.02185185185185185,2,248,113,361
2023-01-30 01:56:09,0.01056712962962963,1,41,79,120
2023-01-18 10:13:32,1.5899768518518518,1,5,5,10
2023-01-18 09:53:12,1.5768055555555556,1,6,1,7
2023-01-20 13:19:13,3.9275,1,179,3,182
2023-01-30 13:49:10,15.398900462962963,1,3,3,6
2023-01-13 14:12:26,0.09854166666666667,1,0,2,2
2023-01-13 09:17:08,0.4204398148148148,1,1,1,2
2023-01-18 15:21:49,6.063888888888889,1,8,3,11
2023-01-12 15:43:03,0.17569444444444443,2,5,5,10
2023-01-18 17:31:14,4.945798611111111,250,22469,19896,42365
2023-01-10 13:33:41,0.01326388888888889,1,1,1,2
2023-01-29 22:44:03,19.678148148148146,3,52,14,66
2023-01-11 13:02:06,0.0075,1,5,5,10
2023-01-11 12:49:40,1.6978935185185184,1,5,5,10
2023-01-11 12:47:00,1.6961689814814815,1,5,5,10
2023-01-11 12:50:02,1.698912037037037,1,17,17,34
2023-01-11 12:46:08,1.696412037037037,1,5,5,10
2023-01-11 12:45:37,1.6967939814814814,1,34,2,36
2023-01-11 12:44:08,1.6965162037037036,1,5,5,10
2023-01-10 04:18:43,0.563136574074074,1,1,5,6
2023-01-11 20:51:44,2.2712731481481483,1,1,1,2
2023-01-11 20:53:12,2.2886689814814813,2,51,12,63
2023-01-06 06:35:52,0.4081712962962963,4,15,14,29
2023-01-11 12:41:35,5.0941782407407405,250,14323,1699,16022
2023-01-11 20:57:25,6.165439814814815,2,20,25,45
2023-02-20 10:32:27,46.00384259259259,1,3,7,10
2023-01-05 12:29:49,0.7168287037037037,2,2,0,2
2023-02-15 07:30:28,66.71649305555556,12,51,37,88
2023-01-04 10:46:44,0.4140277777777778,1,2,2,4
2023-01-04 10:47:02,0.41733796296296294,1,3,3,6
2023-01-04 00:45:17,0.24885416666666665,1,0,5,5
2023-01-11 20:58:47,9.27599537037037,16,371,341,712
2023-01-04 10:47:19,1.6091898148148147,1,1,1,2
2023-01-04 11:58:26,15.069305555555555,5,10,10,20
2023-01-04 10:47:39,1.6153356481481482,1,5,5,10
2023-01-04 12:13:58,57.666111111111114,3,56,56,112
2023-01-05 16:03:53,4.025439814814815,154,14596,14042,28638
2023-01-04 01:12:48,3.0074305555555556,3,51,32,83
2023-01-11 20:59:13,19.011226851851852,3,85,47,132
2023-01-05 12:30:39,6.327280092592592,5,16,3,19
2023-01-13 16:14:40,14.859421296296297,3,5381,2395,7776
2023-01-09 02:18:20,10.549548611111112,1,1,1,2
2023-01-13 15:43:18,15.780613425925926,2,9,1,10
2022-12-28 09:21:10,0.37246527777777777,1,2,4,6
2023-01-18 15:30:47,22.008877314814814,1,1,1,2
2023-01-13 15:40:22,17.090625,3,14,4,18
2023-01-09 02:52:37,13.075347222222222,1,4,2,6
2022-12-27 00:51:39,0.009988425925925927,1,3,3,6
2022-12-27 00:38:26,0.1882060185185185,1,5,5,10
2022-12-27 00:37:19,0.18789351851851852,1,5,5,10
2022-12-27 00:37:36,0.18837962962962962,1,5,5,10
2022-12-27 00:39:09,0.18989583333333335,1,65,59,124
2022-12-27 00:39:27,0.19050925925925927,1,5,5,10
2022-12-27 00:52:16,0.20033564814814814,1,3,3,6
2022-12-27 00:51:24,0.007511574074074074,1,27,26,53
2022-12-27 00:35:54,0.19108796296296296,1,3,3,6
2024-04-29 08:01:22,491.67895833333336,1,0,22,22
2023-01-05 12:31:06,12.61704861111111,1,5,0,5
2023-01-05 12:32:02,12.870011574074073,4,5,143,148
2023-01-05 12:33:00,13.265914351851851,1,6,0,6
2023-01-05 12:33:33,14.054212962962962,2,7,0,7
2022-12-21 03:40:51,0.01778935185185185,1,6,6,12
2022-12-21 03:06:44,0.0052199074074074075,1,6,6,12
2022-12-21 02:58:02,0.0221875,1,6,6,12
2023-01-05 12:39:30,15.535185185185185,1,1,1,2
2023-01-09 02:54:03,19.289502314814815,2,18,16,34
2023-01-05 12:34:11,15.713043981481482,2,3,3,6
2023-01-05 12:39:59,15.771331018518518,1,1,1,2
2023-01-01 12:31:54,10.231516203703704,250,22532,8245,30777
2023-01-11 21:21:10,22.311064814814817,1,5,1,6
2023-01-05 12:35:28,15.984872685185184,2,4,4,8
2023-01-18 15:32:24,29.121608796296297,2,10,1,11
2023-01-05 12:35:47,16.044664351851853,1,1,1,2
2022-12-21 02:22:23,0.6495023148148148,1,6,6,12
2022-12-20 10:44:56,0.018692129629629628,1,6,6,12
2023-01-18 15:29:08,29.246886574074075,1,1,1,2
2023-01-05 12:36:25,16.324641203703703,1,2,2,4
2022-12-20 10:08:23,0.5813541666666666,1,9,9,18
2022-12-20 10:07:57,0.5828472222222222,1,5,5,10
2022-12-20 10:08:53,0.5879050925925926,1,3,3,6
2022-12-20 10:09:14,0.5883449074074074,1,1,1,2
2023-01-05 12:36:42,16.7128125,1,5,1,6
2023-01-05 12:40:28,16.869699074074074,1,2,2,4
2023-01-12 13:11:55,23.950752314814814,1,2,2,4
2023-01-18 16:15:24,30.10152777777778,2,6,6,12
2022-12-19 16:55:18,0.16755787037037037,1,10,0,10
2023-01-05 12:42:38,17.02398148148148,1,1,1,2
2023-01-18 15:25:32,30.183900462962963,1,12,2,14
2023-03-03 19:53:37,74.42403935185185,1,6,0,6
2023-01-05 12:42:04,17.144108796296297,2,19,1,20
2023-01-05 12:42:13,17.513055555555557,1,4,3,7
2022-12-19 00:46:22,0.11534722222222223,1,3,3,6
2023-01-13 15:40:07,25.76900462962963,1,8,1,9
2023-01-30 02:08:37,0.026574074074074073,1,5,7,12
2023-01-05 12:43:57,17.698645833333334,1,2,2,4
2022-12-18 15:51:38,0.5438888888888889,3,350,348,698
2023-01-30 01:11:51,43.001099537037035,1,2,2,4
2023-01-05 12:44:32,18.569988425925924,1,10,2,12
2024-02-23 22:15:53,81.0860300925926,1,2,2,4
2023-01-05 12:45:01,19.379814814814814,2,4,4,8
2023-01-05 12:45:21,19.726412037037036,1,78,2,80
2023-01-18 15:40:10,32.93818287037037,4,242,31,273
2023-01-05 12:47:22,20.04138888888889,2,18,19,37
2022-12-20 14:02:48,4.381006944444445,250,18077,12935,31012
2022-12-16 02:11:52,0.13746527777777778,1,39,40,79
2023-01-05 12:47:36,20.663900462962964,1,2,2,4
2023-01-05 12:45:38,20.66494212962963,1,0,6,6
2023-01-13 16:00:24,29.076006944444444,2,88,15,103
2022-12-15 13:52:50,0.015347222222222222,1,32,9,41
2022-12-15 13:15:50,0.01099537037037037,2,10,4,14
2022-12-15 13:07:35,0.031099537037037037,1,3,1,4
2022-12-15 14:56:06,0.16641203703703702,1,4,4,8
2023-01-18 15:33:03,34.97553240740741,4,10,8,18
2022-12-15 14:52:18,1.233599537037037,1,1,1,2
2022-12-13 20:41:34,0.00787037037037037,1,3,3,6
2022-12-13 20:34:08,0.005416666666666667,1,1,1,2
2022-12-15 16:40:37,1.888125,2,22,1,23
2022-12-13 18:41:53,0.2015625,1,3,1,4
2022-12-15 16:41:20,2.2279976851851853,1,1,1,2
2022-12-13 20:31:22,1.0150578703703703,1,1,1,2
2022-12-20 10:10:10,1.1302893518518518,1,3,3,6
2022-12-13 20:30:26,1.0163310185185186,1,5,5,10
2022-12-13 20:41:52,0.006851851851851852,1,5,5,10
2022-12-13 20:29:33,1.0195601851851852,1,5,5,10
2022-12-13 19:03:17,1.6054050925925927,1,9,9,18
2022-12-15 15:18:39,4.043113425925926,1,2,2,4
2023-02-16 06:30:57,66.93337962962963,1,6,1,7
2022-12-15 16:43:26,4.585092592592592,8,8,8,16
2022-12-11 06:27:44,0.6587615740740741,2,6,0,6
2022-12-16 03:46:39,0.46903935185185186,250,22932,12773,35705
2022-12-13 19:03:10,4.626226851851852,1,9,0,9
2022-12-14 18:50:07,6.35162037037037,12,157,2313,2470
2022-12-09 15:37:38,1.4575462962962964,1,2,2,4
2022-12-15 15:18:59,7.643784722222223,6,28,24,52
2022-12-15 16:45:02,7.892523148148148,2,98,10,108
2023-01-13 09:46:53,36.678148148148146,4,51,9,60
2022-12-07 15:39:59,0.05471064814814815,1,1,1,2
2022-12-15 16:47:43,8.123483796296297,1,2,0,2
2022-12-07 13:12:56,0.032511574074074075,1,16,14,30
2022-12-07 13:13:11,0.05842592592592592,1,1,1,2
2022-12-15 14:52:07,8.328472222222222,1,1,1,2
2022-12-06 22:38:03,0.5040509259259259,3,182,16,198
2022-12-06 23:25:18,0.6482175925925926,2,103,0,103
2022-12-09 15:57:51,0.013298611111111112,1,5,4,9
2022-12-09 15:58:15,0.012673611111111111,1,5,5,10
2022-12-06 23:13:15,1.2113773148148148,1,44,27,71
2023-01-18 15:50:51,44.09471064814815,6,95,58,153
2022-12-06 23:25:41,1.5152662037037037,1,28,3,31
2023-06-05 07:37:03,182.42623842592593,46,198776,100477,299253
2022-12-06 23:15:24,3.582337962962963,3,149,20,169
2022-12-06 23:00:56,2.5823263888888888,1,1,0,1
2022-12-09 05:37:13,5.129965277777778,1,17,0,17
2022-12-11 06:37:01,7.176828703703704,2,2,2,4
2022-12-06 22:54:02,3.131828703703704,1,2,0,2
2022-12-04 01:56:21,0.2587962962962963,1,1,1,2
2022-12-06 23:10:53,3.4111805555555557,1,27,7,34
2023-01-29 23:39:31,57.65291666666667,1,41,68,109
2023-02-20 06:37:28,8.40431712962963,1,109,24,133
2023-03-03 20:13:56,91.14717592592592,1,58,7,65
2023-03-03 20:08:22,91.17304398148148,1,10,0,10
2022-12-02 15:57:37,0.004375,1,5,5,10
2022-12-09 15:12:57,7.010439814814815,177,6088,6974,13062
2022-12-02 14:39:41,0.013773148148148149,1,6,3,9
2022-12-02 14:40:16,0.014733796296296297,1,1,1,2
2022-12-02 14:40:34,0.015439814814814814,1,1,1,2
2022-12-02 14:45:59,0.009467592592592593,1,1,1,2
2022-12-02 14:34:04,0.012916666666666667,1,5,5,10
2022-12-02 14:35:08,0.021550925925925925,1,3,3,6
2023-01-18 16:47:50,48.08461805555555,2,39,3,42
2022-12-06 23:31:00,5.379143518518519,1,2,2,4
2022-12-15 16:04:38,14.079988425925926,1,3,2,5
2022-12-01 09:32:10,0.42506944444444444,1,8,3,11
2023-01-18 15:23:40,48.915474537037035,1,1,1,2
2023-01-05 13:03:47,35.840266203703706,2,38,17,55
2022-12-15 14:51:13,14.924988425925926,1,63,0,63
2022-12-15 17:13:14,15.272094907407407,2,6,6,12
2022-12-15 15:35:26,15.412789351851853,7,8222,6400,14622
2023-11-07 21:51:40,342.6122453703704,2,7,7,14
2022-11-30 08:56:28,0.18090277777777777,1,3,1,4
2022-12-15 17:08:41,16.371979166666666,1,7,5,12
2022-12-01 09:49:25,2.2444560185185187,1,2,2,4
2022-12-03 03:05:35,3.9703703703703703,3,16,19,35
2023-05-19 15:13:30,171.4907638888889,1,11,11,22
2022-12-15 15:37:17,16.560960648148146,1,1,1,2
2022-12-02 14:31:29,0.014456018518518519,1,3,3,6
2022-12-02 14:13:27,3.7536111111111112,1,6,6,12
2022-12-02 14:34:31,3.769351851851852,1,6,6,12
2022-12-02 14:12:14,3.7542708333333334,1,2,2,4
2022-12-02 14:33:40,0.0125,1,6,6,12
2022-12-02 14:11:42,3.7555324074074075,1,6,6,12
2022-12-02 14:31:07,0.01125,1,11,11,22
2022-12-02 15:27:57,0.031145833333333334,1,1,1,2
2022-12-02 14:13:44,0.005335648148148148,1,36,36,72
2022-12-02 14:11:08,3.75662037037037,1,3,3,6
2022-12-02 14:10:40,3.7565856481481483,1,2,2,4
2022-12-09 05:36:29,10.56394675925926,2,5892,5429,11321
2022-11-28 15:42:05,0.01835648148148148,1,4,0,4
2022-12-15 17:09:49,17.122881944444444,1,26,18,44
2022-12-06 23:39:36,8.427337962962962,1,1,0,1
2022-12-06 23:40:18,8.569641203703704,1,6,0,6
2023-01-18 15:44:34,51.634375,12,299,70,369
2022-12-06 23:40:38,9.020208333333333,2,3,2,5
2022-11-27 22:49:32,0.0052893518518518515,1,13,4,17
2022-11-27 19:36:22,0.4235300925925926,1,4,0,4
2022-11-26 22:08:25,0.009988425925925927,1,1,0,1
2022-12-15 15:37:07,18.824618055555554,1,1,1,2
2022-11-27 19:37:37,1.3978819444444444,2,4,0,4
2022-12-15 16:04:53,19.90196759259259,1,1,1,2
2023-01-18 15:47:56,54.05340277777778,5,109,15,124
2022-12-15 16:24:38,20.227280092592594,1,2,2,4
2022-12-02 14:03:06,5.21125,250,7458,5093,12551
2022-11-27 19:39:05,3.1745833333333335,2,10,4,14
2022-11-27 19:42:17,4.08869212962963,1,11,0,11
2022-11-27 19:41:18,4.143113425925926,5,26,32,58
2022-12-13 18:43:04,20.198032407407407,6,35584,13500,49084
2022-11-27 19:41:40,4.283171296296296,1,3,30,33
2022-12-15 14:47:24,22.16486111111111,1,3,0,3
2023-01-18 15:20:53,56.207118055555554,3,88,37,125
2022-11-27 19:43:25,4.42005787037037,1,1,1,2
2023-10-23 12:28:32,334.13105324074075,1,24,4,28
2022-12-07 01:35:40,13.7303125,2,45,2,47
2022-12-15 16:05:40,19.99912037037037,1,1,1,2
2023-03-03 20:01:18,100.93975694444444,3,35573,15940,51513
2022-11-27 19:45:29,5.00412037037037,1,1,0,1
2022-11-27 19:46:24,5.097662037037037,1,4,4,8
2022-12-15 17:37:48,22.92476851851852,2,24935,12250,37185
2022-12-15 14:43:06,23.018171296296295,13,222,40,262
2022-11-26 04:34:19,0.005150462962962963,1,3,3,6
2022-11-22 14:09:43,0.7511226851851852,1,1,1,2
2022-11-22 14:10:01,0.7525578703703704,1,57,45,102
2022-11-22 14:10:45,0.7531365740740741,1,1,1,2
2022-11-22 14:11:01,0.7546527777777777,1,25,25,50
2022-12-02 15:38:57,10.816192129629629,1,5,5,10
2022-11-22 14:08:20,0.7537037037037037,1,3,3,6
2022-11-26 04:25:53,4.349398148148148,1,4,4,8
2022-11-22 14:11:25,0.7564236111111111,1,5,5,10
2022-12-15 17:42:08,23.909675925925924,1,1,1,2
2022-12-15 14:47:06,23.94412037037037,6,31766,11738,43504
2022-11-27 19:47:29,6.1490625,1,4,4,8
2022-12-15 14:43:16,23.97837962962963,1,6,5,11
2022-12-15 17:41:40,24.112002314814816,1,17,1,18
2022-11-27 19:48:12,6.286099537037037,1,10,1,11
2022-11-21 09:35:10,0.00869212962962963,1,5,1,6
2022-12-15 16:30:47,24.335046296296298,1,2,2,4
2022-12-15 15:20:21,24.501909722222223,3,17720,17722,35442
2022-12-15 17:42:48,24.809791666666666,2,3,1,4
2022-12-15 15:18:20,25.25542824074074,1,1,1,2
2022-11-25 15:20:48,5.539837962962963,1,1,0,1
2022-12-15 15:20:34,25.787025462962962,2,2,1,3
2023-05-02 10:08:49,164.77408564814814,8,2058,112,2170
2023-01-06 06:55:58,48.42105324074074,1,4,3,7
2022-12-15 14:57:26,26.752025462962962,1,2,2,4
2022-11-22 04:52:18,3.4799652777777776,1,1,0,1
2022-12-15 15:40:58,27.067488425925927,1,1,0,1
2022-12-15 14:56:49,27.060902777777777,1,1,0,1
2022-11-20 18:28:13,2.311736111111111,2,12,3,15
2022-12-15 14:57:03,27.222662037037036,5,23521,11608,35129
2022-12-15 14:57:17,27.229664351851852,4,9,5,14
2022-12-15 15:20:47,27.517766203703705,2,58,38,96
2022-12-15 15:20:55,27.51940972222222,1,1,1,2
2022-12-15 15:21:14,27.568159722222223,2,16,6,22
2022-11-17 21:59:08,0.10793981481481481,1,4,0,4
2022-12-15 15:40:32,27.856909722222223,1,20,0,20
2022-11-17 20:31:52,0.08550925925925926,1,4,0,4
2023-04-20 14:43:56,154.01221064814814,3,50,38,88
2022-11-17 15:25:07,0.045821759259259257,1,0,1,1
2022-12-15 15:44:29,28.071712962962962,1,5,0,5
2022-12-15 15:40:46,28.099710648148147,1,1,1,2
2022-11-25 00:40:06,2.66181712962963,250,22176,6108,28284
2022-11-17 11:56:15,0.06362268518518518,1,76,102,178
2022-12-15 17:46:14,28.138078703703705,1,9,9,18
2022-11-17 09:50:21,0.27166666666666667,1,10,0,10
2022-11-17 07:54:44,0.5772106481481482,2,15,5,20
2022-11-17 09:52:30,0.5070254629629629,3,3,2,5
2022-11-17 09:52:52,0.5637615740740741,1,4,0,4
2022-11-17 09:53:04,0.7684953703703704,1,1,1,2
2023-01-18 15:33:56,63.07408564814815,3,83,11,94
2022-11-17 09:53:38,1.0179398148148149,1,2,2,4
2022-11-17 09:54:11,1.0318287037037037,2,3,3,6
2022-11-17 09:55:59,1.0402777777777779,1,1,1,2
2022-11-17 09:54:33,1.0818171296296297,1,1,1,2
2022-11-17 09:55:51,1.1464699074074074,1,4,0,4
2022-11-16 03:03:59,0.19940972222222222,1,3,12,15
2022-12-15 16:10:35,29.839918981481482,1,2,2,4
2023-01-18 15:43:58,63.89961805555556,2,14,3,17
2022-12-15 17:50:11,30.185219907407408,2,127,4,131
2022-11-17 09:55:04,1.8045717592592592,1,1,0,1
2022-11-17 09:55:23,1.8713425925925926,1,10,2,12
2022-11-17 09:58:33,1.9067013888888888,1,2,0,2
2022-11-17 12:59:15,0.6259027777777778,250,10105,5750,15855
2022-11-17 10:24:59,2.0761805555555557,2,21,7,28
2022-11-17 09:59:35,2.237222222222222,1,22,2,24
2022-11-24 20:30:29,9.83116898148148,12,373,301,674
2022-11-15 02:39:07,0.0033449074074074076,1,1,1,2
2022-11-15 02:57:18,0.045405092592592594,1,8,1,9
2022-11-15 01:58:00,0.0012268518518518518,1,1,1,2
2022-11-15 01:09:58,0.008402777777777778,1,1,1,2
2022-11-16 10:59:28,1.5614583333333334,2,2,2,4
2022-11-14 21:21:15,0.0027546296296296294,1,6,1,7
2022-11-17 10:01:16,2.544259259259259,3,9,7,16
2022-12-02 16:04:31,0.06153935185185185,3,390,385,775
2022-12-02 14:33:17,0.013229166666666667,1,5,5,10
2022-11-15 11:38:23,0.008171296296296296,1,5,5,10
2022-12-02 15:49:52,0.006446759259259259,1,6,6,12
2022-11-26 05:07:53,10.737164351851852,1,5,5,10
2022-11-15 11:48:01,0.015023148148148148,1,8,17,25
2022-11-14 21:14:55,0.054594907407407404,2,32,25,57
2022-11-14 19:26:32,19.269212962962964,1,117,24,141
2022-11-14 16:52:32,0.014988425925925926,1,1,1,2
2022-11-14 19:26:21,5.253055555555555,1,30,38,68
2022-11-14 19:26:03,5.256956018518519,1,46,34,80
2022-11-17 10:01:51,3.0819444444444444,3,15,15,30
2022-11-14 19:27:12,0.47130787037037036,1,6,2,8
2022-11-14 07:50:15,0.0007175925925925926,1,10,4,14
2022-11-14 07:33:49,0.004780092592592593,1,1,1,2
2022-11-14 07:33:24,0.021377314814814814,1,740,325,1065
2022-11-14 07:06:18,0.02287037037037037,1,0,3,3
2022-11-14 07:06:06,0.03784722222222222,1,31,28,59
2022-11-14 05:56:16,0.004907407407407407,1,1,1,2
2022-11-14 06:13:14,0.031967592592592596,1,1,0,1
2022-11-14 05:28:20,0.018738425925925926,1,1,1,2
2022-11-14 07:34:08,0.11001157407407407,2,15,15,30
2022-11-14 05:05:10,0.013217592592592593,1,12,2,14
2022-11-14 04:26:49,0.11005787037037038,1,2,0,2
2022-11-16 03:56:31,6.566504629629629,1,4,4,8
2022-11-15 02:22:38,121.10895833333333,3,45731,32092,77823
2022-11-13 23:38:56,0.07145833333333333,1,1,1,2
2022-11-13 23:43:24,0.0755787037037037,1,17,12,29
2022-11-17 10:05:09,185.10842592592593,9,628,93,721
2022-11-14 04:52:14,0.35502314814814817,2,26,1,27
2022-12-02 14:08:05,18.74789351851852,1,11,5,16
2022-12-15 17:49:43,32.00195601851852,3,35546,13219,48765
2022-11-15 05:37:37,1.5388657407407407,132,7051,4681,11732
2022-11-13 19:58:55,0.13662037037037036,1,2,2,4
2022-12-15 15:40:00,29.998391203703704,5,210,28,238
2022-11-13 19:58:40,0.2640046296296296,1,34,1,35
2022-11-13 19:59:49,0.27439814814814817,2,6,6,12
2022-11-13 20:00:38,0.5406018518518518,1,1,1,2
2022-11-13 20:10:20,0.5740856481481481,5,81,123,204
2022-11-17 10:05:39,4.597673611111111,2,70,66,136
2022-11-13 05:57:11,0.5227662037037037,1,6,0,6
2022-11-13 02:33:31,0.4532060185185185,1,1,1,2
2022-11-13 02:33:21,0.467662037037037,1,6,6,12
2022-11-13 20:01:39,1.2191550925925927,1,22,6,28
2022-11-12 09:54:52,0.011527777777777777,1,1,1,2
2022-11-13 16:14:31,1.3643865740740742,199,5112,5072,10184
2022-12-15 17:53:37,33.72255787037037,1,2,0,2
2022-11-13 20:02:09,1.8642708333333333,3,2358,1096,3454
2022-11-13 20:05:30,1.8964930555555555,2,12,4,16
2022-11-13 20:02:28,1.9718981481481481,1,3,0,3
2022-11-12 04:11:08,0.3572800925925926,1,0,0,0
2022-11-11 20:22:29,0.12166666666666667,1,1,0,1
2022-11-11 20:31:03,0.25342592592592594,2,2,2,4
2022-11-11 20:23:04,0.3235763888888889,1,1,1,2
2022-11-11 20:22:17,0.381712962962963,1,5,7,12
2022-11-11 20:19:48,0.43627314814814816,3,4,4,8
2022-11-13 21:22:08,2.5685416666666665,4,225,49,274
2022-11-11 08:20:24,0.007094907407407407,1,1,1,2
2022-11-11 07:26:58,0.04224537037037037,1,46,36,82
2022-11-11 08:20:11,0.11828703703703704,1,8,8,16
2022-11-11 06:45:16,0.058472222222222224,1,1,1,2
2022-11-11 04:26:44,0.10561342592592593,1,1,1,2
2022-11-11 01:55:21,0.02829861111111111,1,8,1,9
2022-11-11 07:39:38,0.3026273148148148,1,67,22,89
2022-11-11 00:33:32,0.007025462962962963,1,2,2,4
2022-11-11 00:34:00,0.013275462962962963,1,12,15,27
2022-11-11 01:54:03,0.11431712962962963,1,2,0,2
2022-11-13 20:06:03,2.8950925925925928,1,4,2,6
2022-11-10 21:30:00,0.051076388888888886,2,9,102,111
2022-11-10 20:06:09,0.017627314814814814,1,17,2,19
2022-11-10 19:25:24,0.02148148148148148,2,24,3,27
2022-11-10 19:26:04,0.0959837962962963,1,8,8,16
2022-11-10 18:36:12,0.16747685185185185,1,1,1,2
2022-11-10 19:25:13,0.21590277777777778,1,2,0,2
2022-11-10 13:21:32,0.020370370370370372,1,2,9,11
2022-11-10 20:06:21,0.3445023148148148,1,51,5,56
2022-11-10 07:50:45,0.01460648148148148,1,0,62,62
2022-11-10 20:09:03,0.5350347222222223,1,1,1,2
2022-11-10 07:49:59,0.024421296296296295,1,4,3,7
2022-11-10 07:49:48,0.042708333333333334,1,2,2,4
2022-11-10 07:49:36,0.06694444444444445,1,111,40,151
2022-11-10 06:32:37,0.02560185185185185,1,1,1,2
2022-11-10 05:27:46,0.028333333333333332,1,23,1,24
2022-11-10 04:34:42,0.014201388888888888,1,2,11,13
2022-11-10 03:02:05,0.017326388888888888,1,1,1,2
2022-11-10 23:06:19,0.9691203703703704,1,1,1,2
2022-11-10 20:11:38,0.8521527777777778,1,1,0,1
2022-11-10 01:31:09,0.18393518518518517,1,1,0,1
2022-11-10 13:21:52,0.7592245370370371,1,5,3,8
2022-11-09 19:10:38,0.10059027777777778,1,1,1,2
2022-11-12 06:56:25,0.9444444444444444,250,18491,3640,22131
2022-11-09 13:08:20,0.20699074074074075,1,43,8,51
2022-11-09 07:24:21,0.036041666666666666,1,211,48,259
2022-11-10 04:49:30,0.9245138888888889,1,21,12,33
2022-11-11 20:24:10,2.568738425925926,1,1,1,2
2022-11-09 14:22:59,0.36930555555555555,1,4,0,4
2022-11-09 03:12:58,0.05925925925925926,1,1,1,2
2022-11-10 18:10:38,1.7625925925925925,1,19,8,27
2022-11-09 14:23:53,0.7214583333333333,6,11,3,14
2022-12-15 15:39:41,37.416435185185186,4,51,18,69
2022-11-10 18:10:50,1.9799189814814815,1,1,1,2
2022-11-10 18:10:09,1.983310185185185,3,44,3,47
2022-11-09 00:30:34,0.27002314814814815,1,1,1,2
2022-11-08 16:28:03,0.046481481481481485,3,3,3,6
2022-11-08 15:37:29,0.11820601851851852,1,4,0,4
2022-11-08 15:37:41,0.13605324074074074,1,8,0,8
2022-11-08 15:39:15,0.16333333333333333,4,7,7,14
2022-11-08 16:26:12,0.21940972222222221,1,1,1,2
2022-11-08 15:36:26,0.2260648148148148,1,2,1,3
2022-11-08 15:35:43,0.25524305555555554,1,2,2,4
2022-11-08 16:15:55,0.4141666666666667,2,6,2,8
2022-12-15 16:11:59,37.45886574074074,2,40638,15493,56131
2022-11-15 11:21:35,7.441331018518518,1,9,4,13
2022-11-08 02:53:06,0.22027777777777777,1,10,10,20
2022-11-15 11:26:51,7.630532407407407,1,10,10,20
2022-11-26 04:43:00,0.004212962962962963,1,16,16,32
2022-11-15 11:23:01,7.628877314814815,1,5,5,10
2022-11-26 04:52:40,18.357939814814817,1,5,5,10
2022-11-15 11:21:04,7.627685185185185,1,1,1,2
2022-11-15 11:20:43,1.5754398148148148,1,1,1,2
2022-11-15 11:19:34,7.627268518518519,1,1,1,2
2022-11-15 11:19:10,7.627233796296296,1,5,5,10
2022-11-26 04:35:27,18.347118055555555,1,61,56,117
2022-11-15 11:18:49,7.6275462962962965,1,52,52,104
2022-11-15 14:42:21,7.769930555555556,1,52,52,104
2022-11-15 14:42:59,7.770416666666667,1,1,1,2
2022-12-02 14:07:28,24.746770833333333,1,12,12,24
2022-11-15 02:19:57,7.256064814814815,1,1,1,2
2022-12-02 16:06:42,6.467523148148148,1,3,3,6
2022-11-26 04:50:07,18.360810185185183,1,6,6,12
2022-11-26 04:49:48,0.0038541666666666668,1,84,116,200
2022-11-26 04:51:54,18.36315972222222,1,4,4,8
2022-11-15 14:52:44,0.0060879629629629626,1,2,2,4
2022-11-08 03:06:54,0.43747685185185187,1,1,0,1
2022-11-07 21:35:53,0.3705439814814815,3,125,15,140
2022-11-09 15:43:48,2.0212268518518517,250,20685,8363,29048
2022-11-07 14:38:56,0.08099537037037037,1,18,1,19
2022-11-08 02:52:52,0.6708564814814815,1,10,1,11
2022-11-07 14:42:58,0.17704861111111111,1,9,9,18
2022-11-08 16:29:15,1.2675810185185186,1,1,0,1
2022-11-07 14:48:47,0.2238425925925926,1,1,1,2
2022-11-07 18:47:48,0.45185185185185184,1,26,2,28
2022-11-07 14:43:24,0.2884259259259259,1,2,1,3
2022-11-07 21:37:37,0.6342013888888889,4,8,7,15
2022-11-08 03:00:28,0.9098379629629629,1,8,2,10
2022-11-07 02:57:17,0.01326388888888889,1,1,1,2
2022-12-15 15:38:51,38.6430787037037,2,37633,13960,51593
2022-11-10 22:24:39,4.008946759259259,3,6272,3371,9643
2022-11-08 16:31:32,1.809236111111111,1,6,11,17
2022-11-08 02:50:47,1.2507291666666667,1,6,1,7
2022-11-07 15:17:56,0.7898032407407407,1,1,1,2
2022-11-07 02:16:44,0.2960185185185185,1,1,1,2
2022-11-07 02:40:04,0.3425810185185185,2,4,4,8
2022-11-07 02:40:54,0.3692361111111111,1,4,0,4
2022-11-07 02:39:49,0.3767824074074074,1,1,1,2
2022-11-07 02:31:38,0.3804050925925926,1,1,1,2
2022-12-15 17:55:55,39.08296296296297,1,2,2,4
2022-11-07 02:38:54,0.41052083333333333,1,1,1,2
2022-11-06 15:13:53,0.011828703703703704,1,5,6,11
2022-11-07 02:40:17,0.6173263888888889,1,3,2,5
2022-11-08 16:32:04,2.2128935185185186,1,3,3,6
2022-11-08 16:31:53,2.3013541666666666,1,2,2,4
2022-12-15 17:55:29,39.71561342592592,1,0,22,22
2022-11-07 14:41:42,2.2140393518518517,2,20,9,29
2022-11-07 02:16:10,0.7860648148148148,1,1,1,2
2022-11-06 05:59:57,0.001574074074074074,1,1,1,2
2022-11-06 05:16:35,0.05230324074074074,1,1,1,2
2022-11-10 18:16:49,4.6401157407407405,1,6,1,7
2022-11-24 20:32:03,18.742824074074075,2,2,2,4
2022-11-10 18:11:25,5.2977893518518515,4,6951,4080,11031
2022-11-05 22:24:07,0.0008912037037037037,1,33,5,38
2022-11-05 22:00:48,0.0071643518518518514,1,1,0,1
2022-11-05 21:57:59,0.006921296296296296,1,2,2,4
2022-11-05 21:31:52,0.020092592592592592,1,2,0,2
2022-11-05 21:56:03,0.04057870370370371,1,1,1,2
2022-11-05 22:06:32,0.05334490740740741,1,55,118,173
2022-11-05 20:03:59,0.010069444444444445,1,0,1,1
2022-11-05 20:18:58,0.02309027777777778,1,1,1,2
2022-11-05 20:51:01,0.05292824074074074,1,7,3,10
2022-11-05 20:19:26,0.07074074074074074,1,14,0,14
2022-11-05 20:11:24,0.08623842592592593,1,27,46,73
2022-11-05 20:11:36,0.10608796296296297,1,1,1,2
2022-11-05 16:27:45,0.0490625,1,2,7,9
2022-11-05 16:29:20,0.06552083333333333,1,12,0,12
2022-11-05 17:28:14,0.16723379629629628,1,127,3,130
2022-11-05 12:45:06,0.04809027777777778,1,1,1,2
2022-11-07 15:06:49,1.6722222222222223,250,21440,4642,26082
2022-11-05 12:43:48,0.12394675925925926,1,1,1,2
2022-11-05 12:43:37,0.23320601851851852,4,41,24,65
2022-11-04 23:09:52,0.09163194444444445,1,3,3,6
2022-11-04 19:01:33,0.013425925925925926,4,28,11,39
2022-11-04 18:33:16,0.009050925925925926,1,101,32,133
2022-11-04 16:08:08,0.05883101851851852,1,11,3,14
2022-11-04 15:08:42,0.04491898148148148,1,121,9,130
2022-11-04 15:08:30,0.05181712962962963,1,18,17,35
2022-11-04 15:31:44,0.07123842592592593,1,12,6,18
2022-11-08 16:20:09,4.128634259259259,1,3,3,6
2023-05-02 12:40:37,179.06469907407407,1,127,19,146
2022-11-04 12:19:13,0.09412037037037037,1,74,36,110
2022-11-04 12:19:57,0.13436342592592593,1,1,0,1
2023-03-22 10:22:35,138.06381944444445,2,47096,18480,65576
2022-11-04 15:04:25,0.3582060185185185,1,1,0,1
2022-11-05 22:02:41,1.8644907407407407,2,3,3,6
2022-11-04 01:32:26,0.08266203703703703,1,40,2,42
2022-11-04 01:28:26,0.0949537037037037,1,6,1,7
2022-11-04 01:28:38,0.09859953703703704,1,3,2,5
2022-11-04 01:28:01,0.13800925925925925,1,22,7,29
2022-11-04 01:28:14,0.15609953703703705,1,41,37,78
2022-11-08 16:21:06,4.818564814814815,1,18,10,28
2022-11-08 16:19:14,4.878877314814815,1,4,4,8
2022-11-03 23:14:39,0.40275462962962966,2,69,18,87
2022-11-03 15:05:39,0.20578703703703705,2,14,4,18
2022-11-08 16:18:58,5.88542824074074,4,20,20,40
2022-11-02 17:50:21,0.023275462962962963,1,4,1,5
2022-11-02 17:09:39,0.02273148148148148,1,5,1,6
2022-11-02 15:34:48,0.060578703703703704,1,4,3,7
2022-11-02 15:35:22,0.09884259259259259,2,4,1,5
2022-11-02 15:38:24,0.10604166666666667,1,5,0,5
2022-11-03 23:13:08,1.8115393518518519,1,0,1,1
2022-11-08 16:20:35,21.817546296296296,1,2,2,4
2022-11-03 22:12:09,2.017314814814815,1,0,1,1
2022-11-03 15:06:43,1.7589814814814815,3,221,15,236
2022-11-01 21:08:42,0.02564814814814815,1,2,2,4
2022-11-04 12:21:06,2.8317939814814816,1,129,7,136
2022-11-01 15:03:51,0.005069444444444444,1,1,1,2
2022-11-01 14:06:53,0.12961805555555556,1,0,0,0
2022-11-01 11:59:24,0.05018518518518519,1,2,0,2
2022-11-05 10:54:26,1.3877199074074074,250,21519,15848,37367
2022-11-01 12:05:39,0.14504629629629628,1,36,40,76
2022-11-01 12:01:39,0.415625,1,4,4,8
2022-11-01 15:26:25,0.5781481481481482,1,15,2,17
2022-11-01 14:27:59,0.5627199074074074,1,3,3,6
2022-11-26 05:07:13,25.376041666666666,1,6,11,17
2022-11-15 11:49:22,14.655914351851852,1,5,5,10
2022-11-15 11:49:01,14.655960648148149,1,5,5,10
2022-11-15 11:49:50,14.658969907407407,1,1,1,2
2022-10-31 15:31:45,0.00986111111111111,1,1,1,2
2022-12-15 15:38:38,45.07394675925926,2,50755,19752,70507
2022-10-30 20:29:23,0.013206018518518518,1,0,2,2
2022-10-31 12:06:17,0.6697453703703704,1,84,72,156
2022-10-30 18:04:39,0.014826388888888889,1,3,1,4
2022-10-30 00:43:27,0.02515046296296296,1,1,0,1
2022-10-29 23:30:17,0.07050925925925926,1,9,9,18
2022-10-30 00:43:21,0.17717592592592593,1,8,0,8
2022-10-30 00:43:15,0.2197800925925926,1,77,42,119
2022-10-29 18:05:53,0.06260416666666667,1,34,13,47
2022-10-29 12:04:24,0.005856481481481482,1,1,1,2
2022-10-29 11:34:56,0.16188657407407409,1,1,1,2
2022-11-01 09:42:04,3.1180439814814815,250,23482,5327,28809
2022-10-29 11:32:49,0.3993287037037037,1,7,3,10
2022-10-28 21:30:44,0.15876157407407407,1,6,0,6
2022-10-28 17:34:22,0.016655092592592593,1,3,3,6
2022-10-28 14:40:48,0.00912037037037037,1,5,5,10
2022-10-28 14:29:00,0.008206018518518519,1,5,0,5
2022-10-28 14:21:59,0.011689814814814814,1,3,3,6
2022-10-28 10:46:42,0.013032407407407407,1,2,1,3
2022-10-27 22:48:30,0.040289351851851854,1,4,4,8
2022-10-27 17:30:08,0.010439814814814815,1,0,4,4
2022-10-27 22:48:45,0.23353009259259258,1,102,78,180
2022-10-27 17:17:48,0.09805555555555556,1,13,1,14
2022-10-27 17:17:15,0.10678240740740741,1,1,0,1
2022-10-28 10:56:51,0.8407407407407408,1,1,3,4
2022-10-27 00:10:38,0.005787037037037037,1,1,1,2
2022-10-27 12:30:53,0.680324074074074,1,4,0,4
2022-10-30 00:43:57,3.196550925925926,1,7,21,28
2022-10-26 20:14:07,0.023171296296296297,1,8,0,8
2022-10-27 12:31:11,0.6911805555555556,1,5,1,6
2022-10-30 00:44:33,3.2061458333333333,3,35,20,55
2022-10-27 00:10:54,0.19119212962962964,2,5,0,5
2022-11-14 07:07:15,18.49079861111111,1,30,16,46
2022-10-27 22:26:02,1.2096875,1,131,5,136
2022-10-26 18:40:56,0.05652777777777778,1,3,3,6
2022-10-26 16:21:36,0.007268518518518519,1,1,1,2
2022-10-26 14:56:38,0.02269675925925926,1,3,3,6
2022-10-26 11:52:01,0.010590277777777778,1,344,370,714
2022-10-26 12:01:02,0.021666666666666667,1,26,26,52
2022-10-26 11:00:43,0.4568171296296296,1,5,5,10
2022-10-26 07:10:19,0.3096527777777778,1,12,9,21
2022-10-26 11:42:30,13.092071759259259,2,243,66,309
2022-10-26 10:10:48,0.603125,1,3,15,18
2022-10-25 19:43:34,0.01425925925925926,1,3,2,5
2022-10-25 19:43:45,0.036550925925925924,1,21,2,23
2022-10-25 16:47:04,0.02409722222222222,1,0,3,3
2022-10-25 16:47:22,0.11010416666666667,1,67,34,101
2022-10-26 11:13:37,1.6284375,1,10,10,20
2022-10-26 11:15:38,1.6299884259259259,1,5,5,10
2022-10-26 12:08:17,0.008206018518518519,1,5,5,10
2022-10-26 11:11:56,1.6278703703703703,1,49,42,91
2022-10-26 11:14:34,1.6299305555555557,1,5,5,10
2022-10-26 11:12:39,1.6294097222222221,1,5,5,10
2022-10-26 12:07:48,0.008101851851851851,1,5,5,10
2022-10-26 11:16:27,1.6327314814814815,1,82,24,106
2022-10-26 11:13:05,1.630625,1,5,5,10
2022-10-26 11:11:05,1.6297337962962963,1,5,5,10
2022-10-29 13:06:23,1.7430787037037037,6,88,42,130
2022-10-26 17:35:56,2.117939814814815,1,155,11,166
2022-10-24 15:37:47,0.13723379629629628,1,2,2,4
2022-10-24 16:30:59,0.20215277777777776,2,13,2,15
2022-10-24 16:37:58,0.22905092592592594,1,5,5,10
2022-10-23 21:38:20,0.09479166666666666,1,1,5,6
2022-10-23 21:37:58,0.1021875,1,26,22,48
2022-10-23 21:38:08,0.10733796296296297,1,8,4,12
2022-10-29 05:35:50,2.7229282407407407,250,24584,7243,31827
2022-10-25 17:02:21,2.141608796296296,1,193,355,548
2022-10-23 13:58:24,0.11362268518518519,1,25,68,93
2022-10-23 12:05:18,0.05449074074074074,1,6,15,21
2022-10-22 21:14:58,0.023738425925925927,1,10,9,19
2022-10-22 21:15:15,0.1482638888888889,1,1,4,5
2022-10-25 17:03:16,3.0458101851851853,2,19,4,23
2022-10-22 16:09:51,0.012199074074074074,1,4,2,6
2022-10-22 16:30:21,0.075625,1,1,1,2
2022-10-22 21:18:33,0.27775462962962966,4,222,34,256
2023-01-14 13:00:24,84.03471064814815,3,12,6,18
2022-10-22 16:30:56,2.2325925925925927,5,189,85,274
2022-10-22 09:49:41,1.9594097222222222,1,47,2,49
2022-10-22 09:44:42,8.801400462962963,1,528,296,824
2022-10-23 15:46:36,2.159479166666667,250,19823,11038,30861
2022-10-21 11:22:03,0.017800925925925925,1,1,1,2
2022-10-22 12:30:59,1.155300925925926,3,26,4,30
2022-10-21 09:48:23,0.0675462962962963,1,2,3,5
2022-10-21 08:05:51,0.7754050925925926,1,1,1,2
2022-10-21 08:06:04,0.7836226851851852,1,6,3,9
2022-10-20 12:47:42,0.0015509259259259259,1,1,0,1
2022-10-26 11:16:50,6.346539351851852,1,64,40,104
2022-10-18 19:21:21,0.050069444444444444,1,1,1,2
2022-10-18 17:33:11,0.018449074074074073,1,1,1,2
2022-10-18 17:01:59,0.0008564814814814815,1,1,1,2
2022-10-18 16:57:01,0.0011342592592592593,1,2,1,3
2022-10-19 09:31:00,0.9389930555555556,1,162,102,264
2022-10-20 07:15:52,5.729768518518519,11,212,69,281
2022-10-20 00:49:52,2.1960532407407407,1,20,6,26
2022-10-21 11:48:30,3.653587962962963,1,61,16,77
2022-10-21 00:17:03,0.888275462962963,1,5,5,10
2022-10-20 00:47:50,2.195752314814815,1,7,7,14
2022-10-21 00:16:34,3.174189814814815,1,5,5,10
2022-10-21 11:09:17,0.031087962962962963,1,5,5,10
2022-10-20 02:54:45,0.06881944444444445,1,5,5,10
2022-10-20 00:47:06,2.1970833333333335,1,5,5,10
2022-10-21 10:17:18,3.5946875,1,1,1,2
2022-10-17 06:32:49,0.013078703703703703,1,14,0,14
2022-10-18 22:12:56,2.05255787037037,2,19,8,27
2022-10-16 06:44:00,0.2082175925925926,2,195,21,216
2022-10-14 22:20:54,0.22810185185185186,1,11,5,16
2022-10-14 14:14:22,0.012673611111111111,1,7,3,10
2022-10-14 01:16:38,0.04150462962962963,1,92,37,129
2022-10-21 12:07:02,7.881226851851852,1,6,4,10
2022-10-21 11:47:57,6.411979166666667,250,18627,7255,25882
2022-10-13 23:44:23,0.3763773148148148,1,1,1,2
2022-10-13 09:29:19,0.6203356481481481,1,50,24,74
2022-10-13 12:42:38,4.067083333333334,1,900,1574,2474
2022-10-13 14:14:12,0.17109953703703704,250,21751,8992,30743
2022-10-11 10:45:39,0.6105092592592593,1,5,5,10
2022-10-11 10:46:28,0.6113541666666666,1,5,5,10
2022-10-11 21:30:39,1.059224537037037,1,16,10,26
2022-10-11 10:46:58,0.6126041666666666,1,16,16,32
2022-10-11 10:46:04,0.6125,1,40,40,80
2022-10-10 19:41:25,0.44275462962962964,1,26,11,37
2022-10-10 06:03:19,0.01525462962962963,1,1,1,2
2022-10-10 04:51:17,0.008159722222222223,1,2,2,4
2022-10-12 19:07:30,2.9422106481481483,1,77,20,97
2022-10-09 22:32:41,0.16108796296296296,1,3,2,5
2022-10-11 03:59:30,1.0079398148148149,250,20377,6266,26643
2022-10-09 17:26:15,0.030925925925925926,1,1,1,2
2022-10-09 22:33:39,0.4488888888888889,1,3,3,6
2022-10-26 10:10:02,16.950381944444445,1,71,9,80
2022-10-09 10:28:59,0.06791666666666667,1,2,2,4
2022-10-09 13:55:33,0.415625,2,109,42,151
2022-10-09 01:55:09,0.012951388888888889,1,118,103,221
2022-10-09 01:49:52,0.3116550925925926,2,112,52,164
2022-10-20 12:35:29,12.157094907407407,10,406,2481,2887
2022-10-08 06:34:00,0.017719907407407406,1,1,1,2
2022-10-09 16:27:04,1.0362962962962963,250,21246,6548,27794
2022-10-08 05:15:50,0.018483796296296297,1,38,6,44
2022-10-09 04:08:37,0.9845949074074074,2,596,251,847
2022-10-08 05:14:14,0.005821759259259259,1,5,5,10
2022-10-08 04:01:11,0.30386574074074074,1,282,112,394
2022-10-07 08:14:31,0.12715277777777778,1,394,50,444
2022-10-07 03:53:14,0.006643518518518518,1,1,1,2
2022-10-06 00:26:34,0.054467592592592595,1,42,89,131
2022-10-06 00:19:45,0.06604166666666667,1,8,210,218
2022-10-05 22:03:52,0.1827314814814815,1,3,68,71
2022-10-08 04:34:58,1.8340972222222223,250,20058,7846,27904
2022-10-05 16:57:33,0.4106134259259259,1,101,30,131
2022-10-05 05:02:10,0.0017708333333333332,1,2,0,2
2022-10-05 01:47:56,0.09072916666666667,1,473,196,669
2022-10-05 01:48:07,0.21106481481481482,1,16,18,34
2022-10-05 07:14:38,0.9733680555555555,250,19180,7324,26504
2022-10-04 11:57:32,0.6589236111111111,1,4,4,8
2022-10-06 18:34:03,0.0450462962962963,1,233,309,542
2022-10-04 11:35:39,0.6442939814814815,1,11,11,22
2022-10-04 07:34:01,0.006284722222222222,1,6,11,17
2022-10-06 17:23:58,2.8866550925925925,1,64,39,103
2022-10-04 07:17:09,0.46563657407407405,1,27,22,49
2022-10-04 12:18:59,0.019375,1,5,5,10
2022-10-04 11:57:11,0.66125,1,5,5,10
2022-10-04 11:56:14,0.6607638888888889,1,5,5,10
2022-10-04 11:34:21,0.6457407407407407,1,59,66,125
2022-10-04 11:42:26,0.6515625,1,5,5,10
2022-10-06 17:25:00,2.8896296296296295,1,66,13,79
2022-10-04 07:16:11,0.4671180555555556,1,46,36,82
2022-10-03 21:08:39,0.1947800925925926,1,1,1,2
2022-10-03 16:15:47,0.07556712962962962,1,75,48,123
2022-10-03 00:56:13,0.3037384259259259,1,5,1,6
2022-10-04 18:13:23,4.6216435185185185,1,479,464,943
2022-10-04 18:13:46,4.920324074074074,1,13,446,459
2022-10-04 07:42:40,4.7123842592592595,222,16329,16310,32639
2022-09-29 06:55:15,0.06280092592592593,1,4,2,6
2022-09-29 23:14:37,0.7453356481481481,1,3,12,15
2022-09-29 14:27:51,0.4196875,177,16313,16156,32469
2022-10-30 12:23:05,31.335486111111113,1,14,6,20
2022-09-29 04:21:51,0.02185185185185185,1,43,4,47
2022-09-29 04:22:12,0.06010416666666667,1,38,28,66
2022-09-28 23:15:09,0.09793981481481481,1,1,1,2
2022-09-27 23:02:15,0.06925925925925926,1,1,1,2
2022-09-27 23:02:02,0.07814814814814815,1,10,6,16
2022-09-27 21:33:56,0.09518518518518519,1,11,3,14
2022-09-27 17:34:29,0.8853356481481481,1,5,5,10
2022-09-27 17:33:59,0.8860763888888888,1,5,5,10
2022-09-27 17:32:25,0.8856597222222222,1,5,5,10
2022-09-27 17:31:46,0.8862847222222222,1,5,5,10
2022-09-27 17:31:33,0.8916898148148148,1,1,1,2
2022-09-27 01:08:19,1.8550462962962964,1,558,134,692
2022-09-28 15:22:50,3.9595023148148147,115,12431,11983,24414
2022-09-24 06:33:28,0.019953703703703703,1,83,0,83
2022-09-24 05:41:01,0.005601851851851852,1,4,4,8
2022-09-23 22:11:34,0.04064814814814815,1,1,1,2
2022-09-23 21:00:13,1.7574305555555556,1,306,11,317
2022-09-21 20:45:57,0.368275462962963,9,439,183,622
2022-09-24 10:37:14,2.965775462962963,1,9,11,20
2022-09-21 12:48:35,0.19099537037037037,1,1,1,2
2022-09-24 15:28:55,3.5311689814814815,43,1838,846,2684
2022-09-20 21:50:19,0.31298611111111113,1,1,1,2
2022-09-21 02:05:25,0.008229166666666666,1,49,29,78
2022-09-24 10:55:44,0.011689814814814814,1,1,1,2
2022-09-21 02:15:25,0.005636574074074074,1,24,95,119
2022-09-21 01:50:49,1.238738425925926,1,61,49,110
2022-09-21 02:21:52,1.2608796296296296,1,5,5,10
2022-09-21 11:24:23,1.637962962962963,1,5,5,10
2022-09-21 02:05:44,0.00837962962962963,1,13,13,26
2022-09-21 11:24:53,1.6392592592592592,1,8,10,18
2022-09-21 02:22:50,1.2628587962962963,1,15,15,30
2022-09-21 01:51:20,1.2413194444444444,1,21,14,35
2022-09-24 10:38:47,4.608321759259259,1,4,4,8
2022-09-20 21:49:00,1.2434375,1,1,1,2
2022-09-21 20:46:58,7.267199074074074,1,23,3,26
2022-09-21 20:46:35,7.317372685185185,2,34,3,37
2022-09-15 13:35:07,0.4819097222222222,2,2,2,4
2022-09-17 01:03:46,4.2065625,1,5,5,10
2022-09-17 01:03:19,4.207430555555556,1,5,5,10
2022-09-17 01:03:04,4.207280092592592,1,5,5,10
2022-09-18 07:50:13,5.490787037037037,1,5,5,10
2022-09-21 02:10:03,8.552314814814816,181,16802,15868,32670
2022-09-11 14:12:25,0.032685185185185185,1,55,55,110
2022-09-11 13:23:56,0.015960648148148147,1,6,6,12
2022-09-11 14:11:10,0.03162037037037037,3,480,538,1018
2022-09-08 07:44:25,0.06296296296296296,1,6,0,6
2022-09-08 07:44:37,0.7029513888888889,1,6,0,6
2022-09-11 12:53:06,5.696932870370371,1,5,5,10
2022-09-11 12:54:51,5.6986689814814815,1,156,394,550
2022-09-11 13:20:36,0.01425925925925926,1,28,164,192
2022-09-11 12:55:47,5.699861111111111,1,5,5,10
2022-09-11 12:53:34,5.699456018518519,1,3,3,6
2022-09-11 12:54:05,5.700266203703704,1,5,12,17
2022-09-11 12:54:28,5.700717592592593,1,39,22,61
2022-09-11 12:59:06,5.704560185185185,1,5,5,10
2022-11-08 16:18:22,65.71700231481482,1,2,0,2
2022-10-26 13:23:00,54.91488425925926,1,2,3,5
2022-09-20 21:51:22,21.965810185185184,1,298,39,337
2022-08-31 16:12:53,1.8360416666666666,1,146,92,238
2022-08-31 16:32:18,0.0103125,1,4,4,8
2022-08-31 16:32:58,0.010648148148148148,1,3,16,19
2022-08-31 21:28:31,0.20278935185185185,1,3,3,6
2022-08-31 21:29:39,0.2020949074074074,1,2,10,12
2022-08-31 16:33:26,0.009641203703703704,1,6,6,12
2023-04-27 09:26:14,0.7105787037037037,1,39,6,45
2022-09-01 02:41:31,0.2093287037037037,1,2,30,32
2022-08-31 16:14:28,1.8416319444444444,1,19,22,41
2022-08-31 16:15:32,1.8429282407407408,1,3,3,6
2022-08-29 08:02:41,0.07876157407407407,1,2,0,2
2022-08-28 01:31:54,0.31581018518518517,1,177,36,213
2022-08-28 01:37:55,0.34063657407407405,2,398,37,435
2022-08-27 18:56:47,0.07049768518518519,1,120,1,121
2022-08-27 15:40:47,0.3463541666666667,1,1,1,2
2022-08-26 22:45:55,0.030532407407407407,1,16,16,32
2022-08-26 00:11:24,0.10731481481481482,1,1,1,2
2022-08-25 21:33:35,0.14616898148148147,1,138,4,142
2022-08-25 15:36:54,0.08356481481481481,1,12,5,17
2022-08-25 15:36:35,0.1251736111111111,1,1,1,2
2022-08-25 15:36:01,0.13594907407407408,1,2,2,4
2022-09-11 13:19:59,16.621493055555554,250,16728,4028,20756
2022-08-25 18:10:44,0.7150231481481482,1,2,2,4
2022-08-25 18:39:41,1.024548611111111,3,4697,836,5533
2022-08-24 17:00:38,1.1143055555555557,1,64,13,77
2022-08-25 00:58:05,2.2024537037037035,1,15,15,30
2022-08-25 18:57:41,0.031747685185185184,1,3,3,6
2022-08-25 00:55:01,2.201238425925926,1,29,29,58
2022-08-25 18:57:01,2.9527430555555556,1,1,1,2
2022-08-25 00:57:17,2.203125,1,1,1,2
2022-08-25 00:56:16,2.202974537037037,1,6,11,17
2022-08-25 00:55:35,2.202685185185185,1,5,5,10
2022-08-25 00:54:36,2.2035416666666667,1,1,1,2
2022-12-15 16:07:37,112.08975694444445,1,6,0,6
2022-10-27 14:58:49,67.57230324074074,3,7,10,17
2022-08-26 00:12:47,5.691712962962963,2,2,2,4
2022-08-19 00:27:53,0.021886574074074076,1,3,3,6
2022-08-19 09:53:42,0.4170833333333333,1,2,2,4
2022-10-04 22:16:41,47.28798611111111,1,3,0,3
2022-12-13 19:02:33,117.24532407407408,1,1,1,2
2022-08-18 23:52:06,1.1134606481481482,1,1,1,2
2022-08-18 23:58:17,1.1180671296296296,1,32,26,58
2022-08-25 02:39:12,8.4915625,1,12,0,12
2022-08-17 21:07:30,1.2784027777777778,1,1,1,2
2022-08-17 21:07:12,1.7995949074074074,1,1,1,2
2022-08-19 00:24:46,3.174664351851852,1,5,5,10
2022-08-18 23:53:14,3.153587962962963,1,5,5,10
2022-08-18 23:53:37,1.114537037037037,1,1,1,2
2022-08-19 00:06:07,3.163113425925926,1,4,4,8
2022-08-19 00:06:16,3.1634953703703705,1,1,1,2
2022-08-18 23:55:18,3.1561574074074072,1,3,3,6
2022-08-18 23:53:28,3.155104166666667,1,1,1,2
2022-08-18 23:52:58,3.1552777777777776,1,17,43,60
2022-08-18 23:54:31,1.115150462962963,1,1,1,2
2022-08-24 17:00:55,9.028078703703704,1,64,27,91
2022-08-15 18:33:05,0.5134953703703704,1,0,2,2
2022-08-15 18:32:21,0.5719907407407407,1,2,0,2
2022-08-25 10:40:19,10.461400462962963,250,18589,7091,25680
2022-08-28 01:45:08,15.290856481481482,1,2,2,4
2022-08-28 01:45:19,15.292835648148149,1,2,3,5
2022-09-29 02:39:34,49.22695601851852,1,423,145,568
2022-08-25 02:29:00,13.346724537037037,1,7,7,14
2022-08-25 02:29:20,15.449432870370371,1,1,0,1
2022-08-14 22:40:26,6.1072800925925925,1,5,5,10
2022-08-14 22:41:36,6.108668981481482,1,5,5,10
2022-08-14 22:43:03,6.110034722222222,1,3,3,6
2022-08-14 22:50:50,6.115856481481481,2,6,6,12
2022-08-14 22:43:22,6.110949074074074,1,1,1,2
2022-08-14 22:42:03,6.110706018518519,1,11,23,34
2022-08-25 02:27:48,16.75556712962963,11,1156,81,1237
2023-01-18 15:28:18,164.3749537037037,3,10,2,12
2022-08-10 15:12:59,99.92809027777778,10,199,141,340
2022-08-06 06:47:17,0.007337962962962963,1,2,2,4
2022-08-06 07:28:10,0.017719907407407406,1,3,3,6
2022-08-06 07:01:40,0.01628472222222222,1,2,2,4
2022-08-06 06:46:33,0.009456018518518518,1,3,3,6
2022-08-25 02:37:09,19.759525462962962,1,1,1,2
2022-08-25 02:38:02,22.25980324074074,1,3,3,6
2022-08-25 02:37:40,22.261736111111112,1,1,1,2
2022-08-06 06:14:41,4.422511574074074,1,5,5,10
2022-08-06 06:34:00,4.436238425925926,1,1,1,2
2022-08-06 06:14:17,4.4226273148148145,1,124,40,164
2022-08-06 06:31:15,0.005069444444444444,1,14,53,67
2022-08-06 06:21:07,0.00375,1,26,47,73
2022-08-06 06:31:47,4.437199074074074,1,1,1,2
2022-08-06 06:37:04,4.44105324074074,1,1,1,2
2022-08-14 22:39:45,13.442627314814814,250,18138,7412,25550
2022-07-29 16:24:30,0.01167824074074074,1,2,2,4
2022-07-29 16:29:44,0.01638888888888889,1,5,5,10
2022-07-29 16:27:13,0.006423611111111111,1,3,3,6
2022-07-29 16:31:49,0.019710648148148147,1,2,2,4
2022-07-29 16:16:29,0.009351851851851853,1,5,5,10
2022-07-29 16:39:39,0.005763888888888889,1,9,9,18
2022-07-29 16:11:57,0.006828703703703704,1,2,2,4
2022-07-29 16:09:29,0.005277777777777778,1,2,2,4
2022-07-29 16:48:44,0.005358796296296296,1,1,1,2
2022-08-27 15:41:20,29.012118055555554,1,20,0,20
2022-07-29 15:57:09,3.824409722222222,1,17,17,34
2022-07-29 15:59:38,3.827974537037037,1,1,1,2
2022-07-29 15:56:30,3.8266898148148147,1,5,5,10
2022-08-25 02:30:54,31.60127314814815,1,3,11,14
2022-07-22 01:17:42,0.04769675925925926,1,27,9,36
2022-07-22 01:17:56,0.06784722222222223,1,2,2,4
2022-07-22 13:52:07,0.5946064814814814,1,188,18,206
2022-07-30 13:09:19,9.995497685185185,168,11886,11162,23048
2022-07-20 15:06:53,0.12702546296296297,1,2,1,3
2022-07-20 11:24:35,0.415787037037037,1,9,9,18
2022-07-20 11:28:53,1.6214699074074075,1,1,1,2
2022-07-20 11:27:46,1.6289467592592592,1,6,11,17
2022-07-20 11:55:57,0.003935185185185185,1,6,6,12
2022-07-20 11:29:18,1.6318518518518519,1,77,40,117
2022-07-20 11:30:42,1.6336689814814815,1,5,5,10
2022-07-20 11:26:23,1.6310300925925927,1,87,23,110
2022-07-20 11:36:45,0.006030092592592593,1,17,35,52
2022-07-20 11:57:25,0.004629629629629629,1,5,5,10
2022-07-20 11:30:00,1.6357986111111111,1,1,1,2
2022-07-20 11:55:45,0.003981481481481482,1,23,81,104
2022-07-20 11:25:46,1.6341087962962964,1,5,5,10
2022-07-20 11:47:44,0.007847222222222222,1,254,336,590
2022-08-31 16:16:07,5.88693287037037,1,55,55,110
2022-07-20 11:25:14,1.6351967592592593,1,239,150,389
2022-09-11 13:00:06,17.49849537037037,1,21,21,42
2022-07-18 23:06:11,0.49769675925925927,2,7,5,12
2022-08-25 02:38:35,37.658599537037034,1,1,1,2
2022-07-18 06:41:08,0.035138888888888886,1,1,1,2
2022-07-18 06:41:50,0.07325231481481481,1,1,1,2
2022-10-26 17:23:16,101.73439814814814,2,2312,963,3275
2022-07-17 11:37:31,1.845011574074074,1,23,11,34
2022-07-20 12:21:58,5.333344907407407,119,1910,1285,3195
2022-07-17 11:49:29,2.688101851851852,1,329,20,349
2022-07-13 23:23:11,0.004594907407407408,1,2,0,2
2022-07-15 01:21:28,3.2196527777777777,1,1,1,2
2022-07-13 13:03:28,1.8496527777777778,2,193,51,244
2022-08-15 00:47:33,36.17582175925926,1,1,1,2
2022-07-09 20:07:18,0.26037037037037036,1,1,1,2
2022-07-08 20:39:17,0.013368055555555555,1,1,1,2
2022-07-15 01:20:59,8.166550925925925,250,13287,7386,20673
2022-07-07 16:18:23,2.1576157407407406,5,23,11,34
2022-07-05 18:01:50,0.23905092592592592,1,1,1,2
2022-07-06 00:14:46,1.1727314814814815,1,5,5,10
2022-07-06 00:47:18,1.195486111111111,1,5,5,10
2022-07-06 00:17:33,1.175335648148148,1,19,11,30
2022-07-06 00:40:06,0.007824074074074074,1,107,115,222
2022-07-06 00:54:41,0.025486111111111112,1,3,3,6
2022-07-06 00:42:11,1.1933449074074074,1,5,5,10
2022-07-06 00:17:57,1.1768865740740742,1,18,18,36
2022-07-06 00:16:52,1.177673611111111,1,1,1,2
2022-07-04 09:08:30,4.649074074074074,2,115,9,124
2022-07-07 01:14:28,3.6625925925925924,1,12,2,14
2022-06-30 08:39:29,0.03128472222222222,1,1,26,27
2022-06-30 07:51:56,0.03481481481481481,1,2,2,4
2022-06-28 17:49:36,0.11413194444444444,1,1,1,2
2022-06-28 09:55:47,0.5746180555555556,1,143,94,237
2022-06-28 10:34:43,0.005185185185185185,1,413,555,968
2022-06-28 13:16:41,0.7152662037037038,1,7,7,14
2022-06-28 10:08:05,0.004629629629629629,1,20,28,48
2022-06-28 09:56:44,0.5773032407407407,1,7,7,14
2022-06-29 17:30:38,1.4069444444444446,1,5,5,10
2022-06-29 17:31:11,1.8932523148148148,1,3,3,6
2022-06-28 10:20:09,0.0043518518518518515,1,49,60,109
2022-06-28 10:19:40,0.004189814814814815,1,43,48,91
2022-06-29 17:31:39,1.1740277777777777,1,27,26,53
2022-06-28 09:56:20,0.5783333333333334,1,91,51,142
2022-06-28 13:16:09,0.7174421296296296,1,1,1,2
2022-06-28 13:16:24,0.7183101851851852,1,1,1,2
2022-06-27 07:02:48,0.8924537037037037,1,1,1,2
2022-07-06 20:58:32,1.8380439814814815,250,22424,8802,31226
2022-06-23 21:08:52,1.367361111111111,1,7,0,7
2022-06-22 23:44:27,0.21140046296296297,1,1,1,2
2022-06-27 07:30:15,6.316666666666666,1,235,17,252
2022-06-27 11:54:47,6.6620486111111115,1,5,5,10
2022-06-27 11:55:18,6.662581018518519,1,3,3,6
2022-06-19 06:18:08,0.06170138888888889,1,34,42,76
2022-06-19 05:43:55,2.398113425925926,1,5,5,10
2022-06-19 05:42:02,2.396886574074074,1,4,4,8
2022-06-19 05:44:57,2.399513888888889,1,5,5,10
2022-06-19 05:43:21,2.3991435185185184,1,5,5,10
2022-06-20 10:10:12,3.5847685185185183,1,1,1,2
2022-06-19 05:38:07,2.3960185185185185,1,2,2,4
2022-06-20 09:52:36,1.1758333333333333,1,1,1,2
2022-06-22 02:35:40,1.6961921296296296,1,1,1,2
2022-06-20 09:52:13,1.1757986111111112,1,1,1,2
2022-06-19 05:40:46,2.397986111111111,1,1,1,2
2022-06-19 05:39:22,2.397048611111111,1,1,1,2
2022-07-06 00:11:01,7.453865740740741,1,3,3,6
2022-06-26 03:08:08,9.787743055555556,44,1688,1345,3033
2022-06-23 21:12:02,8.350798611111111,1,232,0,232
2022-06-23 21:09:32,9.462094907407407,2,6,2,8
2022-06-23 21:10:03,9.614641203703703,1,1,1,2
2022-06-19 06:53:39,0.038657407407407404,1,404,241,645
2022-06-19 07:10:15,0.008275462962962964,1,11,78,89
2022-06-16 11:33:21,2.6433333333333335,1,5,5,10
2022-06-16 11:35:45,2.6452893518518517,1,1,1,2
2022-06-19 05:46:14,5.402939814814815,1,25,113,138
2022-06-19 05:47:13,2.750891203703704,1,5,5,10
2022-06-15 05:52:21,1.4079976851851852,1,1,1,2
2022-06-15 05:51:48,1.407673611111111,1,23,30,53
2022-06-19 07:10:41,0.008576388888888889,1,2,96,98
2022-06-16 11:43:24,2.6521412037037035,1,1,1,2
2022-06-16 11:42:17,1.237650462962963,1,5,5,10
2022-06-16 11:46:49,1.2396412037037037,1,5,5,10
2022-06-15 05:53:20,1.41,1,5,5,10
2022-06-15 14:35:36,2.177141203703704,3,60,48,108
2022-08-25 02:31:10,72.75138888888888,1,1,1,2
2022-07-05 00:41:40,23.12212962962963,5,6761,3267,10028
2022-06-12 00:48:03,0.16238425925925926,1,0,2,2
2022-06-11 18:32:02,0.041435185185185186,1,13,14,27
2022-06-11 13:34:58,0.06233796296296296,1,1,1,2
2022-06-10 15:34:59,0.23262731481481483,1,13,3,16
2022-06-10 15:37:25,0.3332986111111111,1,1,1,2
2022-06-19 05:42:44,7.699212962962963,1,2,2,4
2022-06-11 12:55:17,4.69943287037037,1,9,14,23
2022-06-15 05:53:49,8.407060185185186,1,1,1,2
2022-06-11 12:53:52,4.701365740740741,1,1,1,2
2022-06-16 04:31:19,6.342268518518519,250,16817,5026,21843
2022-08-28 15:44:35,85.40082175925926,2,4,4,8
2022-06-16 20:07:11,12.586238425925925,1,8,0,8
2022-12-15 18:03:45,194.52497685185185,1,1,0,1
2022-06-21 13:16:23,17.86087962962963,2,39,6,45
2022-06-16 20:09:43,13.27386574074074,1,33,0,33
2022-06-09 20:25:24,12.118275462962963,1,257,152,409
2022-06-01 20:00:50,0.10884259259259259,1,1,6,7
2022-06-01 17:09:37,0.07401620370370371,1,73,0,73
2022-06-01 17:22:35,0.15770833333333334,1,799,742,1541
2022-06-01 20:00:23,0.7747569444444444,1,3,3,6
2022-06-01 03:03:12,0.3012962962962963,1,4,4,8
2022-05-31 16:25:25,0.045023148148148145,1,3,0,3
2022-06-03 03:50:53,3.322025462962963,1,5,5,10
2022-06-03 03:53:14,3.324189814814815,1,3,3,6
2022-06-11 12:54:46,11.700960648148149,1,4,4,8
2022-07-06 00:44:02,36.19366898148148,1,5,5,10
2022-06-03 03:51:25,1.3263657407407408,1,5,5,10
2022-06-01 10:50:28,1.6154050925925927,1,5,5,10
2022-06-01 10:49:52,1.615173611111111,1,33,28,61
2022-06-01 11:07:38,0.0061574074074074074,1,17,37,54
2022-06-01 17:22:55,1.9984259259259258,1,5,4,9
2022-06-01 14:24:07,2.0489236111111113,6,10,6,16
2022-07-20 11:56:44,50.94556712962963,1,28,20,48
2022-06-04 04:44:49,3.067511574074074,250,15704,14255,29959
2022-06-01 17:23:31,2.2312962962962963,1,4,1,5
2024-04-02 14:07:18,0.014386574074074074,1,0,3,3
2022-05-31 03:53:44,0.8767592592592592,1,4,0,4
2022-05-30 15:10:13,0.35269675925925925,1,3,7,10
2022-05-28 13:50:37,0.20216435185185186,1,7,6,13
2022-05-28 12:32:08,0.32413194444444443,1,26,20,46
2022-05-27 18:05:34,0.05974537037037037,1,0,357,357
2022-05-28 02:43:39,0.4154976851851852,1,1,1,2
2022-05-27 18:05:22,0.3437384259259259,2,14,4,18
2022-05-26 21:02:42,0.004247685185185185,1,11,1,12
2022-05-26 21:26:15,0.03868055555555556,1,48,1,49
2022-05-26 20:08:12,12.878472222222221,1,2,1,3
2022-05-26 20:08:02,12.872268518518519,1,6,2,8
2022-05-26 20:14:47,14.236655092592592,1,5,1,6
2022-05-26 20:06:10,14.229155092592592,1,2,0,2
2022-05-26 20:04:17,36.46471064814815,1,2,1,3
2022-05-26 20:04:05,12.864074074074074,1,6,0,6
2022-05-26 20:03:54,12.352199074074074,1,12,1,13
2022-05-26 18:29:29,0.007928240740740741,1,1,3,4
2022-05-26 18:32:48,0.07373842592592593,1,24,0,24
2022-05-26 16:43:15,0.035208333333333335,1,1,1,2
2022-05-26 15:55:05,0.025497685185185186,1,5,5,10
2022-05-26 16:05:47,0.03803240740740741,1,2,3,5
2022-05-26 00:16:19,0.0043518518518518515,1,101,72,173
2022-05-26 00:06:44,0.013055555555555556,1,5,5,10
2022-06-09 19:57:37,15.019155092592593,2,530,8,538
2022-05-30 06:49:43,3.9159722222222224,250,15782,17991,33773
2022-05-27 18:06:41,3.2372800925925924,1,7,7,14
2022-05-28 12:22:47,4.676458333333334,1,65,36,101
2022-05-25 23:41:07,2.148113425925926,1,5,5,10
2022-05-29 13:28:08,5.72306712962963,1,4,4,8
2022-05-29 13:28:48,5.723703703703704,1,1,1,2
2022-05-29 13:30:11,5.725405092592593,1,1,1,2
2022-05-25 23:06:30,2.125891203703704,1,5,5,10
2022-05-29 13:27:10,5.724270833333334,1,20,27,47
2022-05-28 12:22:32,4.679560185185185,1,5,5,10
2022-05-25 23:05:53,2.127037037037037,1,43,43,86
2022-05-25 23:06:55,2.1279398148148148,1,5,5,10
2022-05-29 13:27:31,5.725601851851851,1,1,1,2
2024-01-12 16:04:01,593.3307638888889,6,53,35,88
2022-12-15 16:11:14,209.3525462962963,2,10,4,14
2022-08-25 02:32:45,96.79655092592593,1,1,1,2
2022-05-22 20:16:43,2.7572337962962963,1,294,103,397
2022-05-20 02:39:05,0.3189236111111111,1,11,7,18
2022-05-19 17:26:20,0.0096875,1,16,6,22
2022-05-24 14:33:19,5.057280092592593,70,1386,933,2319
2022-05-18 21:29:14,1.233275462962963,1,64,19,83
2022-08-17 21:06:49,92.21732638888889,3,28,22,50
2022-05-17 08:12:00,0.03153935185185185,1,59,46,105
2022-05-18 12:25:24,0.01480324074074074,3,270,264,534
2022-05-18 12:16:16,1.6734606481481482,2,210,169,379
2022-05-18 12:02:31,1.6640972222222221,1,10,10,20
2022-05-18 18:29:54,0.2511921296296296,1,5,19,24
2022-05-18 12:01:24,1.1566435185185184,1,52,57,109
2022-05-18 18:30:31,1.934189814814815,1,5,5,10
2022-05-18 18:33:13,0.25340277777777775,1,5,18,23
2022-05-18 12:01:58,1.6655439814814814,1,34,19,53
2022-05-18 18:27:03,1.9340625,1,3,3,6
2022-05-18 18:27:55,1.9348958333333333,1,5,5,10
2022-05-16 18:14:21,0.028275462962962964,1,2,2,4
2022-10-28 23:31:45,165.2814236111111,1,3,2,5
2022-05-16 17:13:36,0.02712962962962963,1,3,2,5
2022-08-25 02:41:14,100.45635416666667,2,44,15,59
2022-08-25 02:40:17,100.75633101851852,2,11,2,13
2022-05-15 23:00:10,0.07113425925925926,2,2,2,4
2022-05-16 09:18:35,0.8407523148148148,1,513,16,529
2022-05-19 10:58:16,4.0779861111111115,250,15021,10561,25582
2022-08-25 02:40:38,102.08623842592593,3,31,5,36
2022-05-14 04:51:59,0.2410300925925926,1,3,0,3
2022-08-25 18:10:01,104.32636574074074,1,1059,445,1504
2022-05-14 08:03:44,1.250775462962963,1,7,1,8
2022-05-12 20:40:55,0.1246875,1,0,1,1
2022-05-12 22:02:36,1.0300810185185185,2,116,183,299
2023-01-13 21:34:17,247.4254861111111,3,103131,48698,151829
2023-01-13 10:03:14,247.97461805555557,2,6,5,11
2022-05-23 18:38:29,13.395138888888889,3,7,7,14
2022-05-10 02:58:04,0.12105324074074074,1,2,2,4
2022-05-09 21:19:11,0.04659722222222222,1,8,0,8
2022-05-10 19:00:31,0.9536226851851852,1,5,14,19
2022-05-10 19:08:27,0.9599768518518519,1,107,72,179
2022-05-12 01:44:41,1.2642592592592592,1,5,5,10
2022-05-10 19:01:51,0.9560185185185185,1,64,48,112
2022-05-10 19:15:04,0.004097222222222223,1,231,307,538
2022-05-10 19:01:16,0.9559837962962963,1,5,5,10
2022-05-10 19:09:31,0.961875,1,1,1,2
2022-05-10 19:02:08,0.9569907407407408,1,65,22,87
2022-05-12 01:42:52,2.2358449074074076,1,4,4,8
2022-05-12 01:54:27,0.006666666666666667,1,56,56,112
2022-05-12 01:43:31,2.2374768518518517,1,1,1,2
2022-05-10 19:04:13,0.9604398148148148,1,1,1,2
2022-05-09 21:20:19,0.4293518518518519,1,10,3,13
2023-03-24 02:17:53,319.8583912037037,1,396,236,632
2022-05-09 05:43:08,1.1337962962962962,4,319,315,634
2023-02-13 15:36:30,282.1450115740741,6,95,13,108
2022-05-10 07:44:35,3.2120486111111113,1,166,59,225
2022-05-15 09:04:59,8.553541666666666,250,7210,6352,13562
2022-05-06 19:40:20,0.23144675925925925,2,5,1,6
2022-05-06 19:40:49,0.3934837962962963,1,5,1,6
2022-05-06 19:41:34,0.4885069444444444,1,4,2,6
2022-06-16 20:09:59,41.77563657407408,2,3,3,6
2022-10-28 10:56:32,175.78141203703703,6,27125,25662,52787
2022-05-05 22:41:42,0.2927199074074074,1,1,1,2
2022-05-07 02:50:40,2.3120833333333333,1,2,1,3
2022-05-17 12:52:26,12.774097222222222,2,42,24,66
2022-05-05 22:41:57,1.3134027777777777,1,6,6,12
2022-05-04 01:20:44,0.015416666666666667,1,29,7,36
2022-05-04 00:40:27,0.042604166666666665,1,23,14,37
2022-05-03 22:57:43,0.3390162037037037,4,75,23,98
2022-05-03 22:26:46,0.34381944444444446,1,1,1,2
2022-05-03 10:30:41,0.024722222222222222,1,4,4,8
2022-05-03 07:09:09,0.04416666666666667,1,9,6,15
2022-10-08 14:45:40,158.38675925925926,1,274,121,395
2022-05-03 01:41:21,0.22841435185185185,1,5,5,10
2022-05-03 01:19:41,0.21524305555555556,1,5,5,10
2022-05-04 04:42:37,1.3565046296296297,1,46,59,105
2022-05-03 01:30:14,0.0042824074074074075,1,131,97,228
2022-05-04 05:06:50,0.014884259259259259,5,1052,854,1906
2022-05-04 04:55:05,0.006099537037037037,1,5,5,10
2022-05-03 01:10:45,0.2114351851851852,1,1,1,2
2022-05-03 01:19:24,0.21773148148148147,1,81,58,139
2022-05-03 01:22:05,0.006296296296296296,1,54,54,108
2022-05-04 13:47:06,1.737824074074074,1,5,10,15
2022-05-04 04:49:53,0.0040625,1,1,1,2
2022-05-03 01:40:49,0.011643518518518518,1,101,38,139
2022-05-03 01:40:18,0.005509259259259259,1,5,5,10
2022-05-04 13:25:40,1.5005555555555556,1,20,10,30
2022-05-03 00:55:23,0.20306712962962964,1,2,2,4
2022-05-02 17:34:40,0.02585648148148148,1,1,1,2
2022-05-06 12:53:22,2.5013310185185187,250,20773,8154,28927
2022-05-02 15:41:02,0.035486111111111114,3,146,11,157
2022-05-02 15:41:34,0.14418981481481483,1,14,0,14
2022-06-01 15:31:36,30.174293981481483,2,283,12,295
2022-05-02 01:39:45,0.5767476851851852,2,3,1,4
2022-05-01 23:00:08,0.5615856481481482,1,3,1,4
2022-05-02 14:19:24,2.1046875,218,5593,5224,10817
2022-04-30 22:55:27,0.5621064814814815,1,1,1,2
2022-04-30 22:51:32,0.9078472222222222,1,2,1,3
2022-04-30 22:37:46,0.8924421296296297,1,11,2,13
2022-04-30 22:56:35,0.814375,1,9,4,13
2022-04-29 18:25:31,0.04121527777777778,1,4,1,5
2022-04-29 21:27:03,0.46523148148148147,1,43,114,157
2022-04-29 09:46:59,0.27498842592592593,1,1,1,2
2022-04-29 20:42:42,0.6084375,1,81,82,163
2022-04-28 21:34:58,0.007407407407407408,1,2,2,4
2022-04-28 22:24:44,0.08662037037037038,1,15,2,17
2022-04-29 20:43:08,1.0259143518518519,2,28,12,40
2022-04-28 22:15:27,0.09557870370370371,1,1,1,2
2022-04-28 19:29:29,0.02982638888888889,1,17,3,20
2022-04-28 18:19:10,0.04186342592592593,2,20,1,21
2022-04-28 16:11:31,0.004965277777777778,1,1,1,2
2022-04-28 15:15:12,0.06653935185185185,1,34,1,35
2022-04-28 15:15:29,0.09569444444444444,1,1,1,2
2022-04-30 11:11:52,1.528738425925926,250,21497,18123,39620
2022-04-28 22:24:32,0.7535648148148149,1,87,91,178
2022-04-28 15:47:34,0.9858449074074074,2,243,124,367
2022-04-29 17:23:03,2.173703703703704,1,132,128,260
2022-08-25 21:38:37,121.06506944444445,1,9,12,21
2022-04-26 20:06:31,0.010428240740740741,1,3,3,6
2022-04-26 19:48:37,0.011377314814814814,1,6,6,12
2022-04-26 19:22:09,0.08694444444444445,3,20,1,21
2022-04-26 19:25:26,0.45145833333333335,2,54,2,56
2022-05-03 01:20:22,7.217291666666667,1,5,5,10
2022-04-27 00:13:53,1.1714120370370371,1,6,6,12
2022-05-03 01:11:42,7.211782407407408,1,2,2,4
2022-05-21 06:43:37,2.3788425925925925,1,1,1,2
2022-04-27 00:17:44,1.1764814814814815,1,5,5,10
2022-04-27 00:16:19,1.1756365740740742,1,86,71,157
2022-05-04 13:29:51,0.3640625,1,5,5,10
2022-04-27 00:17:03,1.1767592592592593,1,36,32,68
2022-04-27 00:12:55,1.1741435185185185,1,1,1,2
2022-05-04 04:43:03,8.361909722222222,1,6,6,12
2022-12-15 16:38:35,234.00662037037037,1,1,1,2
2022-04-28 05:34:28,3.7911574074074075,103,2701,2530,5231
2022-09-29 14:36:14,158.45268518518517,1,1,1,2
2022-04-23 19:47:43,0.021770833333333333,1,1,1,2
2022-04-23 19:47:27,0.6257175925925926,1,7,0,7
2022-04-23 21:33:26,2.1292476851851854,147,4511,4463,8974
2022-04-21 18:26:11,0.015578703703703704,1,1,0,1
2022-06-28 07:42:13,68.75092592592593,28,1422,380,1802
2022-04-21 17:33:45,2.8950694444444443,1,20,11,31
2022-04-21 17:33:26,2.8956944444444446,1,1,1,2
2022-04-21 17:33:05,2.8956828703703703,1,6,6,12
2022-04-19 07:11:58,0.6240277777777777,1,2,2,4
2022-04-16 06:40:26,0.008703703703703703,1,3,3,6
2022-04-21 18:21:08,7.706041666666667,139,4534,4359,8893
2022-04-13 11:25:42,0.29899305555555555,1,1,1,2
2022-08-15 02:39:59,124.25997685185185,1,3,3,6
2022-04-12 12:20:40,0.09730324074074075,1,1,1,2
2022-04-12 01:26:50,0.8506828703703704,1,1,1,2
2022-04-14 12:22:08,2.677048611111111,1,5,5,10
2022-04-14 12:21:47,2.6775810185185187,1,1,1,2
2022-04-14 12:20:02,0.073125,1,20,12,32
2022-04-16 06:28:04,4.432627314814815,1,5,5,10
2022-04-14 12:21:05,2.677997685185185,1,1,1,2
2022-04-14 10:29:52,2.6008564814814816,1,5,5,10
2022-04-16 06:27:18,1.8272569444444444,1,5,5,10
2022-04-14 10:30:54,2.6019444444444444,1,42,36,78
2022-04-14 10:31:20,2.6026504629629628,1,1,1,2
2022-05-04 13:38:02,0.3533101851851852,1,28,2,30
2022-04-14 12:20:27,2.6787152777777776,1,5,5,10
2022-04-14 12:25:13,2.6821527777777776,1,26,28,54
2022-04-16 06:27:43,4.434097222222222,1,5,5,10
2022-04-11 19:17:04,0.10145833333333333,1,1,1,2
2022-04-09 18:11:06,0.05663194444444444,1,5,0,5
2022-08-13 13:41:13,126.70171296296296,1,2,2,4
2022-04-08 19:57:25,0.01597222222222222,1,44,1,45
2022-04-08 18:18:20,0.03832175925925926,1,1,0,1
2022-04-08 17:35:32,0.03864583333333333,1,9,7,16
2022-04-08 15:10:53,0.10155092592592592,1,20,31,51
2022-04-13 17:52:54,5.271284722222222,250,13000,3364,16364
2022-04-08 17:17:37,0.4094675925925926,1,6,3,9
2022-04-08 11:14:51,0.2732175925925926,3,140,128,268
2022-04-08 10:47:18,0.6509143518518519,1,2,30,32
2022-04-07 18:46:30,0.0061574074074074074,1,1,1,2
2022-04-07 18:17:49,0.006863425925925926,1,3,0,3
2022-04-08 17:17:54,1.0992476851851851,1,34,4,38
2022-04-07 16:06:16,0.08645833333333333,1,16,4,20
2022-08-25 21:38:23,140.32342592592593,2,1,214,215
2022-04-08 16:03:31,1.1010185185185186,3,61,28,89
2022-04-07 12:47:30,0.012430555555555556,2,12,0,12
2022-04-07 11:32:12,0.027476851851851853,1,3,2,5
2022-04-07 14:08:17,0.16945601851851852,2,24,12,36
2022-04-07 09:27:35,0.043506944444444445,1,12,3,15
2022-08-28 02:00:39,143.25863425925925,2,23,7,30
2022-04-06 20:53:29,0.06474537037037037,1,68,8,76
2022-04-06 18:57:18,0.02741898148148148,1,0,18,18
2022-04-06 18:57:53,0.06848379629629629,1,2,2,4
2022-04-06 18:56:57,0.06811342592592592,1,1,1,2
2022-04-06 19:01:41,0.29019675925925925,1,31,6,37
2022-04-06 18:58:12,0.3254398148148148,1,137,362,499
2022-04-06 18:58:24,1.3158912037037036,1,13,3,16
2022-04-08 19:21:50,4.918368055555556,2,29,24,53
2022-04-05 10:00:31,0.3673148148148148,1,4,0,4
2022-04-08 04:40:05,3.3561342592592593,1,5,5,10
2022-04-08 04:40:23,3.3567476851851854,1,3,3,6
2022-04-05 18:03:45,0.9147569444444444,1,5,5,10
2022-04-05 18:03:26,0.9148032407407407,1,5,5,10
2022-04-05 18:03:13,0.9150462962962963,1,15,15,30
2022-04-05 18:02:51,0.9148148148148149,1,1,1,2
2022-04-05 18:02:35,0.9147222222222222,1,5,5,10
2022-04-05 18:02:07,0.9151736111111111,1,1,1,2
2022-04-05 18:01:49,0.9151388888888888,1,1,1,2
2022-04-04 16:19:46,1.095162037037037,3,8,3,11
2022-04-03 12:02:29,0.6920601851851852,1,1,1,2
2022-08-13 13:40:01,133.4845601851852,2,34702,16721,51423
2022-04-01 21:55:32,0.5161921296296297,1,1,0,1
2022-04-01 21:59:13,0.5308912037037037,2,6,3,9
2022-04-01 21:56:23,1.4916550925925927,1,20,22,42
2022-03-31 09:20:26,0.01980324074074074,1,3,3,6
2022-04-06 19:01:02,6.490462962962963,7,221,13,234
2022-03-31 10:10:40,0.49508101851851855,1,1,1,2
2022-03-30 22:49:24,0.3181712962962963,1,12,11,23
2022-03-30 12:52:38,0.00837962962962963,1,7,2,9
2022-03-30 12:45:52,30.062592592592594,1,2,2,4
2022-03-30 12:46:03,8.162696759259259,1,57,14,71
2022-03-30 12:34:54,0.03017361111111111,1,1,4,5
2022-03-29 20:55:37,0.025810185185185186,1,37,37,74
2022-03-29 20:17:00,0.11354166666666667,1,1,1,2
2022-05-25 22:20:31,57.35525462962963,1,1,1,2
2022-03-30 08:26:51,0.8222337962962963,2,12,36,48
2022-04-08 10:52:23,4.947453703703704,250,4734,4633,9367
2022-03-29 08:52:25,0.5327314814814815,1,5,5,10
2022-03-29 08:52:52,0.5341898148148149,1,6,6,12
2022-03-29 08:51:55,0.5336574074074074,1,5,5,10
2022-03-29 08:51:14,0.5332754629629629,1,4,4,8
2022-03-29 09:58:28,0.005925925925925926,1,2,2,4
2022-03-29 08:53:22,0.5354513888888889,1,1,1,2
2022-03-28 10:43:58,0.06166666666666667,5,69,89,158
2022-03-28 21:57:38,0.5672569444444444,4,159,4,163
2022-03-28 07:39:32,0.43255787037037036,1,4,2,6
2022-08-13 13:39:05,142.60129629629628,1,71,8,79
2022-03-27 23:16:03,0.33091435185185186,1,0,4,4
2022-08-13 13:28:17,143.66625,1,0,707,707
2022-03-27 23:17:17,1.6086458333333333,5,48,38,86
2022-03-26 03:29:36,0.00010416666666666667,1,1,1,2
2022-03-26 03:02:19,0.0005671296296296297,1,1,1,2
2022-03-26 01:53:13,0.11895833333333333,1,7,3,10
2022-03-25 20:41:17,0.006377314814814815,1,5,5,10
2022-03-25 23:26:51,0.12461805555555555,1,75,5,80
2022-03-25 23:39:54,0.2915277777777778,1,2,1,3
2022-03-25 18:31:35,0.5463541666666667,2,10,2,12
2022-03-29 01:51:09,3.2002430555555557,250,16156,6274,22430
2022-03-25 20:00:59,1.2924189814814815,1,45,0,45
2022-08-13 13:44:34,143.29111111111112,1,1,0,1
2022-03-26 01:54:11,3.357291666666667,1,7,1,8
2022-03-22 17:41:46,0.017939814814814815,1,2,1,3
2022-03-22 17:20:25,0.0071643518518518514,1,3,3,6
2022-03-22 17:08:08,0.0017592592592592592,1,3,3,6
2022-03-22 17:20:08,0.014085648148148147,1,37,0,37
2022-03-22 10:58:25,0.03671296296296296,1,1,1,2
2022-03-22 09:07:11,0.14328703703703705,1,79,59,138
2022-03-22 11:29:04,0.25180555555555556,1,1,2,3
2022-03-22 10:58:14,0.23966435185185186,1,1,1,2
2022-03-22 08:48:12,0.15195601851851853,1,20,49,69
2022-03-22 05:08:05,0.013715277777777778,1,14,39,53
2022-03-25 23:38:45,3.834907407407407,10,166,97,263
2022-03-21 18:10:09,0.2735763888888889,1,13,20,33
2022-03-21 18:08:29,0.39469907407407406,1,40,3,43
2022-03-22 02:30:20,0.9431597222222222,2,32,32,64
2022-03-22 02:30:32,0.9440856481481481,1,3,3,6
2022-03-22 02:30:45,0.9443981481481482,1,4,4,8
2022-03-22 02:30:56,0.9449074074074074,1,5,5,10
2022-03-21 05:55:26,0.08744212962962963,1,15,15,30
2022-03-21 05:55:12,0.08746527777777778,1,5,5,10
2022-03-29 08:50:41,8.209710648148148,1,5,5,10
2022-03-21 05:55:00,0.08855324074074074,1,2,2,4
2022-03-21 03:45:58,0.11064814814814815,1,1,1,2
2022-03-24 10:23:46,4.26917824074074,166,4756,4533,9289
2022-03-26 01:53:34,6.10693287037037,10,754,846,1600
2022-03-19 08:24:26,0.32450231481481484,1,1,1,2
2022-03-21 03:46:11,2.756365740740741,2,203,129,332
2022-03-19 08:24:08,1.0440856481481482,1,1,1,2
2022-03-17 15:32:11,0.09460648148148149,1,1,1,2
2022-03-17 11:54:41,0.06599537037037037,1,97,0,97
2022-03-17 11:54:08,0.11011574074074074,1,0,2829,2829
2022-03-19 15:23:01,2.595636574074074,71,1261,3946,5207
2022-03-16 23:46:50,0.013344907407407408,1,2,0,2
2022-03-17 00:37:03,0.08491898148148148,1,24,6,30
2022-03-17 11:55:10,0.6488888888888888,1,2,2,4
2022-03-15 19:27:50,0.052222222222222225,2,2,1,3
2022-03-15 18:07:25,0.012430555555555556,1,4,4,8
2022-03-15 19:38:29,0.27655092592592595,1,1,1,2
2022-03-15 13:10:32,0.17722222222222223,1,1,1,2
2022-03-15 13:11:09,0.18204861111111112,1,2,2,4
2022-03-15 07:13:22,0.008842592592592593,1,19,51,70
2022-03-28 21:38:20,13.655671296296296,4,42,39,81
2022-03-15 05:05:20,0.00974537037037037,1,57,57,114
2022-03-18 00:34:57,2.8224189814814813,1,7,7,14
2022-03-18 00:51:58,0.007673611111111111,1,4,4,8
2022-03-15 06:51:55,0.32534722222222223,1,12,4,16
2022-03-15 03:11:14,0.17722222222222223,1,12,2,14
2022-03-15 04:46:11,0.3594675925925926,1,5,5,10
2022-03-15 04:46:22,0.3603587962962963,1,5,5,10
2022-03-15 04:46:34,0.36163194444444446,1,48,36,84
2022-03-15 04:46:45,0.36270833333333335,1,2,2,4
2022-03-15 04:46:58,0.3630787037037037,1,1,1,2
2022-04-08 04:44:41,24.36173611111111,1,8,8,16
2022-04-14 12:33:11,0.005358796296296296,1,4,4,8
2022-03-15 04:47:08,0.36369212962962966,1,5,5,10
2022-03-15 04:48:15,0.3645833333333333,1,5,5,10
2022-03-15 04:47:22,0.36422453703703705,1,5,5,10
2022-03-29 09:49:00,14.574409722222223,2,4,4,8
2022-03-15 04:47:32,0.365625,1,1,1,2
2022-03-17 00:33:26,0.06576388888888889,250,18270,10564,28834
2022-03-14 18:20:41,0.1622800925925926,1,16,0,16
2022-03-15 03:11:29,0.9529050925925926,2,53,77,130
2022-03-14 04:27:38,0.04240740740740741,1,6,2,8
2022-03-13 14:03:36,0.02096064814814815,2,135,1,136
2022-03-13 14:01:30,0.22246527777777778,1,12,2,14
2022-03-13 08:48:39,0.07359953703703703,1,3,3,6
2022-03-14 04:45:23,0.8988888888888888,1,2,60,62
2022-03-13 04:15:20,0.03929398148148148,1,3,3,6
2022-03-13 03:51:09,0.06496527777777777,1,8,1,9
2022-03-12 18:33:11,0.1370949074074074,3,27,4,31
2022-03-12 08:02:24,0.051099537037037034,1,1,1,2
2022-03-12 07:23:04,0.03318287037037037,1,3,1,4
2022-03-12 08:11:36,0.07380787037037037,1,72,30,102
2022-03-12 03:14:25,0.06260416666666667,1,66,2,68
2022-03-14 18:01:59,1.6858333333333333,250,14364,13647,28011
2022-03-11 03:58:10,0.12883101851851853,1,1,1,2
2022-03-10 16:59:23,0.008171296296296296,1,12,2,14
2022-03-10 03:10:21,0.015960648148148147,1,1,1,2
2022-03-09 23:11:16,0.011284722222222222,1,6,0,6
2022-03-09 23:11:40,0.035138888888888886,1,140,0,140
2022-03-09 23:11:49,0.06269675925925926,1,12,0,12
2022-03-12 07:33:11,2.434409722222222,9,53,20,73
2022-03-09 21:44:38,0.05103009259259259,1,10,1,11
2022-03-09 12:01:44,0.04415509259259259,1,11,1,12
2022-03-09 19:06:52,0.35158564814814813,1,11,5,16
2022-03-09 20:15:24,0.5748263888888889,1,154,49,203
2022-03-09 11:11:11,0.11412037037037037,1,2,2,4
2022-03-09 11:45:50,0.22797453703703704,1,274,190,464
2022-03-09 07:46:06,0.06518518518518518,1,11,2,13
2022-03-09 12:17:58,1.6763078703703704,1,5,5,10
2022-03-09 12:30:35,1.6859143518518518,1,5,5,10
2022-03-09 12:31:27,1.687361111111111,1,1,1,2
2022-03-07 10:21:27,0.015949074074074074,1,1,1,2
2022-03-09 07:51:12,1.9159143518518518,1,22,5,27
2022-03-12 07:12:58,4.909351851851852,3,362,45,407
2022-03-07 22:40:55,0.6378703703703704,5,103,13,116
2022-03-08 08:14:40,1.0928587962962963,4,383,132,515
2022-03-06 22:41:44,0.08715277777777777,1,1,1,2
2022-03-06 21:51:41,0.04880787037037037,31,88,88,176
2022-03-09 07:52:32,5.101875,3,713,236,949
2022-03-05 04:57:51,0.11217592592592593,2,2,2,4
2022-03-07 08:36:47,3.3910185185185187,4,173,36,209
2022-03-12 08:30:31,8.373622685185186,2,21,9,30
2022-03-04 00:00:14,0.020972222222222222,1,0,5,5
2022-03-04 00:06:33,0.028680555555555556,1,13,11,24
2022-03-09 08:06:17,6.319143518518518,7,762,720,1482
2022-03-09 19:49:15,6.077511574074074,2,63,6,69
2022-03-03 15:18:58,0.23842592592592593,1,2,0,2
2022-03-03 15:13:58,0.23809027777777778,1,1,1,2
2022-03-07 10:38:52,4.504664351851852,3,190,359,549
2022-03-03 05:45:31,0.30149305555555556,1,4,19,23
2022-03-03 05:45:46,0.30274305555555553,1,2,0,2
2022-03-02 19:28:26,0.0603125,1,11,2,13
2022-03-02 17:57:27,2.287476851851852,1,3,2,5
2022-10-06 08:16:47,218.10101851851852,1,6,39,45
2022-03-02 17:57:09,0.5108217592592592,1,62,26,88
2022-03-01 22:07:58,0.03684027777777778,1,1,1,2
2022-03-03 15:13:41,1.747037037037037,1,9,9,18
2022-03-02 17:57:44,1.7261689814814816,1,24,1,25
2022-03-11 05:35:51,1.7581481481481482,250,18124,5972,24096
2022-03-01 08:33:10,0.5194791666666667,1,16,17,33
2022-03-01 08:33:26,0.5199074074074074,1,20,20,40
2022-03-01 08:32:52,0.5199074074074074,1,5,5,10
2022-02-28 20:42:37,0.027060185185185184,1,1,1,2
2022-03-01 21:20:29,1.3965393518518519,2,84,19,103
2022-02-28 07:44:49,0.02021990740740741,1,1,1,2
2022-03-01 08:32:31,1.1709143518518519,1,3,3,6
2022-03-01 15:48:59,2.3848148148148147,3,441,110,551
2022-02-27 06:37:08,0.10239583333333334,1,5,3,8
2022-02-27 06:37:00,0.11310185185185186,1,6,3,9
2022-02-26 20:14:12,0.02971064814814815,5,32,14,46
2022-02-26 16:27:11,0.1144212962962963,1,1,1,2
2022-02-26 16:26:28,0.013449074074074073,1,2,0,2
2022-02-26 15:28:28,0.004456018518518519,1,2,1,3
2022-02-26 16:51:59,0.8615277777777778,1,76,40,116
2022-02-25 16:04:09,0.037766203703703705,1,1,1,2
2022-05-04 13:33:19,26.36638888888889,1,3,3,6
2022-03-09 12:32:28,12.48957175925926,1,1,1,2
2022-02-25 01:15:20,0.013726851851851851,1,1,1,2
2022-02-25 00:48:46,0.0038078703703703703,1,9,9,18
2022-02-25 00:48:08,0.004537037037037037,1,1,1,2
2022-02-24 13:46:21,0.11570601851851851,1,1,1,2
2022-02-24 16:28:23,0.9390856481481481,3,328,163,491
2022-02-23 20:37:03,0.02625,2,1,67,68
2022-02-23 18:30:13,0.005532407407407408,1,1,1,2
2022-03-01 09:38:36,3.891076388888889,250,17179,10825,28004
2022-02-25 00:16:53,1.3677546296296297,2,6,6,12
2022-02-24 23:51:01,1.3836111111111111,2,50,19,69
2022-02-23 15:44:17,0.12210648148148148,2,2,0,2
2022-02-23 15:51:09,0.13,1,1,1,2
2022-02-23 15:44:59,0.35347222222222224,1,1,1,2
2022-02-22 19:14:17,0.028969907407407406,1,14,14,28
2022-02-22 16:11:22,0.06746527777777778,1,24,8,32
2022-03-15 07:16:45,21.07865740740741,5,586,275,861
2022-02-22 14:27:08,0.38828703703703704,1,165,55,220
2022-02-22 14:27:25,0.42212962962962963,1,30,28,58
2022-02-22 05:20:04,0.05174768518518519,1,23,3,26
2022-03-09 12:36:03,15.686585648148148,1,5,5,10
2022-03-09 12:36:40,15.687997685185184,1,55,43,98
2022-03-09 12:32:13,15.685509259259259,1,27,27,54
2022-03-09 12:33:49,15.687233796296296,1,5,5,10
2022-03-09 12:33:19,15.687627314814815,1,13,5,18
2022-02-25 00:18:56,3.1777546296296295,1,3,3,6
2022-03-09 12:35:00,15.689733796296297,1,2,2,4
2022-02-21 13:55:38,0.07377314814814814,1,4,5,9
2022-02-23 13:13:09,4.366365740740741,176,8618,8135,16753
2022-02-19 02:12:28,0.07949074074074074,1,1,1,2
2022-02-18 19:21:21,0.03231481481481482,1,7,3,10
2022-02-18 19:43:42,0.07842592592592593,1,2,2,4
2022-02-18 12:51:51,0.13693287037037036,1,3,1,4
2022-02-19 04:23:07,1.3200810185185186,1,3,3,6
2022-02-16 20:44:19,0.005740740740740741,1,5,7,12
2022-02-16 20:44:48,0.021736111111111112,1,13,2,15
2022-02-16 13:57:57,0.04702546296296296,1,8,4,12
2022-02-16 13:28:45,0.04462962962962963,1,1,1,2
2022-02-16 12:14:53,23.05144675925926,1,13,0,13
2022-02-16 13:36:44,0.1441087962962963,2,13,20,33
2022-02-16 12:17:28,0.10241898148148149,1,2,2,4
2022-03-01 18:37:48,13.422326388888889,7,40,10,50
2022-02-23 19:03:46,7.827349537037037,4,1131,409,1540
2022-02-25 00:20:41,9.225243055555556,1,23,2,25
2022-02-16 13:37:26,1.160949074074074,1,10,5,15
2022-02-16 04:05:11,1.0805787037037038,1,1,1,2
2022-02-16 21:29:49,1.9919444444444445,4,9,6,15
2022-02-16 10:20:37,1.5927893518518519,1,7,7,14
2022-02-15 05:13:48,0.38005787037037037,1,53,53,106
2022-02-15 02:06:06,0.2497337962962963,1,2,120,122
2022-02-15 02:06:26,0.2501157407407407,1,7,7,14
2022-02-16 10:18:09,1.591875,1,3,3,6
2022-02-15 02:07:14,0.2522916666666667,1,10,10,20
2022-02-15 02:05:18,0.25127314814814816,1,5,5,10
2022-02-19 04:30:06,4.352777777777778,2,4,4,8
2022-02-15 02:07:42,0.25452546296296297,1,1,1,2
2022-02-14 15:08:23,0.11909722222222222,1,4,4,8
2022-02-14 15:08:03,0.1485300925925926,1,9,9,18
2022-02-14 15:07:05,0.32868055555555553,1,1,1,2
2022-02-13 01:52:34,0.02903935185185185,1,20,1,21
2022-02-12 18:52:17,0.05883101851851852,2,13,8,21
2022-02-12 18:00:33,0.03875,1,8,4,12
2022-05-26 13:50:33,102.88526620370371,13,205,17,222
2022-02-12 17:07:43,0.21755787037037036,1,11,7,18
2022-02-12 11:50:17,0.01892361111111111,1,1,1,2
2022-02-12 00:09:31,0.0777199074074074,1,3,3,6
2022-02-11 22:16:52,0.006006944444444444,1,1,1,2
2022-02-13 00:58:26,1.167349537037037,1,2,2,4
2022-02-12 00:08:23,0.13777777777777778,1,4,0,4
2022-02-11 13:52:08,0.16935185185185186,3,92,30,122
2022-02-19 04:20:00,4.239907407407407,250,16089,5432,21521
2022-02-11 02:59:13,0.043784722222222225,1,462,382,844
2022-02-11 02:59:27,0.046030092592592595,1,62,37,99
2022-02-10 21:00:10,0.031608796296296295,1,20,20,40
2022-02-10 18:42:45,0.04920138888888889,1,26,31,57
2022-02-11 01:49:31,0.4849537037037037,1,1,1,2
2022-02-12 23:05:22,0.016134259259259258,1,4,4,8
2022-02-12 23:04:32,0.015671296296296298,1,4,4,8
2022-02-13 11:21:10,0.5273958333333333,1,5,5,10
2022-02-11 20:16:23,1.2591203703703704,1,2,5,7
2022-02-10 13:57:11,0.06349537037037037,3,56,7,63
2022-02-10 13:26:55,0.11027777777777778,3,27,15,42
2022-02-10 14:28:53,0.616712962962963,1,2,2,4
2022-02-10 02:09:45,0.10553240740740741,1,2,5,7
2022-02-28 13:14:52,0.02869212962962963,1,3620,113,3733
2022-02-09 23:10:28,0.1989351851851852,1,4,14,18
2022-02-09 23:10:16,0.20605324074074075,1,23,3,26
2022-02-09 11:30:00,0.13592592592592592,1,23,1,24
2022-02-11 20:51:57,2.978923611111111,1,156,38,194
2022-02-08 21:23:05,0.04412037037037037,1,1,1,2
2022-02-09 03:15:38,0.29008101851851853,1,29,13,42
2022-02-11 13:52:46,2.788877314814815,1,15,7,22
2022-02-10 14:07:06,2.5152893518518518,1,1,1,2
2022-02-08 00:53:49,0.09490740740740741,1,19,14,33
2022-02-08 01:41:18,0.3381712962962963,2,239,349,588
2022-02-11 01:53:06,3.2402199074074076,1,89,35,124
2022-02-14 20:49:41,7.029826388888889,1,5,5,10
2022-02-12 11:21:56,4.6358449074074075,1,52,30,82
2022-02-11 02:59:31,0.044583333333333336,1,5,5,10
2022-02-11 01:50:45,3.2405671296296297,1,5,5,10
2022-02-11 01:53:51,3.2432754629629628,1,5,5,10
2022-02-11 01:54:20,3.243726851851852,1,5,5,10
2022-02-11 01:50:09,3.2409375,1,22,28,50
2022-02-12 11:50:50,1.3667476851851852,1,5,5,10
2022-02-10 14:11:42,2.5202314814814817,1,3,3,6
2022-02-07 18:57:06,0.017094907407407406,1,1,1,2
2022-02-08 01:34:56,0.341875,1,21,21,42
2022-02-07 16:06:44,0.21721064814814814,3,171,192,363
2022-02-07 12:14:48,0.10175925925925926,1,4,1,5
2022-02-06 14:31:04,0.015486111111111112,4,65,9,74
2022-02-05 16:29:54,0.5760532407407407,1,2,0,2
2022-02-10 14:11:16,5.419340277777778,1,1,1,2
2022-02-10 14:12:09,5.420347222222222,1,8,8,16
2022-02-10 14:10:47,5.420520833333334,1,1,1,2
2022-02-10 14:25:43,5.431643518518518,1,3,3,6
2022-02-10 14:12:33,5.422719907407408,1,1,1,2
2022-02-05 04:06:34,0.28844907407407405,1,14,12,26
2022-02-03 20:29:20,0.2695138888888889,1,1,1,2
2022-02-03 13:21:39,0.0006944444444444445,1,17,1,18
2022-02-24 23:34:14,22.115219907407408,7,18119,8247,26366
2022-02-03 13:09:05,1.0924537037037036,1,170,2,172
2022-02-03 13:07:43,59.23277777777778,1,9,5,14
2022-02-03 13:07:30,11.9715625,1,66,49,115
2022-02-01 19:57:39,0.02798611111111111,1,2,0,2
2022-02-01 16:34:49,0.01861111111111111,1,1,1,2
2022-02-01 19:57:50,0.872650462962963,1,1,1,2
2022-02-05 04:02:43,4.328993055555555,1,5,5,10
2022-02-05 04:03:06,4.331168981481482,1,25,19,44
2022-02-10 14:09:06,9.752847222222222,1,3,3,6
2022-02-05 04:03:13,4.332881944444445,1,1,1,2
2022-02-05 04:02:58,4.333599537037037,1,4,4,8
2022-02-12 23:00:26,0.01326388888888889,1,12,12,24
2022-03-12 08:23:54,29.759525462962962,2,5,5,10
2022-02-11 21:20:19,11.07474537037037,3,106,11,117
2022-02-07 17:16:32,6.958078703703704,2,170,13,183
2022-01-31 20:27:40,0.45199074074074075,1,30,1,31
2022-01-30 23:32:03,0.005486111111111111,1,1,1,2
2022-01-30 21:34:54,0.02710648148148148,1,1,1,2
2022-01-30 22:49:52,0.20950231481481482,1,2,2,4
2022-01-30 20:38:54,0.1583101851851852,2,53,4,57
2022-01-30 22:50:08,0.2764583333333333,1,219,1,220
2022-02-09 00:17:07,10.959537037037038,3,628,140,768
2022-01-27 23:46:43,0.2645601851851852,2,187,185,372
2022-01-28 13:24:38,1.0888310185185186,1,28,0,28
2022-01-27 23:43:56,1.026550925925926,2,25,22,47
2022-01-26 19:53:50,0.005115740740740741,1,1,1,2
2022-01-27 17:13:42,0.9112152777777778,1,15,0,15
2022-01-26 17:05:40,0.901875,1,97,35,132
2022-01-25 11:46:52,0.006493055555555556,1,3,3,6
2022-01-25 11:45:45,0.005914351851851852,1,4,4,8
2022-01-25 11:44:01,0.005902777777777778,1,22,23,45
2022-01-26 17:08:50,1.2619907407407407,1,3,0,3
2022-02-14 20:27:53,20.905231481481483,6,1268,149,1417
2022-01-25 11:52:40,0.004814814814814815,1,5,5,10
2022-01-25 11:34:55,0.6444675925925926,1,19,49,68
2022-01-25 11:39:43,0.6487384259259259,1,24,11,35
2022-01-25 11:48:05,0.6547222222222222,1,4,4,8
2022-01-25 12:22:51,0.6798148148148148,1,3,3,6
2022-01-27 11:26:18,2.6408680555555555,1,7,7,14
2022-01-25 12:23:42,0.680775462962963,1,5,5,10
2022-01-25 12:25:27,0.6820601851851852,1,5,5,10
2022-01-25 12:22:10,0.029131944444444443,1,3,3,6
2022-01-27 11:26:40,2.642662037037037,1,3,3,6
2022-03-03 15:14:44,38.99539351851852,4,37,14,51
2022-01-24 02:29:03,0.1645601851851852,1,2,0,2
2022-01-25 11:41:23,3.4343287037037036,1,3,3,6
2022-01-20 19:56:21,0.22319444444444445,1,3,1,4
2022-01-20 13:51:24,0.019004629629629628,1,1,1,2
2022-01-20 12:37:31,0.026539351851851852,2,12,0,12
2022-01-19 22:06:00,0.0019444444444444444,1,1,1,2
2022-01-19 21:50:01,0.0014814814814814814,1,1,1,2
2022-01-19 03:08:46,0.060162037037037035,1,1,1,2
2022-01-25 11:39:09,6.40625,1,4,4,8
2022-01-19 01:53:03,0.5109375,1,2,2,4
2022-02-09 23:15:30,14.193668981481482,3,891,129,1020
2022-01-19 01:53:13,0.507974537037037,1,5,5,10
2022-01-18 13:38:12,0.7286111111111111,1,122,70,192
2022-01-19 02:01:18,1.2467939814814815,1,5,5,10
2022-01-19 01:53:26,0.5061689814814815,1,7,15,22
2022-01-18 13:38:45,0.7315162037037037,1,5,5,10
2022-01-18 13:38:55,0.7318402777777778,1,1,1,2
2022-01-19 02:03:28,1.2490625,1,4,4,8
2022-01-19 02:04:11,1.2496875,1,3,3,6
2022-01-18 13:39:12,0.7324074074074074,1,31,25,56
2022-01-18 13:36:40,0.7320717592592593,1,1,1,2
2022-01-19 02:06:17,0.5202314814814815,1,5,5,10
2022-01-18 13:36:22,0.7327546296296297,1,3,3,6
2022-01-17 10:59:46,0.11945601851851852,1,1,1,2
2022-01-16 19:57:37,0.017407407407407406,1,1,1,2
2022-01-24 12:14:27,10.65324074074074,1,1,1,2
2022-01-23 14:52:58,9.985474537037037,4,71,49,120
2022-01-23 14:50:42,9.983900462962962,1,0,21,21
2022-01-18 13:36:11,5.138020833333333,1,3,3,6
2022-01-19 01:53:39,0.5087268518518518,1,2,99,101
2022-01-18 13:35:31,7.728969907407407,1,341,255,596
2022-01-19 02:04:24,0.5161226851851852,1,7,7,14
2022-01-19 02:04:34,8.250520833333333,1,9,9,18
2022-01-18 13:35:16,7.730590277777778,1,1,1,2
2022-01-18 13:35:02,7.730601851851852,1,1,1,2
2022-01-10 13:25:24,0.03733796296296296,1,1,1,2
2022-01-10 13:25:08,0.05846064814814815,1,4,1,5
2022-01-09 02:21:19,0.11686342592592593,1,2,4,6
2022-01-07 18:50:12,0.12446759259259259,2,45,43,88
2022-01-06 01:27:30,0.021319444444444443,1,1,1,2
2022-01-19 02:07:37,0.009247685185185185,1,3,3,6
2022-01-06 01:35:42,0.0052662037037037035,1,4,4,8
2022-01-23 12:53:58,17.881354166666668,1,9,0,9
2022-01-16 15:55:41,11.049756944444445,1,1,0,1
2022-01-06 01:25:22,0.007210648148148148,1,8,15,23
2022-01-06 01:25:52,0.008252314814814815,1,28,146,174
2022-01-06 01:11:25,0.008287037037037037,1,5,5,10
2022-01-06 00:58:12,2.197766203703704,1,5,14,19
2022-01-06 01:25:38,0.015486111111111112,1,42,42,84
2022-01-06 00:56:33,2.198935185185185,1,15,32,47
2022-01-06 01:35:23,0.0036689814814814814,1,15,22,37
2022-01-06 00:56:21,2.2012152777777776,1,5,14,19
2022-01-06 00:55:17,2.200717592592593,1,555,393,948
2022-01-06 01:10:00,0.00730324074074074,1,13,51,64
2022-01-06 01:26:53,0.023449074074074074,1,5,5,10
2022-01-06 01:01:31,0.0053125,1,3,3,6
2022-01-27 11:25:19,1.9580208333333333,1,4,4,8
2022-01-06 01:14:35,0.0096875,1,5,5,10
2022-01-19 02:12:02,0.004606481481481481,1,7,10,17
2022-01-13 11:05:22,12.101631944444444,1,3,3,6
2021-12-30 07:41:09,0.07489583333333333,1,1,0,1
2022-02-11 21:23:20,43.65978009259259,2,2,2,4
2021-12-28 22:25:51,0.29824074074074075,1,1,1,2
2022-02-11 14:01:40,45.18025462962963,11,17625,9045,26670
2022-01-17 08:41:33,20.118402777777778,1,1213,591,1804
2022-01-06 01:28:19,0.019444444444444445,1,5,5,10
2022-01-06 00:54:51,9.20119212962963,1,5,14,19
2022-01-06 00:54:38,9.20244212962963,1,10,10,20
2022-01-06 00:51:47,9.201273148148148,1,7,7,14
2022-01-18 13:34:46,12.528773148148149,1,2,2,4
2022-01-23 14:46:30,26.986863425925925,3,51,21,72
2021-12-25 21:52:24,0.37840277777777775,1,2,2,4
2021-12-26 18:22:05,2.967037037037037,2,4,4,8
2021-12-25 21:55:06,2.070451388888889,6,84,96,180
2021-12-22 03:34:12,0.18144675925925927,3,3,0,3
2021-12-21 01:12:18,0.02079861111111111,1,5,5,10
2021-12-21 01:55:39,0.04857638888888889,1,5,5,10
2021-12-21 00:39:21,0.005451388888888889,1,88,99,187
2021-12-21 01:11:25,0.01880787037037037,1,5,5,10
2021-12-21 01:11:48,0.018958333333333334,1,332,326,658
2021-12-21 01:11:05,0.018773148148148146,1,25,54,79
2021-12-21 00:38:54,0.00474537037037037,1,40,40,80
2021-12-21 00:38:06,0.00787037037037037,1,1,1,2
2021-12-21 01:10:46,0.020613425925925927,1,1,1,2
2021-12-21 01:54:54,0.02736111111111111,1,8,39,47
2021-12-21 00:38:29,0.0038657407407407408,1,79,23,102
2021-12-21 01:09:35,0.017326388888888888,1,11,11,22
2021-12-21 02:28:00,0.07894675925925926,1,51,26,77
2021-12-21 00:37:42,0.006967592592592593,1,3,3,6
2022-01-25 11:34:37,6.392939814814815,2,56,56,112
2021-12-21 00:37:25,0.006574074074074074,1,3,3,6
2021-12-21 00:36:53,0.006331018518518519,1,1,1,2
2021-12-21 00:36:36,0.0060185185185185185,1,2,2,4
2021-12-21 00:22:58,0.18172453703703703,1,3,3,6
2021-12-21 01:58:59,0.05416666666666667,1,3,3,6
2021-12-20 23:17:14,0.27184027777777775,1,1,1,2
2022-03-26 01:52:51,99.86321759259259,3,22,21,43
2021-12-21 01:09:09,0.016655092592592593,1,2,89,91
2021-12-21 00:24:34,7.179675925925926,1,12,5,17
2021-12-21 00:23:59,7.179791666666667,1,143,143,286
2021-12-21 00:23:29,7.180509259259259,1,1,1,2
2021-12-21 00:22:27,7.180891203703704,1,2,2,4
2021-12-13 22:21:14,0.42313657407407407,1,51,4,55
2021-12-13 17:25:25,0.21472222222222223,1,3,3,6
2022-02-24 23:34:33,73.7366550925926,2,727,63,790
2021-12-13 04:32:29,0.0005324074074074074,1,1,1,2
2021-12-25 21:55:31,17.047662037037036,3,18,18,36
2021-12-21 00:17:16,14.173217592592593,1,5,5,10
2021-12-21 00:19:51,14.177881944444444,1,24,12,36
2021-12-21 00:19:29,14.17806712962963,1,6,6,12
2021-12-21 00:17:45,14.177604166666667,1,1,1,2
2021-12-06 17:04:04,0.11503472222222222,2,2,0,2
2021-12-05 20:50:12,0.05466435185185185,1,1,1,2
2021-12-04 14:53:26,0.007291666666666667,1,11,6,17
2021-12-04 14:53:39,0.007476851851851852,1,403,369,772
2021-12-17 22:00:05,14.153645833333334,1,8,5,13
2021-12-01 18:03:36,0.049652777777777775,1,0,6,6
2021-12-05 20:49:50,5.865590277777778,2,10,6,16
2021-12-04 14:39:19,4.770532407407408,1,5,43,48
2021-12-04 14:39:00,4.7709375,1,5,43,48
2021-12-04 14:38:38,4.771898148148148,1,83,67,150
2021-12-04 14:40:20,4.774039351851852,1,5,43,48
2021-12-04 14:41:41,4.7753703703703705,1,5,43,48
2021-12-04 14:41:12,4.775543981481482,1,5,43,48
2021-11-29 16:39:40,0.4546527777777778,1,2,2,4
2021-12-12 05:09:15,14.920520833333333,7,194,84,278
2021-11-28 22:13:08,1.582824074074074,1,7,4,11
2021-11-27 02:06:40,1.0037962962962963,1,1,1,2
2021-11-26 21:03:35,0.026712962962962963,1,3,3,6
2021-11-26 21:04:09,0.26993055555555556,1,12,4,16
2021-11-26 21:09:12,0.31039351851851854,1,2,1,3
2021-11-26 21:11:09,0.36694444444444446,1,10,9,19
2021-11-26 21:08:48,9.649803240740741,2,68,28,96
2021-11-26 07:30:02,0.035173611111111114,1,7,7,14
2021-11-26 07:29:53,0.17724537037037036,1,7,1,8
2021-11-29 06:19:00,3.0483333333333333,1,5,5,10
2021-11-29 06:19:22,3.0498842592592594,1,3,3,6
2021-11-26 04:58:18,0.19961805555555556,1,25,1215,1240
2021-11-26 00:12:39,0.013055555555555556,1,10,2,12
2021-11-25 22:46:31,18.40181712962963,1,57,3,60
2021-11-25 22:46:40,17.20900462962963,1,3,3,6
2021-11-24 19:29:06,0.027685185185185184,1,2,2,4
2021-11-24 16:41:04,0.1673611111111111,2,32,1,33
2021-11-22 23:15:31,0.011909722222222223,1,30,0,30
2021-11-26 05:01:31,3.369675925925926,1,5,5,10
2021-12-21 01:57:25,28.242013888888888,1,31,15,46
2021-11-26 05:01:54,3.3703125,1,5,5,10
2021-11-29 06:18:42,3.0497569444444443,1,107,39,146
2021-11-29 06:41:18,3.0672569444444444,2,253,121,374
2021-11-26 05:06:12,3.376747685185185,1,5,5,10
2021-11-26 05:06:24,3.3775810185185184,1,1,1,2
2021-11-24 19:24:09,2.6491435185185184,1,11,11,22
2021-11-19 17:21:38,0.055949074074074075,1,1,2,3
2021-11-19 17:22:49,0.1367013888888889,1,1,0,1
2021-12-05 20:48:39,20.728784722222223,1,311,277,588
2021-11-18 00:44:08,0.01734953703703704,1,3,3,6
2021-11-18 00:44:24,0.018229166666666668,1,5,5,10
2021-11-16 20:42:14,0.00020833333333333335,1,1,0,1
2021-11-16 20:36:29,0.10201388888888889,1,1,1,2
2021-11-18 00:08:11,2.167615740740741,1,9,9,18
2021-11-18 00:07:56,2.1675925925925927,1,5,5,10
2021-11-18 00:42:12,0.015520833333333333,1,33,32,65
2021-11-18 00:07:15,2.1688425925925925,1,45,47,92
2021-11-18 00:06:59,2.1691087962962965,1,4,4,8
2021-11-18 00:06:40,2.169513888888889,1,5,5,10
2021-11-18 00:06:27,2.1703125,1,4,4,8
2021-11-14 20:55:40,0.25353009259259257,1,3,1,4
2021-11-18 20:59:57,4.505787037037037,7,12,10,22
2021-11-14 05:11:06,0.0003125,1,5,6,11
2021-11-13 22:07:13,0.6301851851851852,1,3,1,4
2021-11-13 02:30:28,0.30539351851851854,1,1,1,2
2021-11-11 13:00:31,0.15311342592592592,1,3,3,6
2021-11-12 04:18:29,1.5581712962962964,3,36,2,38
2021-11-26 21:12:27,17.51101851851852,2,8,3,11
2021-11-13 09:51:42,4.573171296296296,1,5,5,10
2021-11-13 09:51:07,4.572881944444444,1,5,5,10
2021-11-13 09:48:34,4.572708333333333,1,3,3,6
2021-11-13 09:46:15,4.571134259259259,1,10,10,20
2021-11-13 09:49:38,4.5736689814814815,1,5,5,10
2021-11-13 09:36:28,4.565011574074074,1,9,9,18
2021-11-13 09:35:52,4.564768518518519,1,1,1,2
2021-11-18 00:20:32,0.004803240740740741,1,7,6,13
2021-11-13 09:34:29,4.5646759259259255,1,6,6,12
2021-11-13 09:34:00,4.564641203703704,1,1,1,2
2021-11-18 20:59:34,10.304293981481482,3,3,3,6
2022-01-16 23:49:55,70.20952546296296,3,168,32,200
2022-02-23 15:45:22,108.44423611111111,1,73,65,138
2021-11-06 16:13:51,0.3716087962962963,2,2,2,4
2021-11-18 21:00:27,12.58537037037037,4,5,3,8
2021-12-26 23:47:20,50.79291666666666,1,6,6,12
2021-11-06 04:32:15,0.22400462962962964,2,50,2,52
2021-11-05 23:13:58,14.263460648148149,1,37,11,48
2021-11-05 23:12:25,0.08341435185185185,1,86,12,98
2021-11-05 20:14:35,0.009305555555555555,1,27,1,28
2021-11-18 21:00:39,13.808379629629629,1,4,2,6
2021-11-05 22:23:06,1.1953125,1,260,52,312
2021-11-04 14:49:36,0.6085185185185186,1,1,1,2
2021-11-02 12:26:56,0.6760185185185185,1,5,5,10
2021-11-02 12:30:11,0.6792361111111112,1,5,5,10
2021-11-02 12:23:01,0.6744907407407408,1,5,5,10
2021-11-02 12:22:46,0.6745138888888889,1,27,12,39
2021-11-02 12:26:32,0.6777083333333334,1,5,5,10
2021-11-02 12:39:29,0.009675925925925926,1,81,35,116
2021-11-02 12:57:45,0.010868055555555556,1,35,35,70
2021-11-02 12:22:01,0.676724537037037,1,156,88,244
2021-11-02 12:52:51,0.0071875,1,21,21,42
2021-11-02 13:15:46,0.009756944444444445,1,346,545,891
2021-11-02 12:27:13,0.6823263888888889,1,5,5,10
2021-11-02 12:25:57,0.6835185185185185,1,1,1,2
2021-11-25 12:07:38,25.517511574074074,5,2541,1129,3670
2021-11-18 21:02:09,104.50307870370371,5,140,149,289
2021-10-28 17:30:45,0.05619212962962963,1,1,0,1
2021-10-28 01:44:57,0.013159722222222222,1,1,1,2
2021-10-28 03:29:50,0.11337962962962964,1,11,6,17
2022-01-23 15:01:25,89.13881944444445,1,6,6,12
2021-12-17 22:00:41,52.44034722222222,1,11,1,12
2021-11-18 21:01:32,24.466585648148147,2,12,10,22
2021-10-28 01:44:28,0.007835648148148149,1,5,5,10
2021-10-28 01:26:58,2.2230902777777777,1,5,5,10
2021-10-28 01:27:32,2.224675925925926,1,18,18,36
2021-10-28 01:25:12,2.2233912037037036,1,1,1,2
2021-10-28 01:24:57,2.2234606481481483,1,5,5,10
2021-10-28 01:24:21,2.2231597222222224,1,5,5,10
2021-10-28 01:21:17,2.221365740740741,1,1,1,2
2021-10-28 01:20:43,2.2216666666666667,1,8,8,16
2021-10-28 01:20:19,2.221597222222222,1,6,4,10
2021-10-25 14:34:16,0.07611111111111112,1,19,2,21
2021-10-24 15:20:04,0.23607638888888888,2,9,2,11
2021-10-21 18:39:35,0.06331018518518519,2,52,1,53
2021-10-21 04:24:34,0.1317824074074074,5,16,4,20
2021-10-20 02:35:48,0.07224537037037038,1,2,85,87
2021-10-20 00:47:45,1.193136574074074,1,38,134,172
2021-10-20 01:07:47,1.2083101851851852,1,5,5,10
2021-10-20 01:08:04,1.2089930555555555,1,10,10,20
2021-10-20 01:36:07,1.2287152777777777,1,5,5,10
2021-10-20 02:03:25,0.04252314814814815,1,343,304,647
2021-10-20 00:49:08,1.1972685185185186,1,53,12,65
2021-10-20 01:23:04,0.007199074074074074,1,7,7,14
2021-10-20 01:08:36,1.2120949074074074,1,11,16,27
2021-10-20 01:08:48,1.2125347222222222,1,1,1,2
2021-10-20 01:09:14,1.2136805555555557,1,1,1,2
2021-10-20 00:49:37,1.2002777777777778,1,3,3,6
2021-10-20 00:46:55,1.1985532407407407,1,1,1,2
2021-10-18 16:29:04,0.045092592592592594,1,22,0,22
2021-10-25 14:32:28,7.028784722222222,1,8,7,15
2021-10-18 10:02:35,1.163275462962963,4,113,13,126
2021-10-18 10:04:42,0.371400462962963,1,4,1,5
2021-10-17 18:12:33,0.14105324074074074,1,0,6,6
2021-10-18 10:05:25,0.9351851851851852,3,121,224,345
2022-02-11 03:50:27,16.508391203703702,250,25572,11592,37164
2021-11-17 06:57:02,32.7778125,4,7,6,13
2021-10-14 20:20:38,0.012256944444444445,1,3,3,6
2021-10-14 18:51:56,2.039409722222222,1,1,1,2
2021-10-13 02:59:32,0.500150462962963,1,22,5,27
2021-10-13 10:18:19,1.5885185185185184,1,5,5,10
2021-10-13 10:21:49,1.59125,1,11,11,22
2021-10-13 10:29:50,1.5977199074074073,1,8,13,21
2021-10-14 18:58:38,2.9526273148148148,1,5,5,10
2021-10-14 19:37:22,1.377974537037037,1,34,29,63
2021-10-14 19:42:27,2.9848032407407405,1,13,13,26
2021-10-14 19:37:40,1.3767824074074073,1,19,27,46
2021-10-14 19:36:57,2.981122685185185,1,2,2,4
2021-10-14 19:36:13,2.9808564814814815,1,2,2,4
2021-10-13 10:18:47,1.5938657407407408,1,53,21,74
2021-10-15 14:24:27,0.7819328703703704,2,4,4,8
2021-10-14 19:36:38,2.9815046296296295,1,1,1,2
2021-10-13 10:26:30,1.5996643518518519,1,1,1,2
2021-10-14 18:55:22,2.9537962962962965,1,1,1,2
2021-10-13 10:21:09,1.5974074074074074,1,1,1,2
2021-10-14 18:45:00,4.76431712962963,1,1655,262,1917
2021-10-13 10:19:50,3.9828819444444443,1,50,96,146
2021-10-14 19:38:21,1.378611111111111,1,291,337,628
2021-10-13 03:02:55,5.642164351851852,1,1,1,2
2021-10-06 13:49:33,0.07496527777777778,2,31,4,35
2021-10-09 10:37:14,4.600543981481482,1,5,5,10
2021-10-09 10:42:22,4.60494212962963,1,10,10,20
2021-10-09 10:37:44,4.60244212962963,1,28,124,152
2021-10-09 10:37:56,4.604629629629629,1,5,5,10
2021-10-13 10:15:35,3.977002314814815,1,6,6,12
2021-10-09 10:38:42,4.606805555555556,1,5,5,10
2021-10-09 10:38:58,4.6085416666666665,1,1,1,2
2021-10-09 10:42:40,4.611840277777778,1,6,6,12
2021-10-09 10:39:16,4.609733796296296,1,1,1,2
2021-09-30 03:17:33,0.5915046296296296,1,380,317,697
2021-09-30 03:19:08,0.9261689814814815,1,2,2,4
2021-09-30 03:26:29,1.392488425925926,2,30,1,31
2021-10-14 17:59:22,16.19181712962963,2,31,24,55
2021-09-29 12:54:41,1.694375,1,5,5,10
2021-10-09 10:43:04,9.902997685185186,1,5,5,10
2021-09-29 12:54:56,1.6955671296296295,1,5,5,10
2021-09-29 12:55:23,1.6970138888888888,1,40,11,51
2021-09-29 12:55:37,1.6978472222222223,1,5,5,10
2021-09-29 12:55:51,1.6983449074074075,1,12,7,19
2021-09-29 13:03:12,1.705324074074074,1,79,6,85
2021-09-30 03:17:46,0.5934490740740741,1,5,5,10
2021-09-29 12:56:19,1.7015972222222222,1,14,2,16
2021-09-29 12:56:40,1.7032175925925925,1,1,1,2
2021-09-29 13:00:33,1.7066550925925925,1,1,1,2
2021-09-29 13:00:53,1.7072106481481482,1,3,3,6
2021-09-29 13:01:15,1.7081828703703703,1,1,1,2
2021-09-29 13:01:30,1.7086805555555555,1,1,1,2
2021-09-27 05:24:04,0.4026736111111111,2,4,4,8
2021-09-27 05:23:48,0.5292824074074074,5,53,37,90
2021-09-26 11:23:28,3.464837962962963,1,46,31,77
2021-10-13 13:27:20,22.056689814814813,5,110,46,156
2021-09-21 04:36:36,0.11831018518518518,1,3,3,6
2021-09-29 13:03:43,8.707280092592592,1,3,3,6
2021-09-29 13:02:20,8.706747685185185,1,1,1,2
2021-09-29 13:03:59,8.708217592592593,1,4,4,8
2021-09-29 13:02:47,8.708263888888888,1,1,1,2
2021-10-09 10:39:56,18.61045138888889,1,3,3,6
2021-09-19 09:14:36,0.14596064814814816,1,1,1,2
2021-09-20 00:23:44,0.8368287037037037,1,1,1,2
2021-09-15 16:51:17,1.0661342592592593,1,5,3,8
2021-09-19 05:42:48,5.397569444444445,1,21,40,61
2021-09-19 05:43:56,5.398703703703704,1,5,24,29
2021-09-19 05:43:39,5.398831018518519,1,5,24,29
2021-09-19 05:43:29,5.399305555555555,1,5,24,29
2021-09-19 10:07:07,0.17434027777777777,1,2,107,109
2021-09-19 05:43:15,5.400763888888889,1,389,303,692
2021-09-19 05:43:03,4.867581018518519,1,3,3,6
2021-09-14 12:14:26,0.13939814814814816,1,3,3,6
2021-09-14 08:52:53,0.5352199074074074,1,3,3,6
2021-09-14 08:52:20,0.5350925925925926,1,5,5,10
2021-09-13 16:59:38,0.03920138888888889,2,7,14,21
2021-09-13 16:59:56,2.939224537037037,1,16,1,17
2021-09-29 21:52:37,19.313460648148148,11,115,215,330
2021-09-10 13:43:28,0.024872685185185185,1,3,2,5
2021-09-08 21:33:37,1.2333796296296295,1,1,1,2
2021-09-09 08:36:14,2.515972222222222,1,137,196,333
2021-09-10 00:24:55,0.6563078703703704,1,23,16,39
2021-09-09 08:41:26,2.5207291666666665,1,5,5,10
2021-09-09 08:41:47,2.521284722222222,1,10,10,20
2021-09-09 08:41:03,2.5213657407407406,1,5,5,10
2021-09-09 08:42:39,2.523912037037037,1,5,5,10
2021-09-10 00:24:40,0.6502662037037037,1,121,95,216
2021-09-09 08:43:01,2.5269097222222223,1,2,2,4
2021-09-09 08:40:14,2.5250462962962965,1,12,12,24
2021-09-09 08:39:49,2.5255092592592594,1,1,1,2
2021-09-09 08:39:21,2.5260069444444446,1,11,11,22
2021-09-19 05:44:27,4.727951388888889,1,3,3,6
2021-09-08 21:33:23,2.1291087962962965,1,23,11,34
2022-01-19 21:37:28,137.01253472222223,9,1479,638,2117
2021-09-13 17:03:14,9.098391203703704,1,1,1,2
2021-09-04 14:44:50,3.0575,1,1,1,2
2021-09-01 20:06:40,0.30818287037037034,1,19,1,20
2021-10-14 17:59:28,43.24349537037037,6,15,9,24
2021-12-17 22:01:21,108.13518518518518,2,121,7,128
2021-08-31 23:18:29,0.27143518518518517,1,3,3,6
2021-08-31 23:18:56,1.1336689814814815,1,6,5,11
2021-08-31 11:55:49,0.659699074074074,1,5,5,10
2021-08-31 11:58:35,0.6628587962962963,1,4,4,8
2021-09-19 05:42:32,19.401979166666667,2,3,5,8
2021-08-31 11:56:01,0.6629282407407407,1,6,6,12
2021-08-31 11:56:08,0.6631712962962963,1,1,1,2
2021-08-31 11:56:14,0.6634606481481482,1,4,4,8
2021-08-29 00:00:58,0.31877314814814817,1,5,5,10
2021-08-29 00:00:41,0.31416666666666665,1,18,26,44
2021-08-28 16:18:58,0.6389351851851852,1,3,3,6
2021-08-28 16:18:36,0.63875,1,3,3,6
2021-08-28 16:15:05,0.6363310185185185,1,3,3,6
2021-08-25 16:41:24,1.3612037037037037,1,3,0,3
2021-08-25 15:40:57,1.3303472222222221,1,1,1,2
2021-10-14 19:11:14,51.68358796296296,2,10,10,20
2021-08-25 15:46:30,1.6677199074074074,1,5,1,6
2021-10-14 19:01:27,223.37488425925926,1,4,4,8
2021-08-25 16:39:55,1.8577546296296297,1,58,58,116
2021-08-27 12:46:29,3.6969444444444446,1,1,1,2
2021-08-27 12:47:43,3.697962962962963,1,3,3,6
2021-08-27 23:59:46,0.4663657407407407,1,1,1,2
2021-08-27 12:47:00,3.697800925925926,1,3,3,6
2021-12-17 22:02:14,116.38859953703704,2,128,2,130
2021-10-14 18:53:11,52.33108796296296,1,1,1,2
2021-08-20 14:11:58,0.09251157407407408,1,4,4,8
2021-08-23 13:03:38,3.1302083333333335,1,10,10,20
2021-08-23 13:03:53,3.1304861111111113,1,34,33,67
2021-08-20 09:54:12,0.08523148148148148,1,4,4,8
2021-08-20 07:15:07,0.6508101851851852,1,1,0,1
2021-08-20 06:40:33,1.6178356481481482,2,2,1,3
2021-08-20 09:53:33,1.8096759259259259,2,220,0,220
2021-08-20 09:48:25,3.222638888888889,1,5,5,10
2021-08-20 09:48:39,3.2549074074074076,1,3,3,6
2021-08-20 09:47:46,3.2391550925925925,1,1,1,2
2021-08-17 04:58:07,0.05872685185185185,1,3,3,6
2021-08-17 03:31:14,0.30952546296296296,1,5,5,10
2021-08-17 03:40:18,0.316087962962963,1,5,5,10
2021-08-17 04:01:31,0.3310532407407407,1,2,2,4
2021-08-17 04:19:31,0.3436458333333333,1,5,5,10
2021-08-17 04:00:05,0.33037037037037037,1,1,1,2
2021-08-17 04:19:51,0.34424768518518517,1,5,5,10
2021-08-17 04:00:17,0.33122685185185186,1,5,5,10
2021-08-17 03:49:59,0.32436342592592593,1,1,1,2
2021-08-17 03:49:21,0.32407407407407407,1,4,4,8
2021-08-17 04:00:37,0.3320486111111111,1,1,1,2
2021-08-17 04:00:53,0.33287037037037037,1,1,1,2
2021-08-25 20:52:41,10.136412037037037,4,157,36,193
2021-08-20 06:39:37,5.967905092592592,1,1,0,1
2022-08-25 21:27:10,379.1467361111111,1,1,0,1
2021-08-11 14:40:55,0.02494212962962963,2,6,1,7
2021-08-17 03:58:37,6.225740740740741,1,3,3,6
2021-08-17 04:20:21,7.339548611111111,1,18,18,36
2021-08-23 13:03:23,6.391354166666667,1,5,5,10
2021-08-17 03:30:54,7.309976851851852,1,14,62,76
2021-08-17 03:49:00,7.322997685185185,1,4,4,8
2021-08-17 03:41:01,7.3178935185185185,1,5,5,10
2021-08-17 03:32:29,7.313159722222222,1,1,1,2
2021-08-09 11:33:20,0.13467592592592592,1,5,1,6
2021-08-08 13:28:57,0.2148263888888889,1,1,1,2
2021-08-09 18:46:57,1.5531481481481482,1,5,8,13
2021-08-08 13:29:57,0.3521064814814815,4,31,2,33
2021-08-07 08:49:05,0.1896875,1,112,54,166
2021-08-08 13:31:02,15.910393518518518,1,2,2,4
2021-08-06 10:14:14,0.2577662037037037,1,11,1,12
2021-08-11 15:49:10,5.966527777777777,3,14,24,38
2021-08-11 15:48:56,6.0010763888888885,1,2,1,3
2021-08-05 11:05:32,0.21180555555555555,1,2,2,4
2021-10-14 18:59:42,70.88041666666666,1,2,10,12
2021-08-07 03:59:54,3.339826388888889,1,3,3,6
2021-08-07 04:01:06,4.329780092592593,1,1,1,2
2021-08-07 04:00:49,4.329907407407408,1,3,3,6
2021-08-07 04:01:32,4.331261574074074,1,3,3,6
2021-08-07 04:01:59,4.3325810185185185,1,5,5,10
2021-08-07 04:10:28,4.339606481481481,1,8,8,16
2021-10-14 19:00:38,73.6679861111111,1,1,0,1
2021-08-02 07:52:26,1.0008449074074075,1,1,1,2
2021-08-02 14:28:03,1.503414351851852,1,124,96,220
2021-08-07 04:10:48,4.56974537037037,1,5,5,10
2021-08-02 14:28:16,1.5062037037037037,1,122,99,221
2021-10-14 19:02:54,76.33416666666666,1,2,0,2
2021-08-26 14:51:22,29.440590277777776,1,6,2,8
2021-08-01 02:12:01,5.248796296296296,1,16,11,27
2021-08-01 02:09:51,5.248344907407407,1,5,5,10
2021-08-01 02:09:33,5.249236111111111,1,58,46,104
2021-08-01 02:10:09,5.250729166666667,1,5,5,10
2021-08-01 02:13:08,5.254814814814814,1,5,5,10
2021-08-01 02:11:37,5.25412037037037,1,38,27,65
2021-08-01 02:13:42,5.256805555555555,1,3,3,6
2021-08-01 02:26:30,5.266157407407407,1,5,5,10
2021-08-01 02:26:50,5.266770833333333,1,1,1,2
2021-08-01 02:27:13,5.267280092592593,1,1,1,2
2021-08-01 02:13:57,5.258460648148148,1,3,3,6
2021-07-24 12:41:46,0.0347337962962963,1,1,1,2
2021-08-09 21:11:50,18.375520833333333,17,1412,128,1540
2022-02-13 23:17:09,207.57774305555554,4,51,18,69
2021-07-23 00:53:17,2.529027777777778,1,2,2,4
2021-07-24 23:13:47,4.6817013888888885,1,5,1,6
2021-07-20 13:24:02,0.7189351851851852,1,10,10,20
2021-07-20 13:24:16,0.7242592592592593,1,2,2,4
2021-07-24 23:14:43,5.7238541666666665,4,149,76,225
2022-12-15 16:37:05,646.2314583333333,1,8,9,17
2021-07-17 15:06:52,0.07325231481481481,1,4,0,4
2021-10-14 19:09:56,90.38365740740741,2,9,6,15
2021-08-11 15:48:43,26.370613425925924,2,50,39,89
2021-10-14 19:04:57,91.05925925925926,1,15,18,33
2021-07-15 13:56:58,0.07736111111111112,1,5,30,35
2021-07-14 03:35:50,0.3560185185185185,2,7,3,10
2021-07-14 03:36:24,0.4015856481481481,1,3,3,6
2021-07-13 14:02:15,0.007349537037037037,1,2,2,4
2021-07-20 13:24:41,6.981539351851852,1,7,7,14
2021-07-13 13:45:17,0.046886574074074074,3,126,203,329
2021-07-20 13:24:57,7.723923611111111,1,2,2,4
2021-07-20 13:25:09,7.725173611111111,1,3,3,6
2021-07-13 13:46:21,1.2125231481481482,3,1349,1610,2959
2021-07-11 10:57:31,0.3493981481481481,1,1,1,2
2021-07-11 09:01:38,0.5116203703703703,1,21,0,21
2021-07-20 13:25:19,6.983333333333333,1,5,5,10
2021-07-10 15:58:41,0.015833333333333335,1,30,2,32
2021-07-09 23:29:27,2.0422337962962964,1,2,6,8
2021-07-10 16:08:40,2.4374074074074072,1,10,10,20
2021-07-10 16:08:54,2.438159722222222,1,1,1,2
2021-07-07 19:12:43,0.1913425925925926,1,33,0,33
2021-07-08 05:34:32,2.3923958333333335,1,5,5,10
2021-07-08 05:35:20,2.3951736111111113,1,3,3,6
2021-07-08 05:35:34,2.3958333333333335,1,1,1,2
2021-07-08 05:35:46,2.3963657407407406,1,1,1,2
2021-07-08 05:37:07,2.398125,1,1,1,2
2021-07-08 05:37:18,2.400162037037037,1,1,1,2
2021-07-07 19:13:09,2.1558217592592595,1,44,33,77
2021-07-05 17:16:06,0.0961111111111111,1,1,0,1
2021-07-05 17:16:22,0.23733796296296297,1,1,1,2
2021-07-07 19:13:30,2.524988425925926,1,1,0,1
2022-12-15 16:38:50,528.9379976851852,3,26509,13112,39621
2021-07-05 17:16:35,1.069363425925926,1,2,0,2
2021-07-04 02:59:37,0.2808217592592593,1,25,10,35
2021-12-15 22:47:19,165.1253125,4,41,14,55
2021-07-03 19:13:47,0.32631944444444444,3,27,6,33
2021-07-02 10:03:15,1.6563773148148149,1,5,1,6
2021-06-30 17:19:30,0.10740740740740741,1,10,10,20
2021-06-30 16:59:59,0.09520833333333334,1,3,3,6
2021-06-30 15:45:49,0.047453703703703706,1,3,3,6
2021-06-30 04:13:55,0.2520833333333333,1,16,3,19
2021-06-30 14:37:01,1.766747685185185,1,5,5,10
2021-06-30 14:37:32,1.7691087962962964,1,41,41,82
2021-07-03 20:07:46,4.998865740740741,1,5,5,10
2021-06-30 14:41:10,1.7724652777777778,1,55,55,110
2021-08-17 03:30:15,14.541296296296297,1,28,13,41
2021-06-30 14:40:07,1.775625,1,1,1,2
2021-08-28 16:17:59,1.1454398148148148,1,9,8,17
2021-06-30 14:36:36,1.7746064814814815,1,1,1,2
2021-07-03 20:07:32,3.1294560185185185,1,59,59,118
2021-07-07 19:17:01,9.891979166666667,1,12,1,13
2021-10-14 19:08:38,108.90449074074074,1,1,1,2
2021-06-27 20:31:29,0.04428240740740741,1,6,3,9
2021-06-24 14:56:43,0.6330439814814814,1,1,1,2
2021-06-25 13:01:52,1.625625,1,64,44,108
2021-06-23 14:42:23,0.014166666666666666,1,2,2,4
2021-07-08 03:31:29,16.214675925925928,1,160,32,192
2021-06-23 22:47:47,2.1086805555555554,1,5,5,10
2021-06-23 22:48:37,2.110590277777778,1,15,15,30
2021-06-24 15:55:34,0.040081018518518516,1,3,3,6
2021-06-23 22:50:14,2.1141550925925925,1,5,5,10
2021-06-23 22:49:56,2.1143055555555557,1,5,5,10
2021-06-23 22:49:40,2.1149074074074075,1,1,1,2
2021-06-23 22:49:29,2.115104166666667,1,5,5,10
2021-06-24 14:57:03,2.7888425925925926,1,3,3,6
2021-06-21 18:14:47,0.09518518518518519,2,38,4,42
2021-06-23 21:55:47,11.579155092592593,2,14,2,16
2022-01-16 12:23:51,213.58637731481483,1,141,75,216
2021-06-21 15:07:31,6.591064814814815,1,206,21,227
2021-06-18 07:04:38,0.053217592592592594,1,13,13,26
2021-06-14 15:00:31,0.4057060185185185,1,5,5,10
2021-06-14 14:55:04,0.40225694444444443,1,5,5,10
2021-06-14 14:53:43,0.40172453703703703,1,10,9,19
2021-06-18 05:41:53,3.610775462962963,1,443,497,940
2021-06-18 08:25:20,0.017905092592592594,1,16,82,98
2021-06-18 07:04:07,0.05303240740740741,1,43,50,93
2021-06-14 14:54:18,0.40728009259259257,1,172,94,266
2021-06-14 15:00:02,0.4113541666666667,1,3,3,6
2021-06-14 14:59:46,0.4114699074074074,1,1,1,2
2021-06-14 14:58:47,0.4110300925925926,1,3,3,6
2021-06-14 15:01:51,0.4134837962962963,1,1,1,2
2021-06-18 07:54:24,0.03158564814814815,1,14,21,35
2021-06-14 14:57:17,0.41053240740740743,1,1,1,2
2021-06-14 14:56:57,0.4105902777777778,1,1,1,2
2021-06-14 15:01:30,0.41594907407407405,1,2,2,4
2021-06-25 02:45:30,13.453564814814815,1,19,0,19
2021-06-15 20:11:08,4.206076388888889,1,13,2,15
2021-06-25 02:45:17,14.525532407407407,2,17,7,24
2021-10-20 23:14:04,132.42746527777777,2,60,10,70
2021-07-21 16:34:39,41.390902777777775,1,18,8,26
2021-06-07 12:00:30,0.281875,1,5,5,10
2021-08-28 00:58:04,78.42100694444444,5,1100,1390,2490
2021-06-07 12:03:42,0.28600694444444447,1,5,5,10
2021-06-10 14:44:05,3.397673611111111,1,20,27,47
2021-06-10 14:44:19,3.1110069444444446,1,1,1,2
2021-06-10 14:45:27,3.3998032407407406,1,4,4,8
2021-06-10 14:45:45,3.4010416666666665,1,5,5,10
2021-06-07 12:07:14,0.2911111111111111,1,1,1,2
2021-06-07 12:01:34,0.287650462962963,1,2,2,4
2021-06-10 14:46:04,3.402361111111111,1,5,5,10
2021-06-07 12:02:34,0.28967592592592595,1,1,1,2
2021-06-07 12:01:12,0.2899537037037037,1,2,8,10
2021-06-10 14:46:18,3.40494212962963,1,7,7,14
2021-06-07 12:00:49,0.2903935185185185,1,1,1,2
2021-06-25 02:45:05,20.674039351851853,1,1,1,2
2021-10-17 01:28:52,10.736342592592592,250,28843,15222,44065
2021-06-03 14:08:07,0.1949537037037037,1,2,2,4
2021-06-03 02:26:02,0.029618055555555557,1,20,1,21
2021-06-02 19:07:50,0.8688078703703703,2,8,5,13
2021-06-01 21:47:27,0.14145833333333332,1,4,2,6
2021-06-01 15:31:49,0.14456018518518518,1,1,1,2
2021-06-01 12:35:49,0.4567939814814815,2,543,110,653
2021-05-31 20:59:30,0.45319444444444446,1,3,3,6
2021-06-01 04:08:57,0.958113425925926,1,128,29,157
2021-06-01 06:19:56,0.07042824074074074,1,163,6,169
2021-06-01 04:10:49,0.9603125,1,74,51,125
2021-06-01 04:08:18,0.9595833333333333,1,16,16,32
2021-06-01 04:14:50,0.964375,1,5,5,10
2021-06-01 04:08:37,0.960300925925926,1,5,5,10
2021-06-01 04:11:10,0.9621296296296297,1,2,2,4
2021-06-01 04:11:23,0.9625925925925926,1,8,2,10
2021-10-14 19:04:27,138.22719907407406,1,7,0,7
2021-05-29 01:23:01,0.04517361111111111,1,5,5,10
2021-06-01 03:18:32,3.527662037037037,1,1,1,2
2021-05-27 08:32:05,0.011446759259259259,1,3,3,6
2021-06-02 15:41:25,6.922673611111111,2,13,6,19
2021-05-30 15:57:48,4.574837962962963,2,5,0,5
2021-06-02 17:15:18,8.218564814814815,4,50,24,74
2021-05-25 01:42:46,0.033368055555555554,1,22,78,100
2021-05-27 08:35:20,3.138564814814815,1,22,18,40
2021-05-27 08:35:48,3.1393287037037036,1,5,5,10
2021-05-27 08:54:32,3.15318287037037,1,5,5,10
2021-08-01 02:27:57,11.537418981481482,1,5,5,10
2021-05-27 08:36:48,3.143715277777778,1,15,15,30
2021-05-29 00:19:29,1.6387962962962963,1,53,14,67
2021-05-29 00:17:23,4.7976273148148145,1,3,3,6
2021-05-27 08:54:46,3.1575231481481483,1,1,1,2
2021-05-27 08:54:59,3.157986111111111,1,1,1,2
2021-05-29 00:17:34,4.799328703703703,1,3,3,6
2021-05-27 08:55:14,3.1590162037037035,1,5,21,26
2021-05-27 08:55:25,3.1595138888888887,1,4,4,8
2021-05-27 08:48:18,3.155428240740741,1,3,3,6
2021-05-27 08:48:43,3.1567708333333333,1,1,1,2
2021-05-24 01:02:46,1.3562731481481483,1,1,1,2
2021-05-22 13:00:34,0.07721064814814815,1,1,1,2
2021-06-02 19:09:19,11.656342592592592,211,12414,12274,24688
2021-05-22 00:38:57,0.36528935185185185,1,5,5,10
2021-05-22 00:58:01,0.019004629629629628,1,5,22,27
2021-05-22 13:00:20,0.9210532407407407,1,37,30,67
2021-05-24 01:03:01,3.1125462962962964,6,6,6,12
2021-05-22 15:43:08,2.0575925925925924,2,338,317,655
2021-05-21 15:31:33,1.0841666666666667,12,268,268,536
2021-05-24 03:16:45,4.43337962962963,1,1,1,2
2021-05-19 21:51:53,1.247488425925926,1,0,3,3
2021-05-18 18:13:44,0.10239583333333334,1,0,1,1
2021-05-19 21:52:08,1.353935185185185,2,7,7,14
2021-05-19 21:51:05,2.0481018518518517,2,2,2,4
2021-05-17 20:31:35,0.29560185185185184,1,9,9,18
2021-05-17 20:36:08,0.4414699074074074,1,1,1,2
2021-05-19 22:19:52,2.0659722222222223,250,14007,11384,25391
2021-05-21 15:45:06,4.4371875,1,10,10,20
2021-05-22 00:29:06,0.35811342592592593,1,87,87,174
2021-05-21 15:47:41,4.439780092592593,1,5,5,10
2021-05-21 15:47:59,4.440601851851852,1,5,5,10
2021-05-21 15:45:47,4.439722222222223,1,5,5,10
2021-05-21 15:48:39,4.442476851851852,1,84,65,149
2021-05-22 00:29:38,0.32229166666666664,1,22,23,45
2021-05-21 15:50:13,4.444953703703704,1,5,5,10
2021-05-21 15:49:03,4.444953703703704,1,3,3,6
2021-05-21 15:45:25,4.4428125,1,46,37,83
2021-05-17 20:36:29,0.6450231481481481,1,1,1,2
2021-05-21 15:52:32,4.449837962962963,1,3,3,6
2021-05-21 15:46:44,4.446122685185185,1,3,3,6
2021-05-21 15:46:30,4.446643518518519,1,1,1,2
2021-05-17 20:36:44,0.648587962962963,1,1,1,2
2021-05-16 21:54:47,0.008240740740740741,1,50,9,59
2021-05-16 21:50:16,0.013298611111111112,1,3,2,5
2021-05-16 21:09:22,0.025972222222222223,1,10,2,12
2021-05-16 21:09:13,0.036284722222222225,1,1,1,2
2021-05-16 21:09:03,0.055081018518518515,1,18,0,18
2021-05-16 17:48:59,0.10248842592592593,1,1,0,1
2021-05-16 21:54:25,0.6041435185185186,39,1037,1037,2074
2021-05-16 21:55:07,0.6357523148148149,1,299,190,489
2021-10-25 14:31:20,164.1475,5,28,8,36
2021-05-12 21:19:44,0.06915509259259259,2,20,2,22
2021-05-12 21:19:31,0.2664236111111111,1,1,1,2
2021-09-30 22:55:52,142.18534722222222,3,32,13,45
2022-03-09 11:07:36,301.81252314814816,19,42873,22350,65223
2021-05-11 20:21:47,0.0033680555555555556,1,1,0,1
2021-05-11 19:15:57,0.04842592592592593,2,8,7,15
2021-05-11 17:14:59,0.0038773148148148148,1,1,1,2
2021-05-11 17:15:11,0.08918981481481482,1,6,4,10
2021-05-11 19:16:24,0.30971064814814814,1,9,2,11
2021-05-11 12:19:02,0.028171296296296295,1,1,1,2
2021-05-11 12:18:34,0.03666666666666667,1,26,6,32
2021-05-11 12:17:38,0.04300925925925926,1,1,2,3
2023-04-03 01:31:40,1524.4605324074073,9,1093,205,1298
2021-05-10 20:20:33,0.010462962962962962,3,9,9,18
2021-05-16 06:27:12,5.431574074074074,165,2806,2727,5533
2021-05-10 20:23:48,0.18958333333333333,1,5,3,8
2021-05-10 15:31:55,0.2223726851851852,1,62,5,67
2021-05-10 15:37:23,0.42787037037037035,1,5,5,10
2021-05-10 15:37:09,0.430775462962963,1,15,15,30
2021-05-10 15:34:59,0.42988425925925927,1,5,5,10
2021-05-10 15:36:47,0.43150462962962965,1,5,5,10
2021-05-10 15:36:39,0.43278935185185186,1,10,10,20
2021-05-10 15:36:27,0.43318287037037034,1,5,5,10
2021-05-10 15:36:15,0.4354050925925926,1,6,6,12
2021-05-10 15:35:31,0.43550925925925926,1,1,1,2
2021-05-10 15:25:36,0.42895833333333333,1,54,54,108
2021-05-10 15:27:51,0.4317361111111111,1,3,3,6
2021-05-10 15:35:24,0.4374537037037037,1,7,7,14
2021-05-10 15:41:38,0.0023263888888888887,1,4,4,8
2021-05-10 15:35:10,0.4390046296296296,1,2,2,4
2021-05-11 12:19:22,3.427210648148148,2,72,4,76
2021-05-09 08:39:30,0.020324074074074074,1,2,2,4
2021-05-09 08:40:18,0.3492708333333333,1,12,11,23
2021-05-09 08:39:13,0.25925925925925924,1,1,1,2
2021-05-10 15:46:23,2.019791666666667,250,14488,8920,23408
2021-05-08 14:22:18,0.053287037037037036,1,1,1,2
2021-05-07 20:04:09,0.09068287037037037,1,3,3,6
2021-05-07 17:52:41,0.018622685185185187,1,1,1,2
2021-05-07 13:56:45,0.04732638888888889,1,46,8,54
2021-05-07 16:14:29,0.16398148148148148,1,2,2,4
2021-05-07 11:54:16,0.015243055555555555,1,3,3,6
2021-09-26 03:46:13,142.1361689814815,1,492,225,717
2021-05-07 17:32:58,0.7152893518518518,1,24,208,232
2021-05-07 12:33:19,0.5128819444444445,1,34,8,42
2021-05-07 12:33:44,4.524236111111111,1,59,160,219
2021-08-10 20:56:13,96.3291087962963,11,8550,4650,13200
2021-05-06 00:11:43,0.047685185185185185,1,8,1,9
2021-05-05 21:57:29,0.015081018518518518,1,23,3,26
2021-05-07 12:33:58,1.6393055555555556,1,39,9,48
2021-05-05 20:04:52,0.06974537037037037,1,75,16,91
2021-05-05 02:41:10,0.11864583333333334,2,6,4,10
2021-05-05 13:59:43,0.6912037037037037,1,4,0,4
2021-05-04 21:13:05,0.21564814814814814,1,1,3,4
2021-05-04 21:06:19,0.360462962962963,1,2,2,4
2021-05-04 12:22:05,0.4237384259259259,1,4,4,8
2021-05-04 02:45:09,0.02880787037037037,1,20,5,25
2021-05-03 13:45:20,0.15650462962962963,1,49,1,50
2021-05-03 13:36:57,0.09583333333333334,1,5,5,10
2021-05-07 03:27:33,3.9290162037037035,1,5,5,10
2021-05-03 11:12:33,0.25219907407407405,1,5,5,10
2021-05-03 11:07:31,0.24898148148148147,1,5,5,10
2021-05-10 15:46:39,0.002650462962962963,1,1,1,2
2021-05-03 13:35:30,0.09333333333333334,1,92,51,143
2021-05-07 03:33:21,3.9359375,1,5,5,10
2021-05-03 11:12:02,0.2548958333333333,1,4,4,8
2021-05-03 11:08:56,0.25300925925925927,1,5,5,10
2021-05-03 11:11:22,0.25494212962962964,1,50,45,95
2021-05-07 03:27:58,3.933449074074074,1,4,4,8
2021-05-03 11:06:00,0.25200231481481483,1,1,1,2
2021-05-03 12:59:50,0.33644675925925926,1,2,2,4
2021-05-05 17:44:01,2.724675925925926,4,245,78,323
2021-05-02 12:30:26,0.6627199074074074,1,1,1,2
2021-04-29 13:43:50,0.14988425925925927,1,1,1,2
2021-05-04 21:23:36,6.174201388888889,3,64,64,128
2021-04-27 18:34:53,0.01832175925925926,1,2,2,4
2021-04-27 14:25:24,0.02869212962962963,1,1,1,2
2021-04-26 11:47:41,0.27230324074074075,1,5,5,10
2021-04-26 11:49:24,0.27402777777777776,1,5,5,10
2021-04-26 11:49:35,0.2745949074074074,1,5,5,10
2021-04-26 11:41:45,0.27067129629629627,1,5,5,10
2021-04-26 11:40:58,0.2704050925925926,1,5,5,10
2021-04-26 06:36:57,0.05966435185185185,1,5,5,10
2021-04-26 13:07:18,0.04962962962962963,1,6,12,18
2021-04-26 11:40:33,0.27241898148148147,1,5,5,10
2021-04-26 12:47:17,0.3194675925925926,1,3,3,6
2021-04-26 07:48:19,0.11203703703703703,1,42,43,85
2021-04-26 12:46:58,0.31975694444444447,1,5,5,10
2021-05-05 19:16:55,9.676585648148148,1,111,46,157
2021-05-05 21:46:59,9.806724537037036,1,14,1,15
2021-05-01 21:19:18,5.803032407407407,1,4,4,8
2021-04-26 16:56:45,0.6190162037037037,1,2,0,2
2021-04-26 16:57:47,1.4763078703703705,1,18,5,23
2021-04-25 04:34:48,0.5254282407407408,1,3,8,11
2021-04-25 04:33:28,3.8288310185185184,1,35,10,45
2021-04-24 11:41:04,0.022268518518518517,1,3,3,6
2021-05-05 17:44:35,11.721840277777778,1,7,8,15
2021-05-01 21:18:59,7.875868055555555,1,3,1,4
2021-04-24 11:35:39,0.4736458333333333,1,6,2,8
2021-04-23 20:51:22,0.03059027777777778,1,2,2,4
2021-04-22 12:26:11,0.014849537037037038,1,5,1,6
2021-04-22 18:33:36,0.596550925925926,1,3,3,6
2021-05-08 15:12:56,3.7368055555555557,250,14522,5211,19733
2021-04-22 03:19:36,0.009756944444444445,1,1792,11,1803
2021-04-22 03:12:28,46.76518518518518,3,14,8,22
2021-04-22 01:25:05,0.028796296296296296,1,15,15,30
2021-04-22 01:27:43,0.13111111111111112,250,16947,10710,27657
2021-04-21 15:45:59,0.13234953703703703,2,9,3,12
2021-04-21 13:40:00,0.08804398148148149,1,3,0,3
2021-04-21 02:46:09,0.2671064814814815,9,108,96,204
2021-04-20 19:28:02,0.3001273148148148,1,1,1,2
2021-04-20 11:57:45,0.40868055555555555,1,4,4,8
2021-04-21 16:31:24,1.589398148148148,1,81,81,162
2021-04-20 00:34:08,0.025555555555555557,1,1,1,2
2021-04-24 15:01:43,4.630185185185185,1,228,128,356
2021-04-20 13:07:52,0.5487384259259259,1,1,1,2
2021-04-19 16:41:29,0.049756944444444444,3,13,10,23
2021-04-19 13:34:36,0.03375,1,3,3,6
2021-04-19 19:03:39,0.5769212962962963,1,20,21,41
2021-04-19 19:02:25,0.2248263888888889,1,5,5,10
2021-04-19 13:34:59,0.35,1,5,10,15
2021-04-19 19:06:49,0.5809143518518518,1,3,3,6
2021-04-19 19:59:20,0.031099537037037037,1,5,5,10
2021-04-19 13:33:42,0.34980324074074076,1,5,5,10
2021-04-19 13:33:21,0.35060185185185183,1,1,1,2
2021-04-19 19:07:08,0.5825462962962963,1,5,5,10
2021-04-19 13:34:10,0.3514699074074074,1,1,1,2
2021-04-19 13:35:21,0.3524074074074074,1,5,5,10
2021-04-19 13:32:19,0.3507986111111111,1,1,1,2
2021-04-19 19:03:21,0.5809027777777778,1,22,17,39
2021-04-19 13:32:42,0.35140046296296296,1,1,1,2
2021-04-19 19:06:34,0.5834953703703704,1,5,5,10
2021-04-19 12:45:15,0.42322916666666666,1,287,51,338
2021-05-08 15:15:06,21.569606481481483,1,145,2,147
2021-04-17 09:12:49,0.31938657407407406,1,12,9,21
2021-04-17 13:41:58,0.5209722222222222,1,29,30,59
2021-04-17 12:55:46,0.49506944444444445,1,51,1,52
2021-04-17 01:14:26,0.20537037037037037,1,172,21,193
2021-04-16 20:20:33,0.018865740740740742,1,1,1,2
2021-04-16 20:01:05,0.009722222222222222,1,4,0,4
2021-05-06 12:22:55,19.814791666666668,9,192,89,281
2021-04-16 08:06:42,0.24597222222222223,2,9,7,16
2021-04-16 08:06:16,0.2485300925925926,3,11,4,15
2021-04-15 14:28:43,0.4806828703703704,1,77,10,87
2021-04-15 14:28:20,0.49711805555555555,1,7,7,14
2021-04-15 03:00:26,0.13947916666666665,1,170,51,221
2021-04-14 13:48:49,0.007627314814814815,1,1,1,2
2021-04-13 21:43:41,0.19666666666666666,1,1,0,1
2021-04-13 21:43:52,0.26175925925925925,1,21,2,23
2021-04-13 01:45:45,0.2662962962962963,1,7,13,20
2021-04-12 13:02:23,0.324537037037037,1,5,5,10
2021-04-12 13:09:21,0.33010416666666664,1,5,5,10
2021-04-12 16:01:55,0.12256944444444444,1,5,5,10
2021-04-12 16:00:48,0.12070601851851852,1,24,75,99
2021-04-12 16:00:31,0.120625,1,18,18,36
2021-04-12 12:00:06,0.28520833333333334,1,1,1,2
2021-04-12 13:11:49,0.3352662037037037,1,5,11,16
2021-04-12 12:37:29,0.31197916666666664,1,3,3,6
2021-04-12 13:00:59,0.3283101851851852,1,61,33,94
2021-04-12 16:02:58,0.1146412037037037,1,5,5,10
2021-04-12 13:00:01,0.3285300925925926,1,10,10,20
2021-04-12 12:59:28,0.3284837962962963,1,15,28,43
2021-04-12 12:08:06,0.2933101851851852,1,1,1,2
2021-04-12 13:00:54,0.33011574074074074,1,5,5,10
2021-04-12 12:00:30,0.2883912037037037,1,1,1,2
2021-04-12 12:00:56,0.2890625,1,3,3,6
2021-04-12 12:25:34,0.8474421296296296,1,150,58,208
2021-04-12 01:35:59,1.2405671296296297,1,45,11,56
2021-04-11 09:22:51,1.4784837962962962,1,0,429,429
2021-04-09 00:31:20,0.10451388888888889,1,14,8,22
2021-04-09 00:31:11,0.15474537037037037,1,0,2,2
2021-04-09 00:31:37,3.043888888888889,2,4,4,8
2021-04-06 09:38:22,0.0900925925925926,1,1,1,2
2021-04-05 21:41:38,0.052708333333333336,1,0,1,1
2021-04-05 11:05:49,0.0502662037037037,1,3,3,6
2021-04-05 13:17:46,0.3391898148148148,1,5,5,10
2021-04-05 10:10:18,0.21032407407407408,1,9,9,18
2021-04-05 13:19:58,0.34274305555555556,1,15,15,30
2021-04-05 10:09:50,0.2112962962962963,1,5,5,10
2021-04-05 10:10:40,0.21306712962962962,1,1,1,2
2021-05-07 23:56:41,34.37322916666667,2,15331,8972,24303
2021-04-03 12:12:30,0.4940277777777778,1,152,7,159
2021-04-03 00:39:04,4.078252314814815,1,8,19,27
2021-04-10 09:50:41,7.442939814814815,1,8,14,22
2021-03-31 22:00:12,0.0914699074074074,1,10,2,12
2021-03-31 15:46:17,0.12739583333333335,1,3,1,4
2021-03-30 15:56:00,0.04991898148148148,1,71,52,123
2021-03-30 08:10:05,0.28778935185185184,1,1,1,2
2021-03-30 14:42:17,1.3937731481481481,1,14,5,19
2021-03-30 14:40:18,1.3931481481481482,1,30,20,50
2021-03-30 14:58:23,1.2352777777777777,1,4,4,8
2021-03-30 14:43:16,1.3974768518518519,1,14,5,19
2021-03-31 01:46:58,0.3732175925925926,1,6,33,39
2021-03-30 14:49:45,1.2274537037037037,1,3,3,6
2021-03-31 02:39:58,0.4098148148148148,1,14,81,95
2021-03-30 14:48:30,1.2291550925925927,1,3,3,6
2021-03-30 14:57:41,1.4094907407407407,1,83,88,171
2021-03-30 14:47:06,1.229988425925926,1,3,3,6
2021-03-30 22:47:28,0.24908564814814815,1,22,48,70
2021-03-30 14:44:51,1.2256828703703704,1,1,1,2
2021-03-30 16:42:42,1.483298611111111,1,53,6,59
2021-03-29 13:17:11,0.16363425925925926,1,1,1,2
2021-03-30 14:38:27,1.3978935185185186,1,14,5,19
2021-03-29 05:39:37,0.02451388888888889,1,60,59,119
2021-03-26 17:22:54,0.088125,1,7,0,7
2021-03-26 17:36:16,0.8033449074074074,1,14,2,16
2021-03-25 01:46:13,0.3586111111111111,1,5,1,6
2021-03-24 09:19:40,0.06032407407407407,1,83,7,90
2021-04-12 10:37:15,22.899224537037036,1,560,26,586
2021-03-22 06:35:46,0.04846064814814815,1,3,3,6
2021-03-22 06:37:51,0.050138888888888886,1,3,3,6
2021-03-22 06:36:13,0.049837962962962966,1,3,3,6
2021-03-22 06:38:23,0.05394675925925926,1,1,1,2
2021-03-22 06:39:20,0.06166666666666667,1,5,5,10
2021-03-22 06:38:54,0.06664351851851852,1,1,1,2
2021-03-22 06:39:39,0.06741898148148148,1,4,4,8
2021-03-24 09:46:13,2.6572222222222224,1,81,0,81
2021-03-24 08:37:42,3.823148148148148,2,51,12,63
2021-03-19 22:47:31,0.11923611111111111,1,1,1,2
2021-03-19 22:48:47,0.1414351851851852,3,26,2,28
2021-03-19 19:22:50,0.0036805555555555554,1,2,0,2
2021-03-19 19:23:08,0.10246527777777778,1,1,1,2
2021-03-19 19:23:33,0.12597222222222224,1,0,1,1
2021-03-19 12:14:40,0.08407407407407408,1,14,70,84
2021-03-19 10:07:57,0.09111111111111111,1,2,2,4
2021-03-17 23:41:33,0.09121527777777778,2,65,2,67
2021-03-19 01:43:13,1.3371296296296296,1,23,58,81
2021-03-19 01:42:44,1.5391435185185185,2,31,28,59
2021-03-19 01:45:34,1.5713194444444445,5,15,15,30
2021-03-19 12:14:58,3.02875,3,130,107,237
2021-03-17 09:09:55,1.5440046296296297,7,47,63,110
2021-03-24 09:44:31,8.441631944444444,16,273,228,501
2021-03-15 10:17:43,0.13935185185185187,1,30,14,44
2021-03-15 07:09:47,0.07278935185185186,1,3,3,6
2021-03-15 12:03:19,0.28215277777777775,1,19,7,26
2021-03-15 12:03:02,0.28350694444444446,1,16,11,27
2021-03-15 12:04:03,0.28480324074074076,1,5,5,10
2021-03-15 22:52:23,0.4453240740740741,1,5,5,10
2021-03-15 12:02:24,0.28519675925925925,1,25,25,50
2021-03-15 12:03:46,0.2864583333333333,1,10,10,20
2021-03-15 11:56:59,0.2828125,1,5,5,10
2021-03-15 01:17:29,1.0996296296296297,1,1,1,2
2021-03-12 13:11:27,0.22908564814814814,1,1,1,2
2021-03-12 13:55:06,0.029652777777777778,1,1,1,2
2021-03-13 00:04:14,0.4517013888888889,1,2,2,4
2021-03-12 07:56:44,0.1295023148148148,1,19,19,38
2021-03-12 07:55:32,0.019247685185185184,1,1,1,2
2021-03-15 12:19:17,2.9629166666666666,1,4,4,8
2021-03-15 22:55:43,3.634849537037037,1,6,6,12
2021-03-12 13:11:05,0.23476851851851852,1,1,1,2
2021-03-12 14:06:29,0.037453703703703704,1,1,1,2
2021-03-12 06:21:05,0.07052083333333334,1,14,14,28
2021-03-19 22:48:59,8.288194444444445,1,42,42,84
2021-03-12 04:33:35,1.6346296296296297,1,1,1,2
2021-03-09 02:08:10,0.024791666666666667,1,16,16,32
2021-03-12 04:25:52,3.6271643518518517,1,2,2,4
2021-03-12 04:25:24,3.6596527777777776,1,10,35,45
2021-03-08 13:50:51,0.34671296296296295,1,1,1,2
2021-03-08 13:50:39,0.3470138888888889,1,1,1,2
2021-03-08 14:05:36,0.35780092592592594,1,5,5,10
2021-03-08 13:50:13,0.3514814814814815,1,1,1,2
2021-04-15 03:24:28,39.482962962962965,2,988,900,1888
2021-03-24 12:51:33,17.96644675925926,3,5,4,9
2021-03-19 01:44:57,12.634895833333333,1,13,2,15
2021-03-08 14:04:54,3.481828703703704,1,5,5,10
2021-03-05 03:32:38,0.04452546296296296,1,2,2,4
2021-03-05 03:00:23,0.02224537037037037,1,2,2,4
2021-03-07 06:06:57,3.5837268518518517,1,4,128,132
2022-01-23 17:10:10,326.1258912037037,9,197,194,391
2021-03-03 23:12:27,0.5416435185185186,2,52,16,68
2021-03-04 21:39:10,2.4336458333333333,1,28,7,35
2021-03-05 02:28:28,0.19693287037037038,1,5,5,10
2021-03-04 21:39:25,2.434884259259259,1,28,7,35
2021-03-05 02:28:41,0.19947916666666668,1,5,5,10
2021-03-12 04:38:45,3.6053819444444444,1,4,4,8
2021-03-01 14:37:06,0.371412037037037,1,1,1,2
2021-03-04 21:38:52,3.6652893518518517,2,5,5,10
2021-03-01 14:36:45,0.3732175925925926,1,3,3,6
2021-03-01 17:39:47,0.5049768518518518,1,27,2,29
2021-03-01 14:34:29,0.37699074074074074,1,3,3,6
2021-03-01 14:35:00,0.3780208333333333,1,4,4,8
2021-03-04 21:39:46,3.2927546296296297,1,3,3,6
2021-03-01 14:50:00,0.40694444444444444,1,3,3,6
2021-02-28 04:12:44,0.0409375,1,152,193,345
2021-02-28 00:01:34,0.24959490740740742,1,38,11,49
2021-02-27 14:35:33,0.40304398148148146,1,347,254,601
2021-02-28 04:27:53,0.05278935185185185,1,6,6,12
2021-02-27 14:36:18,0.4051273148148148,1,40,78,118
2021-02-28 03:03:59,0.5133564814814815,1,101,103,204
2021-03-01 03:59:13,2.0149074074074074,1,72,23,95
2021-02-27 04:48:35,0.4131134259259259,1,12,12,24
2021-02-27 04:48:23,0.41377314814814814,1,10,10,20
2021-02-27 04:47:47,0.40914351851851855,1,11,13,24
2021-02-26 18:44:53,1.814837962962963,1,155,85,240
2021-03-01 20:22:54,5.133391203703703,1,20,2,22
2021-02-24 23:03:02,0.33122685185185186,3,128,91,219
2021-02-24 15:53:16,0.25766203703703705,1,7,1,8
2021-02-26 18:45:26,2.8609027777777776,1,323,186,509
2021-02-26 18:46:26,1.8164351851851852,1,10,41,51
2021-02-27 04:47:59,0.40952546296296294,1,7,23,30
2021-02-26 16:40:27,2.8570949074074075,2,2,1,3
2021-03-12 04:32:49,17.504872685185184,2,133,59,192
2021-02-22 17:26:24,0.09111111111111111,1,1,1,2
2021-02-22 10:26:08,0.07597222222222222,1,1,2,3
2021-02-23 21:56:29,1.6966203703703704,1,5,5,10
2021-02-23 21:57:36,1.6977083333333334,1,63,30,93
2021-05-05 21:39:02,78.94456018518518,9,214,39,253
2021-02-21 18:50:13,0.4077777777777778,1,258,2,260
2021-03-12 04:39:09,20.29619212962963,1,5,5,10
2021-02-20 12:37:37,0.2258449074074074,1,27,27,54
2021-02-20 07:00:56,0.9030555555555555,1,24,17,41
2021-02-20 07:00:16,0.9027546296296296,1,24,17,41
2021-02-20 07:01:36,0.9042708333333334,1,24,17,41
2021-02-20 06:58:19,0.9022453703703703,1,62,55,117
2021-02-20 07:02:03,0.905,1,24,17,41
2021-02-20 07:02:48,0.9055787037037037,1,24,17,41
2021-02-20 06:59:43,0.9039583333333333,1,24,17,41
2021-02-23 21:58:40,4.53480324074074,1,7,7,14
2021-02-19 08:52:58,0.8345138888888889,1,0,0,0
2021-02-19 08:53:25,0.893900462962963,1,8,3,11
2021-02-24 05:32:13,6.838425925925926,5,60,19,79
2021-02-19 08:56:41,2.322824074074074,1,16,5,21
2021-02-19 08:52:32,3.482650462962963,1,55,4,59
2021-02-19 08:57:03,2.3923032407407407,1,1,0,1
2021-02-19 08:56:14,2.531296296296296,1,9,9,18
2021-02-16 14:28:17,0.34738425925925925,1,2,2,4
2021-02-16 14:28:32,0.48386574074074074,1,17,0,17
2021-03-24 09:55:16,36.62894675925926,1,1,1,2
2021-02-19 09:08:10,4.161504629629629,1,4,4,8
2021-02-19 09:10:07,4.167083333333333,1,19,12,31
2021-02-19 09:09:30,4.167974537037037,1,7,7,14
2021-02-19 09:07:40,4.16943287037037,1,2,2,4
2021-02-20 12:38:05,0.2367824074074074,1,38,38,76
2021-02-15 07:00:54,0.3897569444444444,1,161,163,324
2021-02-13 23:10:52,0.30667824074074074,1,10,0,10
2021-02-14 19:16:32,223.09800925925927,1,41,1,42
2021-04-21 22:04:59,8.999895833333333,250,28483,19136,47619
2021-04-10 09:51:02,57.196921296296296,1,25,54,79
2021-02-12 06:19:15,0.09221064814814815,1,4,5,9
2021-02-12 04:45:38,0.01716435185185185,1,11,1,12
2021-02-12 11:39:28,0.42756944444444445,1,27,78,105
2021-02-12 04:29:08,0.1296064814814815,1,12,12,24
2021-02-12 04:29:34,0.13,1,27,27,54
2021-02-11 22:47:05,0.1282638888888889,3,98,90,188
2021-02-11 18:20:58,0.016238425925925927,2,8,8,16
2021-02-11 21:58:39,0.19302083333333334,2,3,1,4
2021-02-11 16:05:03,0.17581018518518518,1,38,64,102
2021-02-11 15:20:01,0.1449537037037037,1,38,64,102
2021-02-11 05:22:12,0.03715277777777778,1,1,1,2
2021-02-10 23:53:13,0.10422453703703703,3,137,31,168
2021-02-11 18:59:47,1.479224537037037,5,15,12,27
2021-02-11 15:18:09,0.1394675925925926,1,22,31,53
2021-02-11 15:17:07,0.13895833333333332,1,5,5,10
2021-02-11 15:54:09,0.1645601851851852,1,5,5,10
2021-02-11 15:18:45,0.14001157407407408,1,5,5,10
2021-02-09 17:12:55,0.3586226851851852,1,3,1,4
2021-02-09 00:21:06,0.030752314814814816,2,2,2,4
2021-02-11 01:18:57,2.790277777777778,2,26,3,29
2021-02-12 01:14:32,0.021423611111111112,1,15,73,88
2021-02-12 01:15:19,0.021666666666666667,1,5,5,10
2021-02-10 01:38:27,1.8462037037037038,1,510,388,898
2021-02-11 11:42:04,1.4137962962962962,1,33,59,92
2021-02-11 11:54:46,3.2772800925925925,1,5,5,10
2021-02-11 11:55:45,1.4234606481481482,1,25,136,161
2021-02-11 15:10:01,3.4154976851851853,2,6,6,12
2021-02-11 11:54:19,3.2801620370370372,1,1,1,2
2021-02-12 00:31:56,0.3766319444444444,1,15,15,30
2021-02-11 11:53:53,3.280127314814815,1,2,2,4
2021-02-11 15:16:21,0.13871527777777778,1,8,8,16
2021-02-11 11:53:02,1.455474537037037,1,1,1,2
2021-02-11 11:58:47,3.2844675925925926,1,3,3,6
2021-02-20 06:55:12,0.9054166666666666,1,4,4,8
2021-02-11 11:51:09,3.2822222222222224,1,4,4,8
2021-02-10 00:56:12,1.8277199074074073,1,2,2,4
2021-02-10 00:55:52,1.8279282407407407,1,8,8,16
2021-05-05 21:41:02,90.37400462962962,2,7,4,11
2021-02-11 00:53:45,7.586064814814815,2,151,33,184
2021-02-02 23:38:49,0.38743055555555556,2,5,2,7
2021-02-02 19:27:58,1.5845833333333332,1,1,1,2
2021-03-24 09:53:23,2.0165625,1,3,3,6
2021-02-11 11:50:10,10.273599537037038,1,5,5,10
2021-02-02 14:56:55,1.404039351851852,1,5,5,10
2021-02-02 19:27:19,0.19296296296296298,1,1,1,2
2021-02-02 14:56:18,1.4072106481481481,1,1,1,2
2021-02-02 14:47:36,1.4015162037037037,1,5,5,10
2021-02-02 14:47:13,1.4016435185185185,1,14,10,24
2021-02-11 00:05:05,10.22119212962963,2,16,11,27
2021-01-31 20:24:18,1.4472685185185186,1,3,3,6
2021-01-31 20:24:58,2.146724537037037,3,160,74,234
2021-01-29 17:38:57,0.0771412037037037,1,1,1,2
2021-01-31 20:25:32,3.16974537037037,1,102,170,272
2021-01-28 17:24:23,0.1094212962962963,1,1,1,2
2021-01-25 08:22:42,0.30831018518518516,1,2,2,4
2021-01-26 14:32:43,1.3835300925925926,1,2,2,4
2021-01-26 14:33:07,1.3854398148148148,1,3,3,6
2021-03-12 04:39:58,45.974780092592596,4,11,7,18
2021-01-26 14:33:47,1.3874652777777778,1,1,1,2
2021-01-26 14:34:05,1.389224537037037,1,5,5,10
2021-03-22 06:41:47,56.06231481481481,2,115,102,217
2021-01-26 14:34:49,1.3960300925925926,1,3,3,6
2021-01-26 14:35:04,1.3964467592592593,1,3,3,6
2021-01-26 23:58:30,0.3907060185185185,1,1,1,2
2021-01-24 08:14:35,0.18032407407407408,1,1,1,2
2021-02-11 01:11:30,18.199293981481482,1,12,0,12
2021-01-22 09:09:23,0.7040046296296296,2,5,5,10
2021-01-21 13:29:55,0.11087962962962963,1,11,11,22
2021-01-21 05:18:32,0.3358333333333333,1,1,1,2
2022-09-20 21:30:27,608.4599189814815,17,175,64,239
2021-01-21 12:46:16,1.003113425925926,1,5,5,10
2021-01-21 12:46:37,1.0094907407407407,1,1,1,2
2021-02-02 13:49:57,14.207800925925927,3,127,34,161
2021-01-22 09:09:40,3.5977083333333333,1,1,1,2
2021-01-20 12:30:57,2.296597222222222,1,3,3,6
2021-01-20 12:42:35,2.304872685185185,1,1,1,2
2021-01-20 12:40:40,2.3099652777777777,1,2,2,4
2021-01-21 12:46:55,0.9986574074074074,1,10,10,20
2021-01-20 12:32:06,2.3043518518518518,1,5,5,10
2021-01-23 14:25:09,5.382881944444445,1,4,4,8
2021-01-20 12:28:46,2.302303240740741,1,5,5,10
2021-01-20 12:29:30,2.303287037037037,1,1,1,2
2021-01-20 12:27:50,2.303125,1,5,5,10
2021-01-31 18:48:30,13.567777777777778,2,7,7,14
2021-01-20 12:24:39,2.3013425925925928,1,5,5,10
2021-01-21 12:47:56,3.317673611111111,1,10,10,20
2021-01-20 12:18:00,2.296990740740741,1,1,1,2
2021-01-21 12:47:34,1.0039351851851852,1,12,12,24
2021-01-20 12:05:07,2.2887037037037037,1,5,5,10
2021-03-19 16:15:59,61.03570601851852,2,3,1,4
2021-02-11 03:40:14,25.902928240740742,2,27,11,38
2021-01-28 21:53:57,13.814884259259259,1,1,1,2
2021-03-24 09:19:08,69.95628472222222,3,28,3,31
2021-01-31 20:26:10,20.592349537037038,1,26,10,36
2021-01-22 09:09:09,12.297060185185185,4,35,35,70
2021-01-22 15:28:16,12.632893518518518,1,5,8,13
2021-03-02 11:02:56,71.87947916666667,6,107,222,329
2021-03-19 16:15:37,112.46762731481482,1,1,2,3
2021-03-24 09:37:25,294.7112384259259,1,12,10,22
2021-10-14 19:06:19,623.4541203703703,1,6,1,7
2021-10-14 19:05:51,871.5237731481482,1,1,1,2
2021-03-20 20:21:58,264.2659027777778,3,22,49,71
2021-01-19 05:47:37,0.39239583333333333,1,1,1,2
2021-01-12 08:25:02,0.06527777777777778,1,6,1,7
2021-01-12 08:27:39,0.5862847222222223,2,12,12,24
2021-01-16 15:59:45,5.444050925925926,1,1,1,2
2021-01-16 16:02:52,5.4465509259259255,1,2,2,4
2021-01-18 02:10:24,6.868715277777778,2,6,6,12
2021-01-16 16:06:28,5.449710648148148,1,1,1,2
2021-01-16 16:12:23,5.4568055555555555,1,5,5,10
2021-01-16 16:08:20,5.454259259259259,1,5,5,10
2021-01-16 16:08:46,5.454756944444444,1,5,5,10
2021-01-16 16:09:27,5.458576388888889,1,5,5,10
2021-01-09 02:48:51,0.5138078703703703,1,1,1,2
2021-01-10 11:47:21,1.9172800925925926,1,29,1,30
2021-01-09 02:51:33,0.5666898148148148,2,6,0,6
2021-01-08 11:26:29,0.0590162037037037,1,5,5,10
2021-01-09 23:32:01,2.8978587962962963,2,52,26,78
2021-01-08 06:07:08,0.3387384259259259,1,1,0,1
2021-01-08 06:13:27,3.356701388888889,1,1,1,2
2021-01-07 08:40:56,1.1352546296296295,6,60,60,120
2021-01-07 08:30:13,1.012974537037037,2,2,2,4
2021-01-06 06:49:49,0.08363425925925926,1,1,1,2
2021-01-05 21:25:08,0.1715509259259259,1,2,2,4
2021-01-05 18:57:33,0.19947916666666668,1,1,0,1
2021-01-05 18:57:51,1.5461921296296297,1,1,1,2
2021-01-05 19:00:43,0.7144444444444444,1,1,1,2
2021-01-04 17:10:34,0.4887037037037037,1,3,3,6
2021-01-07 05:10:50,2.9972337962962965,1,4,4,8
2021-01-04 17:09:40,0.49694444444444447,1,1,1,2
2021-01-05 19:01:32,1.0761342592592593,1,7,5,12
2021-01-04 12:01:47,0.28445601851851854,1,5,5,10
2021-01-04 17:10:10,0.49864583333333334,1,4,4,8
2021-01-04 17:08:59,0.49832175925925926,2,17,5,22
2021-01-04 12:04:01,0.28693287037037035,1,5,5,10
2021-01-04 12:02:24,0.2861458333333333,1,5,5,10
2021-01-04 12:03:32,0.2883449074074074,1,45,45,90
2021-01-04 12:04:11,0.28913194444444446,1,5,5,10
2021-01-04 17:09:15,0.5027314814814815,1,1,1,2
2021-01-07 08:32:17,3.884537037037037,1,1,1,2
2020-12-30 22:18:11,0.2905671296296296,1,26,11,37
2020-12-30 22:19:19,1.2835300925925925,1,6,2,8
2020-12-30 22:18:39,2.2933796296296296,1,7,2,9
2020-12-30 02:44:26,0.4933680555555556,1,5,5,10
2020-12-30 02:47:19,0.4899189814814815,1,6,5,11
2020-12-29 14:53:56,1.404375,1,2,2,4
2020-12-29 15:06:49,1.4135995370370371,1,2,2,4
2020-12-29 14:56:34,1.4078472222222222,1,5,5,10
2020-12-30 02:52:20,0.49350694444444443,1,5,5,10
2020-12-29 15:11:31,1.4187731481481483,1,6,6,12
2020-12-29 15:56:17,0.05945601851851852,1,1,1,2
2020-12-30 02:52:41,0.48810185185185184,1,2,2,4
2020-12-29 15:12:04,1.419710648148148,1,7,7,14
2020-12-29 15:09:12,1.4178819444444444,1,6,6,12
2020-12-30 11:14:01,0.8456365740740741,1,5,5,10
2020-12-30 03:08:13,0.4956712962962963,1,1,1,2
2020-12-29 15:08:41,1.4202546296296297,1,1,1,2
2020-12-30 03:13:30,0.4996527777777778,1,14,14,28
2020-12-27 04:30:57,0.0014583333333333334,1,17,17,34
2020-12-27 05:00:55,0.0349537037037037,1,338,232,570
2020-12-30 22:19:56,5.36724537037037,4,9,4,13
2020-12-26 22:50:34,1.4585416666666666,4,28,71,99
2020-12-24 14:53:27,0.30449074074074073,1,3,3,6
2020-12-24 14:53:46,0.30542824074074076,1,10,2,12
2020-12-23 22:47:50,0.04697916666666667,1,1,1,2
2020-12-23 18:55:24,0.034722222222222224,1,0,15,15
2020-12-23 15:43:12,0.04923611111111111,1,5,0,5
2020-12-23 15:43:39,0.26417824074074076,6,12,21,33
2020-12-23 06:47:04,0.041840277777777775,1,4,0,4
2020-12-26 22:51:47,3.822800925925926,51,999,866,1865
2020-12-23 00:35:03,0.03914351851851852,1,20,2,22
2020-12-23 00:36:14,0.054224537037037036,1,6,4,10
2020-12-22 19:24:56,0.06680555555555556,1,2,2,4
2020-12-22 23:04:52,0.25145833333333334,1,1,1,2
2020-12-22 22:57:47,0.26667824074074076,9,53,81,134
2020-12-22 16:14:32,0.22341435185185185,2,16,5,21
2020-12-22 04:12:12,0.27868055555555554,1,11,9,20
2020-12-21 17:22:18,0.3882291666666667,5,82,58,140
2020-12-29 15:08:24,8.414039351851851,1,5,5,10
2020-12-29 15:08:07,8.415011574074073,1,3,3,6
2020-12-30 03:13:57,0.5015972222222222,1,37,51,88
2020-12-30 10:19:17,0.2349189814814815,1,50,29,79
2020-12-29 15:06:18,8.414293981481482,1,64,72,136
2020-12-29 15:04:49,8.414270833333333,1,5,5,10
2020-12-30 03:39:39,0.5169328703703704,1,4,4,8
2020-12-30 03:17:11,0.5018634259259259,1,5,5,10
2020-12-30 03:17:39,0.505162037037037,1,2,2,4
2020-12-30 03:17:57,0.5245023148148148,1,5,4,9
2020-12-22 16:13:56,1.5162847222222222,1,167,99,266
2020-12-20 23:47:02,0.07947916666666667,1,1,1,2
2020-12-26 22:52:46,6.273761574074074,2,38,16,54
2020-12-20 17:05:04,0.22174768518518517,1,5,0,5
2020-12-20 17:25:00,0.2494560185185185,5,6,7,13
2020-12-19 12:34:17,0.48085648148148147,1,2,2,4
2020-12-19 01:23:43,0.0109375,1,18,18,36
2020-12-19 02:13:51,0.07313657407407408,1,29,3,32
2020-12-22 23:10:59,3.9855439814814817,250,14924,8878,23802
2020-12-18 23:19:15,0.012233796296296296,1,3,1,4
2020-12-18 23:28:38,0.023136574074074073,1,80,45,125
2020-12-18 22:26:26,9.100775462962963,6,116,24,140
2020-12-18 16:51:25,0.16815972222222222,2,23,3,26
2020-12-18 08:46:59,0.005011574074074074,1,1,1,2
2020-12-18 08:57:55,0.015162037037037036,1,2,2,4
2020-12-18 08:43:34,0.01150462962962963,1,1,0,1
2020-12-18 07:47:37,0.04650462962962963,1,86,2,88
2020-12-18 07:30:42,0.05061342592592592,1,48,4,52
2020-12-18 23:21:02,2.860266203703704,250,15019,12833,27852
2020-12-15 11:57:25,0.05739583333333333,1,1,1,2
2020-12-14 08:08:09,0.032337962962962964,1,12,2,14
2020-12-29 15:01:58,15.405104166666666,1,2,2,4
2020-12-29 15:01:25,15.406435185185185,1,5,5,10
2020-12-29 14:51:48,15.40045138888889,1,5,5,10
2020-12-30 04:08:18,0.04303240740740741,1,67,49,116
2020-12-29 14:55:33,15.404618055555556,1,3,3,6
2020-12-29 14:50:37,15.401423611111111,1,5,5,10
2020-12-30 10:19:42,0.2876273148148148,1,5,5,10
2020-12-29 14:47:53,15.401030092592592,1,7,8,15
2020-12-29 14:47:27,15.401076388888889,1,5,5,10
2020-12-29 14:47:09,15.403032407407407,1,36,27,63
2020-12-29 14:45:23,15.403125,1,6,6,12
2020-12-14 04:09:15,0.05284722222222222,1,2,2,4
2020-12-14 09:03:10,0.4934722222222222,1,52,8,60
2020-12-14 08:37:59,8.58070601851852,1,2,0,2
2020-12-15 02:17:07,3.968935185185185,1,3,3,6
2020-12-15 02:04:04,4.488564814814815,1,15,0,15
2020-12-09 18:16:30,0.09,1,7,1,8
2020-12-09 03:33:33,0.6071875,1,3,1,4
2020-12-08 23:24:14,0.5083217592592593,2,5,5,10
2020-12-08 11:07:55,0.18621527777777777,1,1,1,2
2020-12-09 03:34:18,0.8907291666666667,1,11,11,22
2020-12-07 19:07:24,0.021875,1,3,1,4
2020-12-29 15:00:47,22.40976851851852,1,5,5,10
2020-12-29 14:43:59,22.39902777777778,1,5,5,10
2020-12-29 14:41:31,22.39810185185185,1,5,5,10
2020-12-30 11:05:33,0.3238888888888889,1,1,1,2
2021-01-07 05:06:15,8.07599537037037,1,32,17,49
2020-12-07 11:08:31,0.3219212962962963,1,4,4,8
2020-12-07 18:36:36,0.7142824074074074,1,43,23,66
2020-12-07 02:23:43,0.09008101851851852,1,8,5,13
2020-12-07 01:32:28,0.06042824074074074,1,2,2,4
2020-12-07 03:29:38,0.14922453703703703,1,157,157,314
2020-12-14 08:06:34,7.378576388888889,1,326,166,492
2020-12-06 04:55:36,0.19229166666666667,1,0,4,4
2020-12-10 05:27:27,4.664282407407407,6,98,33,131
2020-12-04 03:22:36,0.03819444444444445,1,1,1,2
2020-12-02 20:21:44,0.2508449074074074,1,5,2,7
2020-12-15 05:28:15,12.646435185185185,4,25,14,39
2020-12-04 01:23:51,1.4789467592592593,1,49,3,52
2020-12-02 20:19:41,0.2975925925925926,1,1,1,2
2020-12-01 11:34:34,0.1291898148148148,1,0,6,6
2020-12-02 20:20:01,1.5070717592592593,1,5,0,5
2020-12-01 05:45:58,0.0004861111111111111,1,0,20,20
2020-11-30 22:02:32,0.1796875,1,8,1,9
2020-12-29 14:40:13,29.390243055555555,1,2,2,4
2020-12-30 02:55:59,0.5065740740740741,1,7,7,14
2020-12-29 15:05:31,29.413657407407406,1,5,5,10
2020-12-29 15:13:49,0.03048611111111111,1,3,3,6
2020-12-29 14:40:36,29.396747685185186,1,5,3,8
2020-12-29 14:34:38,29.392789351851853,1,9,10,19
2020-12-29 14:32:38,29.392060185185183,1,3,3,6
2020-12-29 14:31:59,29.392118055555557,1,25,6,31
2020-12-29 14:28:59,29.39005787037037,1,3,3,6
2020-12-29 14:28:31,29.39050925925926,1,5,5,10
2020-11-30 11:09:34,0.5306712962962963,1,16,10,26
2020-12-15 01:04:57,15.325462962962963,4,66,28,94
2020-11-29 08:20:02,0.11304398148148148,1,1,1,2
2020-12-01 05:38:06,3.213136574074074,1,179,3,182
2020-11-28 02:37:01,0.09101851851851851,1,5,2,7
2020-11-28 04:17:54,0.4456365740740741,1,6,2,8
2020-11-27 17:29:23,39.14618055555555,1,30,1,31
2020-11-27 14:41:44,0.39547453703703705,1,5,2,7
2020-11-27 14:41:59,0.4119212962962963,1,13,2,15
2020-12-16 02:24:56,5.861875,250,16928,7447,24375
2020-11-27 02:24:12,2.2642824074074075,1,337,144,481
2020-11-23 16:35:14,0.3413425925925926,4,19,13,32
2020-11-24 20:06:19,1.598587962962963,1,112,110,222
2020-11-23 08:00:24,0.11126157407407407,1,1,1,2
2020-11-23 08:03:38,0.11835648148148148,1,10,10,20
2020-11-23 08:07:57,0.12166666666666667,1,5,5,10
2020-11-23 12:03:44,0.15601851851851853,1,72,47,119
2020-11-23 08:05:05,0.12056712962962964,1,18,18,36
2020-11-23 07:59:46,0.11815972222222222,1,5,5,10
2020-11-23 08:04:48,0.1227199074074074,1,44,59,103
2020-11-23 12:02:48,0.15670138888888888,1,1,1,2
2020-11-23 08:02:31,0.12144675925925925,1,3,3,6
2020-11-23 08:00:55,0.12081018518518519,1,1,1,2
2020-11-23 16:50:17,0.5306828703703703,2,88,38,126
2020-11-27 14:48:32,4.468645833333333,1,97,46,143
2020-11-21 22:54:36,0.02761574074074074,1,2,16,18
2020-11-21 22:19:05,0.03789351851851852,1,21,1,22
2020-11-21 05:18:10,0.6231712962962963,1,38,2,40
2020-11-21 20:27:01,13.271076388888888,1,15,0,15
2020-11-19 18:52:07,0.030324074074074073,2,60,15,75
2020-11-19 16:42:47,0.6255092592592593,1,20,30,50
2020-11-18 23:23:47,0.12560185185185185,1,1,0,1
2020-11-18 17:01:58,0.1163425925925926,1,41,9,50
2020-12-15 17:43:55,29.09409722222222,3,56,27,83
2020-11-19 01:22:25,2.833321759259259,1,1,1,2
2020-11-19 01:25:13,2.8355439814814813,1,2,2,4
2020-11-19 01:28:32,2.841886574074074,1,2,2,4
2020-11-19 01:42:06,2.8524305555555554,1,3,3,6
2020-11-19 01:45:59,2.8554282407407405,1,1,1,2
2020-11-19 16:43:36,3.479363425925926,1,5,5,10
2020-11-19 01:56:05,2.8646527777777777,1,5,5,10
2020-11-19 02:08:21,2.873310185185185,1,7,7,14
2020-11-19 02:07:58,2.87380787037037,1,5,5,10
2020-11-19 16:43:59,3.4821875,1,3,3,6
2020-11-19 02:03:08,2.870648148148148,1,5,5,10
2020-11-19 01:44:39,2.8585300925925927,1,10,10,20
2020-11-19 01:34:32,2.851678240740741,1,5,5,10
2020-11-19 01:32:01,2.850115740740741,1,5,5,10
2020-11-15 13:24:55,0.34881944444444446,1,128,1,129
2020-11-16 04:16:40,1.0996527777777778,1,79,72,151
2020-11-19 16:38:07,4.827858796296296,1,60,1,61
2020-11-14 18:19:24,0.014467592592592593,1,1,2,3
2020-11-13 21:17:05,0.11354166666666667,1,2,1,3
2020-11-19 16:46:47,6.571261574074074,1,2,7,9
2020-11-12 16:43:12,0.20126157407407408,3,43,4,47
2020-11-12 15:58:01,0.22230324074074073,3,16,3,19
2020-11-11 04:36:23,0.017013888888888887,1,1,3,4
2020-11-11 04:36:29,0.022824074074074073,1,46,7,53
2020-11-11 00:18:43,0.25950231481481484,1,2,2,4
2020-11-10 13:44:17,0.061550925925925926,1,8,0,8
2020-11-26 13:42:13,15.9971875,250,16144,8390,24534
2020-11-10 11:15:55,0.13467592592592592,1,5,5,10
2020-11-10 09:29:31,0.0650462962962963,1,5,5,10
2020-11-10 09:28:56,0.06498842592592592,1,1,1,2
2020-11-10 14:03:20,0.2508796296296296,1,5,5,10
2020-11-10 12:30:35,0.18641203703703704,1,5,5,10
2020-11-10 10:04:36,0.08523148148148148,1,5,5,10
2020-11-10 14:36:56,0.17962962962962964,1,77,64,141
2020-11-11 00:37:46,0.5933912037037037,1,5,5,10
2020-11-10 10:05:51,0.08614583333333334,1,5,5,10
2020-11-11 00:33:30,0.42864583333333334,1,5,5,10
2020-11-10 14:04:28,0.15773148148148147,1,85,34,119
2020-11-11 00:36:17,0.42920138888888887,1,11,11,22
2020-11-19 16:47:20,0.6062037037037037,1,130,117,247
2020-11-10 12:51:23,0.2009375,1,15,15,30
2020-11-10 10:16:07,0.0931712962962963,1,5,5,10
2020-11-11 00:32:46,0.4088888888888889,1,288,337,625
2020-11-10 14:06:06,0.11280092592592593,1,20,20,40
2020-11-10 14:11:16,0.19431712962962963,1,3,3,6
2020-11-10 09:23:24,0.06076388888888889,1,3,3,6
2020-11-10 09:20:42,0.05890046296296296,1,3,3,6
2020-11-12 22:05:24,3.885798611111111,1,109,7,116
2020-11-10 07:53:55,1.3138310185185185,250,14696,11650,26346
2020-11-09 00:43:17,0.018900462962962963,2,51,769,820
2020-11-09 15:00:24,0.6413541666666667,1,38,10,48
2020-11-09 00:41:53,0.06571759259259259,1,3,0,3
2020-11-08 17:29:49,0.13578703703703704,2,2,2,4
2020-11-19 16:39:48,11.12400462962963,2,9,5,14
2020-11-07 12:16:55,0.045717592592592594,2,14,6,20
2020-11-07 12:16:01,0.06719907407407408,1,2,2,4
2020-11-06 10:57:15,0.2922222222222222,1,9,1,10
2020-11-06 10:56:32,1.0554513888888888,1,79,39,118
2020-11-04 19:43:31,1.0136226851851853,3,53,20,73
2020-11-04 20:15:23,1.2924189814814815,2,3,2,5
2020-11-03 05:06:46,0.09571759259259259,2,21,19,40
2020-11-04 14:38:07,2.3775347222222223,1,1,1,2
2020-11-04 19:44:10,0.09844907407407408,1,1,1,2
2020-11-04 14:39:03,2.388113425925926,1,1,1,2
2020-11-04 15:23:06,2.4208796296296295,1,5,5,10
2020-11-04 14:41:46,2.3925810185185186,1,5,5,10
2020-11-04 15:06:38,2.410023148148148,1,10,10,20
2020-11-04 15:07:04,2.4109606481481483,1,13,13,26
2020-11-04 15:07:59,2.411875,1,18,26,44
2020-11-04 15:13:16,2.415798611111111,1,5,5,10
2020-11-04 14:48:29,2.400266203703704,1,5,5,10
2020-11-04 14:43:16,2.3970949074074075,1,5,5,10
2020-11-01 17:31:40,0.10152777777777777,1,1,1,2
2020-11-02 05:16:52,0.8074652777777778,1,1,1,2
2020-11-01 05:34:43,0.6140277777777777,1,1,1,2
2020-11-19 16:40:19,19.767939814814813,1,1,1,2
2020-11-01 22:38:32,2.4667476851851853,3,14,6,20
2020-11-02 20:16:39,3.43869212962963,14,2177,171,2348
2020-10-30 12:09:51,0.34185185185185185,1,1,1,2
2020-10-30 12:09:20,1.2004166666666667,2,4101,1514,5615
2020-10-27 12:34:02,0.1580902777777778,1,4,0,4
2020-10-27 02:00:48,0.30505787037037035,1,11,9,20
2020-11-04 20:15:46,9.09,1,14,8,22
2020-10-27 02:05:50,0.36865740740740743,1,76,64,140
2020-10-27 02:00:07,0.3964814814814815,1,1,1,2
2020-10-27 01:58:47,0.41707175925925927,1,23,29,52
2020-10-26 14:41:29,0.039907407407407405,1,13,7,20
2020-10-26 17:40:38,0.5109027777777778,1,1,1,2
2020-10-26 17:41:15,0.5119907407407407,1,2,2,4
2020-10-26 17:43:20,0.5139814814814815,1,1,1,2
2020-10-26 17:43:58,0.5179050925925925,1,18,10,28
2020-10-26 17:41:37,0.5167361111111111,1,1,1,2
2020-10-26 17:44:48,0.5193981481481481,1,1,1,2
2020-10-26 17:51:13,0.5239930555555555,1,11,21,32
2020-10-26 17:47:25,0.5217013888888888,1,5,5,10
2020-10-26 17:52:39,0.5260069444444444,1,5,5,10
2020-10-27 00:06:11,0.015983796296296298,1,278,300,578
2020-10-26 23:36:40,0.23269675925925926,1,60,18,78
2020-10-26 17:44:28,0.5231828703703704,1,5,5,10
2020-10-30 08:02:56,4.119618055555556,1,7,48,55
2020-10-26 17:54:32,0.5307175925925925,1,5,5,10
2020-10-23 12:21:32,0.0344212962962963,1,1,1,2
2020-10-23 12:22:17,0.04767361111111111,1,1,1,2
2020-10-21 23:36:07,0.050833333333333335,1,1,1,2
2020-10-20 07:13:40,0.6052083333333333,2,1,3,4
2020-10-19 15:02:14,0.2202662037037037,1,2,1,3
2020-10-30 07:56:00,11.111481481481482,1,77,51,128
2020-10-22 03:27:37,2.925335648148148,1,25,25,50
2020-10-22 03:28:25,2.926087962962963,1,1,1,2
2020-10-22 05:11:57,0.08747685185185185,1,18,26,44
2020-10-22 03:46:55,2.939224537037037,1,1,1,2
2020-10-22 05:27:11,0.09864583333333334,1,49,51,100
2020-10-22 06:35:49,0.11708333333333333,1,10,10,20
2020-10-22 03:46:26,2.9394444444444443,1,2,2,4
2020-11-04 17:21:06,5.387858796296296,2,19,19,38
2020-10-22 03:41:43,2.9366898148148146,1,1,1,2
2020-10-22 08:26:03,0.07244212962962963,1,300,345,645
2020-10-22 03:11:20,2.916851851851852,1,3,3,6
2020-10-22 02:57:31,2.9073148148148147,1,5,5,10
2020-10-22 04:14:51,0.05247685185185185,1,5,5,10
2020-10-22 02:50:02,0.44372685185185184,1,1,1,2
2020-10-22 08:51:57,0.013495370370370371,1,7,7,14
2020-10-22 02:45:56,2.9009027777777776,1,5,5,10
2020-10-22 02:45:04,2.9005555555555556,1,78,45,123
2020-10-22 02:41:49,2.8990625,1,16,10,26
2020-11-07 23:28:39,21.114930555555556,1,1045,200,1245
2020-10-16 19:41:44,0.5842013888888888,1,1,1,2
2020-10-15 14:24:48,0.8128240740740741,1,92,45,137
2020-10-13 20:41:00,0.35519675925925925,1,1,1,2
2020-10-15 19:24:59,2.6763310185185185,1,58,2,60
2020-10-13 06:16:46,1.0417476851851852,1,26,7,33
2020-10-13 06:22:56,1.0473148148148148,1,31,12,43
2020-10-13 06:23:28,1.0479166666666666,1,27,8,35
2020-10-13 06:50:07,1.0671064814814815,1,11,6,17
2020-10-13 06:47:41,1.0663541666666667,1,26,7,33
2020-10-13 07:41:48,0.04079861111111111,1,5,5,10
2020-10-13 06:49:46,1.0703703703703704,1,36,26,62
2020-10-13 11:19:39,0.1842824074074074,1,91,91,182
2020-10-13 06:49:17,1.0710648148148147,1,14,6,20
2020-10-13 06:45:38,1.0696759259259259,1,7,7,14
2020-10-13 06:27:17,1.0571296296296295,1,1,1,2
2020-10-12 14:33:50,3.6639814814814815,1,530,21,551
2020-10-09 15:12:53,0.8104513888888889,1,2,1,3
2020-11-19 16:48:14,43.05222222222222,4,147,1,148
2020-10-07 22:35:28,0.4554166666666667,1,3,3,6
2020-10-06 19:29:23,0.06755787037037037,1,1,1,2
2020-10-07 13:53:43,0.022407407407407407,1,299,322,621
2020-10-07 11:32:39,0.754375,1,5,5,10
2020-10-07 11:33:20,0.7549421296296296,1,5,5,10
2020-10-07 14:24:57,0.017488425925925925,1,43,21,64
2020-10-07 11:32:07,0.7543981481481481,1,5,5,10
2020-10-07 11:31:55,0.754537037037037,1,5,5,10
2020-10-07 11:29:20,0.7529050925925926,1,78,28,106
2020-10-06 17:16:31,0.34803240740740743,1,2,2,4
2020-10-06 08:49:57,0.03630787037037037,1,1,1,2
2020-10-05 20:04:07,0.058263888888888886,1,1,1,2
2020-10-06 08:00:01,1.0934027777777777,1,3,3,6
2020-10-06 08:14:06,1.1039467592592593,1,21,21,42
2020-10-06 08:15:27,1.1056481481481482,1,3,3,6
2020-10-06 08:15:12,1.1154629629629629,1,7,7,14
2020-10-06 08:13:27,1.1184837962962964,1,5,5,10
2020-10-06 08:12:01,1.1203587962962962,1,1,1,2
2020-10-06 08:07:51,1.1179166666666667,1,3,3,6
2020-10-06 07:56:14,1.1130555555555555,1,8,8,16
2020-10-06 08:00:20,1.1180787037037037,1,1,1,2
2020-10-06 08:40:10,0.029583333333333333,1,1,1,2
2020-10-06 08:00:44,1.1194212962962964,1,5,5,10
2020-10-06 08:04:56,1.123761574074074,1,5,5,10
2020-10-06 08:06:24,1.125173611111111,1,1,1,2
2020-10-06 08:17:28,1.1330324074074074,1,1,1,2
2020-10-06 08:17:37,1.1357175925925926,1,3,3,6
2020-10-05 00:57:39,0.0159375,1,124,4,128
2020-10-07 22:34:58,2.965011574074074,1,114,67,181
2020-10-04 13:02:37,0.5197916666666667,1,19,9,28
2020-10-01 02:17:46,1.4641666666666666,2,10,4,14
2020-11-12 17:35:24,42.92791666666667,1,1,1,2
2020-09-30 12:32:00,0.27019675925925923,1,1,1,2
2020-09-30 17:31:18,1.2242708333333334,1,2,2,4
2020-10-01 06:33:25,2.0014814814814814,1,1,3,4
2020-09-29 13:30:57,0.6121643518518518,1,4,0,4
2020-09-28 19:44:30,0.04100694444444444,1,1,1,2
2020-09-28 16:11:55,0.05853009259259259,1,1,1,2
2020-09-29 06:03:54,1.0127430555555557,1,6,6,12
2020-10-01 06:40:30,3.042013888888889,1,7,14,21
2020-09-28 19:05:12,0.5631828703703704,1,3,3,6
2020-09-29 06:15:52,0.46130787037037035,1,13,13,26
2020-09-28 19:05:52,0.5679861111111111,1,3,3,6
2020-09-28 19:06:28,0.5723958333333333,1,1,1,2
2020-09-28 19:07:06,0.5736689814814815,1,3,3,6
2020-09-29 05:59:32,1.027835648148148,1,10,8,18
2020-09-28 18:53:05,0.5652546296296296,1,3,3,6
2020-09-28 19:11:44,0.5784490740740741,1,1,1,2
2020-09-28 19:10:12,0.5774537037037037,1,3,3,6
2020-09-28 18:52:47,0.5657175925925926,1,1,1,2
2020-09-28 19:09:26,0.5783564814814814,1,1,1,2
2020-09-28 19:07:43,0.5775231481481482,1,1,1,2
2020-09-28 19:04:37,0.5757060185185185,1,9,24,33
2020-09-28 19:11:56,0.5816203703703704,1,5,5,10
2020-09-29 06:11:37,1.039976851851852,1,5,5,10
2020-10-01 06:34:26,3.060300925925926,1,26,18,44
2020-09-28 11:29:44,1.4612037037037038,1,648,58,706
2020-09-27 20:00:44,0.029722222222222223,1,1,1,2
2020-09-24 21:32:13,0.05247685185185185,1,1,0,1
2020-09-23 14:01:55,0.05461805555555556,2,8,8,16
2020-11-19 16:37:50,58.12921296296296,3,625,0,625
2020-09-22 13:30:42,0.08813657407407408,1,19,2,21
2020-09-22 07:53:01,0.060335648148148145,1,1,1,2
2020-12-17 05:51:49,86.56174768518518,3,111,4,115
2020-09-21 18:37:20,0.10731481481481482,1,1,1,2
2020-09-21 12:29:34,0.28087962962962965,1,6,6,12
2020-09-22 05:47:10,0.7184953703703704,1,14,14,28
2020-09-21 11:18:35,0.23902777777777778,1,3,3,6
2020-09-21 12:30:29,0.2901273148148148,1,3,3,6
2020-09-22 07:53:56,0.7645717592592592,1,35,19,54
2020-09-21 12:29:07,0.2917361111111111,1,7,16,23
2020-09-21 12:31:47,0.29628472222222224,1,6,11,17
2020-09-22 05:33:38,1.006539351851852,1,1,1,2
2020-09-21 12:28:36,0.29560185185185184,1,3,3,6
2020-09-22 07:53:25,1.1052430555555555,1,3,3,6
2020-09-21 12:27:40,0.2957638888888889,1,3,3,6
2020-09-22 05:35:31,1.0131018518518518,1,1,1,2
2020-09-22 05:35:46,1.0135648148148149,1,1,1,2
2020-09-22 05:36:46,1.0150115740740742,1,6,6,12
2020-09-22 05:33:00,1.0131712962962962,1,1,3,4
2020-09-22 05:31:40,1.0142592592592592,1,3,3,6
2020-09-21 12:26:49,0.3026273148148148,1,3,3,6
2020-09-22 13:23:37,1.342523148148148,1,4,4,8
2020-09-22 05:30:54,1.014502314814815,1,1,1,2
2020-09-21 07:13:00,0.0857175925925926,1,13,13,26
2020-09-21 12:25:54,0.21663194444444445,1,6,6,12
2020-09-21 07:12:12,0.08565972222222222,1,3,3,6
2020-09-21 07:11:56,0.08603009259259259,1,3,3,6
2020-09-21 07:10:15,0.08524305555555556,1,5,5,10
2020-09-21 15:48:55,0.8212615740740741,1,3,2,5
2020-09-26 18:57:08,7.294756944444444,2,227,33,260
2020-09-16 18:17:41,0.21212962962962964,1,1,1,2
2020-09-16 18:17:17,0.21699074074074073,1,1,1,2
2020-09-16 18:33:18,0.5210648148148148,1,8,8,16
2020-09-16 18:16:46,0.6705439814814815,1,3,3,6
2020-09-15 07:24:25,0.4482291666666667,1,5,0,5
2020-11-12 22:05:02,59.34590277777778,1,78,40,118
2020-09-14 13:05:23,0.07165509259259259,2,18,4,22
2020-09-14 11:04:30,0.057951388888888886,2,4,27,31
2020-09-15 14:15:11,1.2995023148148148,1,3,3,6
2020-09-15 14:17:33,1.3032291666666667,1,3,3,6
2020-09-16 03:48:13,1.8707060185185185,1,44,3,47
2020-09-15 14:20:06,1.3119097222222222,1,5,5,10
2020-09-14 13:03:12,0.2642361111111111,1,6,6,12
2020-09-16 03:47:03,0.5562847222222222,1,6,6,12
2020-09-14 13:08:14,0.2723148148148148,1,38,38,76
2020-09-16 18:34:11,2.4994560185185186,1,11,27,38
2020-09-14 13:02:42,0.2701851851851852,1,4,4,8
2020-09-15 14:16:58,1.0411458333333334,1,1,1,2
2020-09-15 14:14:40,1.3206597222222223,1,1,1,2
2020-09-15 14:14:16,1.042650462962963,1,1,1,2
2020-09-16 18:39:06,2.504814814814815,1,1,1,2
2020-09-15 14:13:32,1.322199074074074,1,1,1,2
2020-09-16 18:40:13,2.224479166666667,1,3,3,6
2020-09-15 14:13:13,1.3234143518518517,1,1,1,2
2020-09-14 13:04:01,0.27564814814814814,1,3,3,6
2020-09-16 03:45:53,1.8889351851851852,1,3,3,6
2020-09-13 10:52:18,0.5213310185185185,1,1,1,2
2020-09-12 15:09:50,0.24371527777777777,3,8,6,14
2020-09-11 12:06:54,0.038796296296296294,1,3,3,6
2020-09-10 17:08:03,0.062407407407407404,1,33,2,35
2020-09-11 18:56:36,1.901863425925926,1,59,112,171
2020-09-09 22:07:19,0.03810185185185185,1,61,42,103
2020-09-11 13:16:29,1.6716435185185186,1,79,30,109
2020-09-08 01:41:17,0.2610300925925926,1,235,123,358
2020-09-07 15:47:41,0.04023148148148148,1,10,10,20
2020-09-07 16:00:16,0.1197337962962963,4,11,13,24
2020-09-07 20:05:25,0.5641898148148148,1,5,5,10
2020-09-07 20:09:19,0.5691550925925926,1,3,3,6
2020-09-07 20:45:50,0.5952546296296296,1,3,3,6
2020-09-07 20:13:05,0.5804976851851852,1,29,56,85
2020-09-07 20:17:09,0.5845486111111111,1,5,5,10
2020-09-08 00:43:23,0.16416666666666666,1,7,7,14
2020-09-07 20:17:47,0.5880439814814815,1,3,3,6
2020-09-07 20:22:50,0.5915972222222222,1,1,1,2
2020-09-07 23:23:13,0.12924768518518517,1,2,2,4
2020-09-07 20:22:34,0.592037037037037,1,1,1,2
2020-09-07 20:21:02,0.5911689814814814,1,1,1,2
2020-09-07 23:22:55,0.1341087962962963,1,4,4,8
2020-09-07 20:19:04,0.5911111111111111,1,9,9,18
2020-09-07 20:18:11,0.591400462962963,1,3,3,6
2020-09-07 20:15:39,0.5906018518518519,1,1,1,2
2020-09-07 20:12:17,0.5886574074074075,1,3,3,6
2020-09-07 20:22:10,0.5966782407407407,1,28,23,51
2020-09-07 20:11:21,0.5906828703703704,1,1,1,2
2020-09-07 20:10:50,0.5905324074074074,1,2,2,4
2020-09-07 20:09:45,0.5899768518518519,1,1,1,2
2020-09-07 20:08:59,0.5901388888888889,1,1,1,2
2020-09-07 20:06:24,0.5887847222222222,1,2,2,4
2020-09-07 20:08:18,0.5902662037037038,1,5,5,10
2020-09-04 18:22:41,0.18439814814814814,1,5,96,101
2020-09-04 18:22:27,0.18635416666666665,1,11,11,22
2020-09-07 09:02:05,2.8015393518518517,1,429,378,807
2020-09-04 06:49:57,0.025798611111111112,1,0,8,8
2020-09-15 12:37:59,12.569305555555555,1,529,282,811
2020-09-26 18:57:40,24.183425925925928,1,9,1,10
2020-09-02 16:42:50,0.10219907407407407,1,19,6,25
2020-09-01 22:17:59,0.43583333333333335,1,2,1,3
2020-09-01 00:58:51,0.0008680555555555555,1,1,1,2
2020-08-31 21:30:28,0.021597222222222223,1,31,2,33
2020-09-01 11:30:43,0.6311111111111111,1,3,25,28
2020-08-31 16:11:27,0.04133101851851852,1,3,3,6
2020-08-31 22:26:11,0.32461805555555556,2,86,174,260
2020-08-31 16:11:38,0.21307870370370371,2,23,16,39
2020-09-01 01:35:57,0.7713425925925926,1,3,3,6
2020-09-01 01:21:17,0.7734606481481482,1,3,3,6
2020-09-01 00:54:35,0.7584837962962963,1,1,3,4
2020-09-01 01:22:03,0.7785532407407407,1,7,24,31
2020-09-01 00:55:17,0.7608217592592592,1,3,3,6
2020-09-01 00:55:49,0.7619791666666667,1,1,1,2
2020-09-01 01:24:38,0.7821296296296296,1,37,7,44
2020-09-01 00:56:09,0.7626736111111111,1,1,1,2
2020-09-01 01:24:57,0.7835185185185185,1,3,3,6
2020-09-01 01:26:56,0.7861921296296296,1,3,3,6
2020-09-01 01:27:21,0.7869675925925926,1,3,3,6
2020-09-01 00:56:32,0.7658101851851852,1,2,2,4
2020-09-01 01:27:50,0.7880902777777777,1,3,3,6
2020-09-01 00:56:53,0.7671875,1,6,6,12
2020-09-01 01:35:28,0.7955671296296296,1,5,5,10
2020-09-01 00:57:12,0.7721064814814815,1,1,1,2
2020-09-01 01:33:16,0.7998148148148149,1,4,4,8
2020-08-31 10:47:10,0.2785648148148148,2,14,14,28
2020-08-30 14:45:50,1.1711574074074074,2,12,7,19
2020-08-29 23:54:32,0.05310185185185185,1,1,1,2
2020-08-30 10:34:20,0.5151041666666667,1,166,14,180
2020-08-30 10:33:59,0.5192939814814815,1,6,4,10
2020-08-28 10:31:57,0.03275462962962963,2,44,48,92
2020-08-28 10:30:00,0.03140046296296296,1,2,14,16
2020-08-28 10:30:24,0.06612268518518519,1,2,5,7
2020-08-28 07:27:34,0.21813657407407408,1,2,5,7
2020-08-25 15:02:04,0.11202546296296297,1,10,11,21
2020-08-25 11:39:36,0.095625,1,2,4,6
2020-08-24 23:21:00,0.16060185185185186,1,0,1,1
2020-08-24 23:21:12,0.3510185185185185,1,22,0,22
2020-08-24 16:09:47,0.1489699074074074,1,1,1,2
2020-08-24 14:56:22,0.04563657407407407,1,2,0,2
2020-08-25 12:48:40,1.2055439814814815,1,3,3,6
2020-08-26 00:41:38,0.40172453703703703,1,3,3,6
2020-08-25 16:12:14,0.1492013888888889,1,14,14,28
2020-08-25 12:44:11,1.2059375,1,3,3,6
2020-08-25 15:41:16,0.13190972222222222,1,5,5,10
2020-08-25 16:53:33,0.16863425925925926,1,9,9,18
2020-08-25 15:01:46,0.11325231481481482,1,20,20,40
2020-08-25 12:43:01,1.2071643518518518,1,3,3,6
2020-08-25 12:32:29,1.2009375,1,5,5,10
2020-08-25 12:38:21,1.207476851851852,1,3,3,6
2020-08-25 12:35:58,1.2060763888888888,1,12,12,24
2020-08-25 12:33:31,0.9022106481481481,1,5,5,10
2020-08-25 12:51:52,1.2214930555555557,1,17,28,45
2020-08-25 12:30:11,1.2073148148148147,1,17,17,34
2020-08-25 12:15:39,1.1991782407407408,1,5,87,92
2020-08-25 12:13:40,1.198761574074074,1,11,11,22
2020-08-25 12:13:13,1.1989699074074074,1,3,3,6
2020-08-25 16:32:54,0.16158564814814816,1,5,5,10
2020-08-25 12:10:02,1.1991435185185184,1,5,5,10
2020-08-25 12:02:07,1.228900462962963,1,1,1,2
2020-08-25 11:59:40,1.2280439814814814,1,5,5,10
2020-08-25 11:58:59,1.2292361111111112,1,5,5,10
2020-08-25 11:57:45,1.2289583333333334,1,3,3,6
2020-08-25 11:53:10,0.8787731481481481,1,1,1,2
2020-08-25 11:45:58,0.8737847222222223,1,3,1,4
2020-08-25 11:49:21,0.8761111111111111,1,1,1,2
2020-08-25 11:44:59,0.8731597222222223,1,2,2,4
2020-08-22 22:08:13,0.2971412037037037,1,0,2,2
2020-08-22 14:09:18,0.01326388888888889,1,186,182,368
2020-08-24 12:06:46,4.172696759259259,1,2,10,12
2020-08-21 12:14:29,1.7793981481481482,1,3,3,6
2020-08-19 17:02:07,0.07133101851851852,2,37,2,39
2020-08-19 17:00:47,0.8850694444444445,1,2,2,4
2020-08-22 22:08:32,4.855520833333333,1,26,26,52
2020-08-20 20:28:15,3.5781134259259257,1,11,6,17
2020-08-20 20:29:36,3.5796296296296295,1,3,3,6
2020-08-20 20:31:28,3.5884027777777776,1,3,3,6
2020-08-20 20:16:58,3.578472222222222,1,5,5,10
2020-08-20 20:16:10,3.5792361111111113,1,1,1,2
2020-08-22 13:48:24,1.7214351851851852,1,11,11,22
2020-08-20 20:23:53,3.588923611111111,1,3,3,6
2020-08-20 20:12:03,3.5810648148148148,1,382,314,696
2020-08-20 20:15:39,3.584490740740741,1,1,1,2
2020-08-20 20:14:31,3.584108796296296,1,5,5,10
2020-08-20 20:11:37,3.5861805555555555,1,1,1,2
2020-08-20 20:11:10,3.5870023148148147,1,8,8,16
2020-08-16 18:37:55,0.054282407407407404,1,1,1,2
2020-08-14 16:04:00,0.23255787037037037,1,0,10,10
2020-12-15 11:56:44,123.05965277777777,1,26,106,132
2020-08-13 10:04:29,0.061203703703703705,1,1,1,2
2020-12-15 16:23:58,125.07299768518519,4,13,7,20
2020-08-12 13:36:08,0.041157407407407406,1,6,3,9
2020-08-12 10:40:26,0.05644675925925926,2,29,13,42
2020-08-12 10:11:16,0.04966435185185185,3,21,9,30
2020-08-11 21:09:14,0.05554398148148148,6,16,5,21
2020-08-24 16:21:08,14.142372685185185,8,137,84,221
2020-08-16 17:08:27,6.445486111111111,1,40,33,73
2020-08-16 17:29:11,6.4627893518518515,1,3,49,52
2020-08-16 17:32:07,6.4688888888888885,1,3,3,6
2020-08-16 17:25:21,6.464861111111111,1,1,1,2
2020-08-16 17:29:34,6.468842592592592,1,1,1,2
2020-08-16 17:32:29,6.471354166666667,1,1,1,2
2020-08-16 17:22:36,6.467905092592592,1,1,1,2
2020-08-16 17:24:46,6.470219907407407,1,1,1,2
2020-08-16 17:21:53,6.468715277777778,1,1,1,2
2020-08-16 17:18:25,6.466875,1,4,4,8
2020-08-16 17:20:01,6.468414351851852,1,10,3,13
2020-08-16 17:17:01,6.468090277777778,1,3,3,6
2020-08-16 17:16:13,6.467800925925926,1,1,1,2
2020-08-09 23:51:07,0.4484722222222222,1,4,4,8
2020-08-09 23:50:44,0.4508564814814815,1,1,5,6
2020-08-09 13:23:43,0.12304398148148148,1,1,1,2
2020-08-08 15:57:57,0.7423263888888889,1,1,1,2
2020-08-11 16:25:00,3.8688541666666665,1,798,305,1103
2020-08-07 08:40:34,0.2155439814814815,1,2,2,4
2020-08-06 15:34:13,1.0152662037037037,1,3,3,6
2020-08-24 12:11:47,19.684895833333332,2,62,12,74
2020-08-05 20:39:15,1.053587962962963,1,24,16,40
2020-10-21 16:04:10,79.02826388888889,14,828,357,1185
2020-08-06 15:34:49,3.344780092592593,1,5,5,10
2020-08-04 20:30:04,1.550289351851852,1,45,24,69
2020-08-06 15:37:51,3.3485416666666667,1,7,7,14
2020-08-06 15:39:59,3.350787037037037,1,3,3,6
2020-08-06 15:36:08,3.3500694444444443,1,3,3,6
2020-08-04 20:28:08,1.5529861111111112,1,68,32,100
2020-08-04 20:30:55,1.5568055555555556,1,5,5,10
2020-08-06 15:41:08,3.356238425925926,1,13,18,31
2020-08-04 20:31:58,1.5589583333333332,1,2,2,4
2020-08-06 15:39:33,3.3561805555555555,1,21,14,35
2020-08-06 15:38:46,3.3566319444444446,1,3,3,6
2020-08-06 15:36:48,1.7919097222222222,1,358,260,618
2020-08-06 15:35:33,3.36125,1,1,1,2
2020-08-04 20:24:04,1.562199074074074,1,1,1,2
2020-08-02 17:03:10,0.018564814814814815,1,4,4,8
2020-08-02 16:47:10,0.021805555555555557,1,4,4,8
2020-08-02 09:19:43,0.18126157407407406,1,16,1,17
2020-08-02 09:20:03,0.8960416666666666,1,10,1,11
2020-08-01 16:20:37,0.2973032407407407,2,98,14,112
2020-08-02 09:20:32,1.6265393518518518,1,1,1,2
2020-08-24 12:13:45,25.88224537037037,2,12,10,22
2020-08-24 14:46:28,46.03818287037037,12,2049,593,2642
2020-08-02 09:20:18,4.642708333333333,1,3,2,5
2020-08-02 16:47:45,5.04425925925926,3,6,4,10
2020-07-28 17:19:00,0.06010416666666667,1,3,3,6
2020-08-02 09:21:29,5.619212962962963,1,4,1,5
2020-07-28 19:52:35,0.16527777777777777,2,104,160,264
2020-07-27 18:08:35,0.03241898148148148,1,3,3,6
2020-08-02 09:21:11,5.694849537037037,2,28,1,29
2020-07-27 18:21:31,0.33524305555555556,1,26,11,37
2020-07-27 18:08:59,0.33042824074074073,1,3,3,6
2020-07-27 18:18:47,0.33924768518518517,1,6,6,12
2020-07-27 18:26:13,0.4686458333333333,1,3,3,6
2020-07-27 18:17:26,0.4638888888888889,1,3,3,6
2020-07-27 21:56:48,0.1868287037037037,1,1,1,2
2020-07-27 22:02:00,0.6200578703703704,1,4,3,7
2020-07-28 15:50:25,0.6068287037037037,1,10,20,30
2020-07-28 01:12:56,0.29065972222222225,1,15,10,25
2020-07-28 15:59:30,0.7500462962962963,1,3,9,12
2020-07-27 18:00:36,0.4562847222222222,1,3,3,6
2020-07-27 18:29:38,0.4764699074074074,1,3,3,6
2020-07-28 15:51:16,0.7406944444444444,1,9,13,22
2020-07-27 18:07:33,0.461875,1,1,1,2
2020-07-27 18:19:03,0.4700578703703704,1,1,1,2
2020-07-28 15:54:01,0.7456597222222222,1,3,3,6
2020-07-27 18:19:40,0.47094907407407405,1,3,3,6
2020-07-27 17:52:24,0.4521296296296296,1,3,3,6
2020-11-04 17:21:28,100.43133101851852,2,31,9,40
2020-07-27 17:25:07,0.43408564814814815,1,4,4,8
2020-07-27 17:27:31,0.4357986111111111,1,22,13,35
2020-07-27 17:37:08,0.4433912037037037,1,1,1,2
2020-07-27 17:41:22,0.44666666666666666,1,9,9,18
2020-07-27 17:28:58,0.43832175925925926,1,1,1,2
2020-07-27 17:53:08,0.4587731481481481,1,5,5,10
2020-07-28 03:24:53,0.37427083333333333,1,5,5,10
2020-07-27 18:29:06,0.48496527777777776,1,15,20,35
2020-09-01 01:04:01,34.38115740740741,2,203,32,235
2020-07-27 18:24:10,0.483287037037037,1,4,4,8
2020-07-27 17:54:09,0.4628009259259259,1,1,1,2
2020-07-28 15:51:50,0.6086342592592593,1,15,17,32
2020-07-27 17:50:40,0.46069444444444446,1,5,5,10
2020-07-27 21:57:35,0.18724537037037037,1,3,3,6
2020-07-27 21:00:01,0.1475,1,4,4,8
2020-07-27 18:31:33,0.49064814814814817,1,1,1,2
2020-07-27 18:31:03,0.49071759259259257,1,1,1,2
2020-07-27 17:48:41,0.4615740740740741,1,1,1,2
2020-07-27 17:26:13,0.44633101851851853,1,6,6,12
2020-07-28 01:18:02,0.30141203703703706,1,1,1,2
2020-07-27 18:25:15,0.48799768518518516,1,3,3,6
2020-10-12 23:19:14,98.28506944444445,1,79,0,79
2020-07-26 22:07:27,0.0032175925925925926,1,3,2,5
2020-07-26 21:58:37,0.2946875,1,5,1,6
2020-11-08 23:56:53,12.723113425925925,250,26970,12048,39018
2020-07-24 12:55:15,0.11037037037037037,1,30,24,54
2020-07-24 10:19:31,0.01287037037037037,1,2,2,4
2020-09-01 01:33:21,39.13560185185185,1,3,0,3
2020-07-24 16:47:25,0.7856365740740741,1,16,7,23
2020-10-12 23:19:36,81.3718287037037,3,46,24,70
2020-07-23 21:54:20,0.3619560185185185,1,8,0,8
2020-07-23 13:41:49,0.4858912037037037,1,2,1,3
2020-07-22 21:08:28,0.0006944444444444445,1,247,61,308
2020-07-22 20:48:52,0.1385763888888889,2,5,9,14
2020-07-22 09:44:02,1.710949074074074,2,88,37,125
2020-07-20 09:25:27,1.1291782407407407,1,25,14,39
2020-07-20 07:48:10,0.29467592592592595,1,0,1,1
2020-11-04 19:45:02,143.65583333333333,5,163,40,203
2020-07-22 09:43:18,4.412870370370371,2,39,7,46
2020-07-19 17:53:32,0.13480324074074074,2,7,3,10
2020-07-19 20:28:28,0.5946527777777778,3,9,7,16
2020-07-19 11:09:47,0.20836805555555554,1,1,1,2
2020-07-20 09:26:13,1.1297106481481483,2,3,3,6
2020-07-18 17:01:00,0.7664004629629629,1,6,5,11
2020-07-18 17:30:46,8.503298611111111,1,6,0,6
2020-07-18 16:55:37,0.9328125,1,1,1,2
2020-07-22 09:45:36,4.738969907407407,3,112,3,115
2020-07-18 17:01:17,1.4411689814814814,1,69,53,122
2020-07-17 05:08:23,0.3882175925925926,1,1,1,2
2020-07-16 20:01:35,0.03474537037037037,1,0,3,3
2020-07-17 05:07:55,0.60125,2,32,1,33
2020-07-17 05:07:19,0.6339930555555555,1,0,7,7
2020-07-24 10:46:47,5.725763888888889,250,19729,18978,38707
2020-07-28 04:43:18,0.31971064814814815,1,36,205,241
2020-07-28 01:14:29,0.3180208333333333,1,6,28,34
2020-07-27 20:54:32,0.14657407407407408,1,9,15,24
2020-07-27 22:11:27,0.19106481481481483,1,5,5,10
2020-07-27 20:59:18,0.1472800925925926,1,5,5,10
2020-07-27 20:57:12,0.14877314814814815,1,3,3,6
2020-07-27 21:59:50,0.18998842592592594,1,5,5,10
2020-07-27 20:56:28,0.14590277777777777,1,37,33,70
2020-08-25 13:50:47,28.848773148148148,4,4262,2020,6282
2020-07-27 20:55:09,0.14533564814814814,1,5,5,10
2020-07-17 05:06:46,1.323425925925926,1,5,5,10
2020-07-28 01:13:50,0.30530092592592595,1,3,3,6
2020-07-27 21:58:12,0.18688657407407408,1,5,5,10
2020-07-27 18:24:41,0.04386574074074074,1,3,3,6
2020-07-15 22:49:14,0.07504629629629629,250,16032,15986,32018
2020-07-15 19:07:28,0.10189814814814815,1,273,81,354
2020-07-15 19:11:22,0.17681712962962962,6,48,48,96
2020-07-15 19:07:54,0.20127314814814815,1,4,0,4
2020-07-15 12:43:50,0.3464583333333333,1,1,0,1
2020-07-15 12:43:20,0.8102546296296296,1,38,2,40
2020-07-14 16:50:20,0.02763888888888889,1,3,3,6
2020-07-13 17:33:11,0.14847222222222223,1,1,1,2
2020-07-15 19:08:20,2.3998032407407406,2,84,3,87
2020-07-14 16:10:36,1.6664467592592593,1,128,17,145
2020-07-12 20:11:49,0.17405092592592591,1,11,3,14
2020-07-12 20:11:31,0.4559837962962963,1,1,1,2
2020-07-12 13:22:49,0.2523726851851852,1,16,1,17
2020-07-11 21:51:23,0.3054861111111111,1,6,1,7
2020-07-14 17:05:07,3.1233912037037035,3,15,10,25
2020-07-15 12:59:27,4.7433101851851855,250,18678,18495,37173
2020-07-10 19:07:30,3.239386574074074,1,8,1,9
2020-07-10 20:09:43,0.04738425925925926,1,16,16,32
2020-07-10 20:09:29,0.0878587962962963,3,81,54,135
2020-07-10 11:57:05,0.12423611111111112,3,188,189,377
2020-07-10 10:25:45,0.0028935185185185184,1,3,0,3
2020-07-14 17:05:35,8.083472222222222,5,35,35,70
2020-07-09 20:32:37,0.041712962962962966,1,10,6,16
2020-07-10 16:04:19,1.0285300925925926,1,16,16,32
2020-07-09 10:53:16,0.5469560185185185,1,3,3,6
2020-07-09 13:09:20,0.721412037037037,3,49,17,66
2020-07-09 11:01:31,0.8383217592592592,1,102,125,227
2020-07-08 12:54:48,0.017951388888888888,1,1,1,2
2020-07-08 11:57:07,0.027210648148148147,1,50,29,79
2020-07-08 10:58:18,0.023599537037037037,1,1,1,2
2020-07-08 07:22:24,0.07081018518518518,1,1,1,2
2020-07-08 07:23:24,0.1729513888888889,1,18,8,26
2020-07-07 18:35:56,0.07563657407407408,1,2,2,4
2020-07-07 14:32:15,0.06584490740740741,1,10,2,12
2020-07-07 13:26:52,14.762199074074074,2,77,16,93
2020-07-07 13:26:40,13.628900462962964,1,27,11,38
2020-07-07 13:26:32,14.52050925925926,1,14,3,17
2020-07-07 11:46:23,0.02564814814814815,1,0,1,1
2020-07-08 21:53:57,1.7542708333333332,1,43,17,60
2020-07-07 08:55:19,0.37918981481481484,1,1,1,2
2020-07-06 23:33:39,0.10269675925925927,2,34,12,46
2020-07-06 21:08:29,0.17559027777777778,1,2,2,4
2020-07-07 10:14:20,1.431111111111111,1,132,3,135
2020-07-06 10:17:34,0.0275,1,1,1,2
2020-07-07 00:01:14,0.6156712962962962,1,3,1,4
2020-07-06 20:51:23,0.24380787037037038,1,154,283,437
2020-07-06 13:30:09,0.30431712962962965,1,3,3,6
2020-07-06 14:00:03,0.32675925925925925,1,27,21,48
2020-07-06 13:28:45,0.3051273148148148,1,3,3,6
2020-07-06 14:57:00,0.05832175925925926,1,13,13,26
2020-07-06 14:56:05,0.060821759259259256,1,11,47,58
2020-07-06 14:06:30,0.3335648148148148,1,16,9,25
2020-07-06 14:56:20,0.36864583333333334,1,1,9,10
2020-07-06 14:57:56,0.0621875,1,15,25,40
2020-07-06 14:01:09,0.33252314814814815,1,3,3,6
2020-07-06 20:50:42,0.24081018518518518,1,63,70,133
2020-07-06 14:17:51,0.34530092592592593,1,1,1,2
2020-07-06 14:18:06,0.34618055555555555,1,2,2,4
2020-07-06 14:18:26,0.34697916666666667,1,1,1,2
2020-07-06 14:24:01,0.3512615740740741,1,5,5,10
2020-07-06 14:19:05,0.34806712962962966,1,1,1,2
2020-07-06 13:07:47,0.2990625,1,6,6,12
2020-07-06 13:27:13,0.31353009259259257,1,549,433,982
2020-07-06 20:49:58,0.24099537037037036,1,8,8,16
2020-07-07 00:23:30,0.14318287037037036,1,3,122,125
2020-07-19 15:04:03,13.953599537037038,3,27,9,36
2020-07-05 16:28:26,1.039074074074074,1,283,242,525
2020-07-06 23:24:04,3.1739467592592594,2,183,236,419
2020-12-18 08:18:32,167.63782407407408,1,62,8,70
2020-07-03 19:01:39,0.1834837962962963,1,60,0,60
2020-07-03 11:27:03,0.017719907407407406,1,12,12,24
2020-07-03 11:26:36,0.4328125,1,15,15,30
2020-07-03 01:05:33,0.0010763888888888889,1,1,1,2
2020-07-03 01:06:09,0.4454166666666667,1,1,3,4
2020-07-02 14:27:36,0.018657407407407407,1,9,4,13
2020-07-10 18:57:22,6.460208333333333,250,14747,13209,27956
2020-07-01 21:38:45,0.028113425925925927,1,3,3,6
2020-07-01 09:34:20,0.1749074074074074,1,73,5,78
2020-07-01 17:05:22,0.8109722222222222,1,38,33,71
2020-07-01 11:51:51,0.8854282407407408,1,11,5,16
2020-06-30 04:18:39,0.08650462962962963,1,1,1,2
2020-07-01 11:52:06,1.4121643518518519,1,1,1,2
2020-06-30 21:58:03,0.9733101851851852,1,139,68,207
2020-06-29 15:59:04,0.08241898148148148,1,128,121,249
2020-06-29 11:57:45,0.13130787037037037,1,2,2,4
2020-06-29 12:47:43,0.25429398148148147,1,6,6,12
2020-06-29 16:24:46,0.14403935185185185,1,329,121,450
2020-06-30 04:18:26,0.08637731481481481,1,3,3,6
2020-06-29 12:44:33,0.26056712962962963,1,5,5,10
2020-06-29 12:49:49,0.2649537037037037,1,12,12,24
2020-06-29 12:55:23,0.26908564814814817,1,68,44,112
2020-06-29 12:50:13,0.26708333333333334,1,68,142,210
2020-06-29 13:44:44,0.04131944444444444,1,1,1,2
2020-06-29 16:24:56,0.14516203703703703,1,5,5,10
2020-06-29 13:43:35,0.30898148148148147,1,4,4,8
2020-06-29 13:45:51,0.31090277777777775,1,1,1,2
2020-06-29 12:43:32,0.26817129629629627,1,8,8,16
2020-06-28 18:55:33,0.013414351851851853,1,1,1,2
2020-06-29 11:58:08,1.0193865740740742,1,159,312,471
2020-06-27 18:20:12,0.25938657407407406,1,24,286,310
2020-06-30 17:19:51,2.1341666666666668,15,911,430,1341
2020-06-26 19:28:40,0.008206018518518519,1,19,14,33
2020-06-29 11:56:56,2.723912037037037,1,247,138,385
2020-07-01 11:51:16,4.95050925925926,3,86,11,97
2020-06-26 12:31:14,0.018680555555555554,1,3,10,13
2020-06-25 20:41:13,0.46326388888888886,1,5,0,5
2020-06-25 20:41:25,0.4628935185185185,1,1,1,2
2020-06-25 10:01:16,0.06886574074074074,1,38,83,121
2020-06-24 20:54:07,0.02101851851851852,1,0,6,6
2020-06-24 20:25:24,0.0178125,1,1,1,2
2020-06-24 23:33:02,0.41704861111111113,1,117,41,158
2020-06-25 20:44:20,2.088761574074074,1,29,22,51
2020-06-24 08:25:33,0.6908449074074074,2,140,38,178
2020-06-23 14:40:02,0.010821759259259258,1,1,1,2
2020-06-23 14:01:35,3.458449074074074,1,2,0,2
2020-06-23 15:24:30,0.09194444444444444,1,1,0,1
2020-06-25 20:42:02,2.4476851851851853,3,10,8,18
2020-06-25 20:44:00,159.55041666666668,4,191,137,328
2020-06-23 10:20:15,0.6775347222222222,3,132,121,253
2020-06-22 17:24:17,0.22993055555555555,1,3,0,3
2020-06-25 08:13:54,3.0761805555555557,1,6,41,47
2020-06-25 08:17:00,3.0792824074074074,1,3,3,6
2020-06-25 08:24:16,3.0849421296296295,1,64,32,96
2020-06-25 08:19:31,3.084224537037037,1,71,55,126
2020-06-25 08:21:07,3.0912847222222224,1,3,3,6
2020-06-25 08:22:36,3.0929398148148146,1,1,1,2
2020-06-25 08:49:35,3.1121527777777778,1,6,6,12
2020-06-25 08:33:00,3.102476851851852,1,5,5,10
2020-06-25 08:49:06,3.1139699074074074,1,2,2,4
2020-06-25 08:48:41,3.114363425925926,1,3,3,6
2020-06-25 08:47:35,3.114201388888889,1,3,3,6
2020-06-25 08:46:12,3.1144907407407407,1,1,1,2
2020-06-25 08:22:54,3.098715277777778,1,2,2,4
2020-06-21 10:41:38,0.8232407407407407,1,17,2,19
2020-06-20 11:30:28,0.14658564814814815,1,1,0,1
2020-06-20 11:30:41,0.5575231481481482,1,1,1,2
2020-06-21 00:27:20,1.4349189814814816,1,551,97,648
2020-06-19 17:18:48,0.014351851851851852,1,9,9,18
2020-06-29 11:58:49,17.21146990740741,8,1216,38,1254
2020-06-20 11:30:14,2.1119097222222223,1,12,8,20
2020-06-20 23:25:05,3.524826388888889,1,3,3,6
2020-06-25 08:40:05,0.01726851851851852,1,3,3,6
2020-06-20 23:32:24,3.532824074074074,1,3,3,6
2020-06-20 23:32:03,3.5353819444444445,1,3,3,6
2020-06-20 23:30:10,3.5371412037037038,1,5,5,10
2020-06-25 08:31:04,7.914375,1,3,3,6
2020-06-25 08:31:30,7.914907407407408,1,3,3,6
2020-06-20 23:27:51,3.538587962962963,1,3,3,6
2020-06-20 23:28:46,3.5425578703703704,1,1,1,2
2020-06-25 08:27:37,7.917025462962963,1,1,1,2
2020-06-25 08:27:11,7.919212962962963,1,1,1,2
2020-06-17 11:18:43,0.039074074074074074,1,1,1,2
2020-06-20 23:26:22,3.5449189814814814,1,3,3,6
2020-06-17 08:31:32,0.20193287037037036,1,2,0,2
2020-06-17 04:30:58,0.8101736111111111,1,3,3,6
2020-06-17 01:15:55,0.12729166666666666,1,1,1,2
2020-07-06 12:27:33,19.87070601851852,1,459,67,526
2020-06-15 14:43:31,0.04981481481481481,1,1,0,1
2020-06-15 14:48:16,0.35984953703703704,1,596,499,1095
2020-06-15 14:38:24,0.35660879629629627,1,30,14,44
2020-06-15 14:17:44,0.3424537037037037,1,3,3,6
2020-06-15 14:20:21,0.34565972222222224,1,3,3,6
2020-06-15 14:10:31,0.33903935185185186,1,3,3,6
2020-06-15 14:28:57,0.3525462962962963,1,1,1,2
2020-06-15 14:25:18,0.3505671296296296,1,8,23,31
2020-06-15 14:26:28,0.3514583333333333,1,6,6,12
2020-06-15 14:41:18,0.36255787037037035,1,1,1,2
2020-06-15 14:31:05,0.35724537037037035,1,1,1,2
2020-06-15 16:00:57,0.42006944444444444,1,3,3,6
2020-06-15 14:22:02,0.35172453703703704,1,3,3,6
2020-06-15 14:16:25,0.34792824074074075,1,3,3,6
2020-06-15 14:37:30,0.3630439814814815,1,13,13,26
2020-06-15 14:19:19,0.3511111111111111,1,25,8,33
2020-06-15 14:11:21,0.3469097222222222,1,3,3,6
2020-06-17 04:31:31,1.9454050925925925,2,3,3,6
2020-06-15 13:46:38,0.33145833333333335,1,1,1,2
2020-06-15 15:57:21,0.062314814814814816,1,4,4,8
2020-06-15 13:31:24,0.32373842592592594,1,8,8,16
2020-06-14 20:29:40,0.05739583333333333,1,584,8,592
2020-06-14 23:57:06,0.5470023148148148,1,1,0,1
2020-06-10 19:56:15,0.274537037037037,9,49,27,76
2020-06-10 11:57:14,0.0412037037037037,1,1,1,2
2020-06-10 11:57:31,1.0653703703703703,5,45,38,83
2020-06-09 18:53:21,0.3721527777777778,1,1,1,2
2020-06-09 08:23:07,0.7909259259259259,1,368,51,419
2020-06-08 06:10:38,0.03002314814814815,1,6,15,21
2020-06-08 06:57:07,0.03726851851851852,1,2,2,4
2020-06-08 06:03:46,0.034756944444444444,1,1,1,2
2020-06-08 06:02:44,0.034340277777777775,1,3,3,6
2020-06-08 06:02:11,0.0353125,1,3,3,6
2020-06-07 16:26:53,0.9390046296296296,1,8,8,16
2020-06-06 17:50:28,0.0722337962962963,1,6,6,12
2020-06-06 17:50:02,0.07322916666666666,1,25,19,44
2020-06-06 17:49:28,0.07363425925925926,1,1,8,9
2020-06-08 05:46:59,1.4966203703703704,1,1,1,2
2020-06-06 17:47:53,0.07486111111111111,1,72,55,127
2020-06-06 17:48:19,0.08584490740740741,1,2,2,4
2020-06-06 15:41:31,0.03085648148148148,2,21,17,38
2020-06-25 20:45:02,19.257951388888888,1,1,1,2
2020-06-06 15:41:45,0.07109953703703703,1,3,3,6
2020-06-09 08:32:32,2.864664351851852,1,13,2,15
2020-06-06 15:41:56,1.0584375,2,107,15,122
2020-06-05 21:10:42,0.3043402777777778,1,17,5,22
2020-06-05 23:29:20,0.06896990740740741,1,12,19,31
2020-06-05 22:01:16,0.3407986111111111,1,9,16,25
2020-06-05 21:59:38,0.34142361111111114,1,4,4,8
2020-06-05 21:59:16,0.34271990740740743,1,4,4,8
2020-06-05 22:27:30,0.028680555555555556,1,28,33,61
2020-06-06 00:31:46,0.10549768518518518,1,120,133,253
2020-06-05 21:58:42,0.3454050925925926,1,16,10,26
2020-06-05 21:58:11,0.34752314814814816,1,4,4,8
2020-06-05 21:57:58,0.3491782407407407,1,19,21,40
2020-06-05 21:57:01,0.35052083333333334,1,1,1,2
2020-06-05 21:56:07,0.3500347222222222,1,1,1,2
2020-06-05 21:50:29,0.3465509259259259,1,14,14,28
2020-06-05 21:49:14,0.34607638888888886,1,1,1,2
2020-06-05 21:47:46,0.345150462962963,1,28,128,156
2020-06-05 21:47:20,0.3451273148148148,1,4,3,7
2020-06-05 21:44:03,0.34596064814814814,1,1,1,2
2020-06-04 17:03:32,0.12258101851851852,2,28,0,28
2020-06-25 22:14:30,22.112627314814816,1,18,18,36
2020-06-03 18:32:16,0.016655092592592593,1,4,3,7
2020-06-05 13:23:28,2.058414351851852,2,9,4,13
2020-06-03 18:18:20,0.27618055555555554,1,2,1,3
2020-06-03 06:33:31,0.17232638888888888,1,2,1,3
2020-06-03 06:32:24,0.25221064814814814,1,12,0,12
2020-06-03 18:18:53,1.1606597222222221,1,2,9,11
2020-06-05 13:24:02,3.3984490740740743,2,18,28,46
2020-06-25 22:36:30,24.020011574074076,2,18,10,28
2020-06-02 01:24:05,0.048541666666666664,1,1,1,2
2020-06-03 18:19:15,1.9380324074074073,1,6,6,12
2020-06-09 08:28:03,7.630787037037037,1,8,2,10
2020-06-02 11:57:22,0.8675578703703704,1,2,2,4
2020-06-01 19:34:12,0.28998842592592594,1,1,1,2
2020-06-01 19:51:16,0.3021990740740741,1,1,1,2
2020-06-01 19:35:04,0.29172453703703705,1,1,1,2
2020-06-01 19:50:03,0.3028356481481482,1,2,2,4
2020-06-01 19:36:11,0.2956597222222222,1,1,1,2
2020-06-01 19:37:30,0.2969560185185185,1,1,1,2
2020-06-01 19:37:54,0.2986111111111111,1,555,382,937
2020-06-01 19:38:30,0.29944444444444446,1,2,2,4
2020-06-01 19:48:13,0.30625,1,3,3,6
2020-06-01 19:38:53,0.30094907407407406,1,1,1,2
2020-06-01 19:48:00,0.3076157407407407,1,1,1,2
2020-06-01 19:46:10,0.3068287037037037,1,1,1,2
2020-06-01 19:45:12,0.3071527777777778,1,3,3,6
2020-06-01 19:55:21,0.3144212962962963,1,3,3,6
2020-06-01 19:44:47,0.3072916666666667,1,3,3,6
2020-06-01 19:44:10,0.3087037037037037,1,5,5,10
2020-06-01 19:43:52,0.3094791666666667,1,6,6,12
2020-06-01 19:44:24,0.31027777777777776,1,10,5,15
2020-06-01 19:41:38,0.30917824074074074,1,5,6,11
2020-06-01 19:55:07,0.3224768518518519,1,19,19,38
2020-06-01 19:41:09,0.31355324074074076,1,3,3,6
2020-06-01 20:13:14,0.33619212962962963,1,25,7,32
2020-06-01 19:53:21,0.32685185185185184,1,17,8,25
2020-06-01 19:39:57,0.31877314814814817,1,3,3,6
2020-05-31 18:34:35,0.04177083333333333,1,4,3,7
2020-05-31 18:35:18,0.4984953703703704,1,1,1,2
2020-05-29 17:25:58,0.022337962962962962,1,23,2,25
2020-05-31 18:38:57,2.2004050925925926,1,30,9,39
2020-05-29 14:14:17,0.08223379629629629,2,109,18,127
2020-05-28 21:50:25,0.02065972222222222,1,9,9,18
2020-09-30 17:31:04,125.02137731481481,1,21,3,24
2020-06-01 01:47:21,3.3886226851851853,2,4,2,6
2020-05-28 10:57:43,0.994525462962963,1,5,5,10
2020-06-09 08:28:58,12.991261574074073,1,14,14,28
2020-05-28 14:44:54,0.02101851851851852,1,3,3,6
2020-05-28 14:22:00,3.060625,1,45,37,82
2020-05-28 14:30:59,3.0677083333333335,1,3,3,6
2020-05-28 10:58:59,2.921215277777778,1,5,5,10
2020-05-28 14:28:07,0.14126157407407408,1,3,5,8
2020-05-28 14:34:02,3.0720833333333335,1,5,5,10
2020-05-28 14:20:47,3.0654166666666667,1,3,3,6
2020-05-28 14:20:21,0.13633101851851853,1,15,55,70
2020-05-28 11:03:04,2.929375,1,1,9,10
2020-06-05 21:42:24,8.30550925925926,2,120,57,177
2020-05-28 14:38:52,3.0811689814814813,1,5,5,10
2020-05-28 14:18:32,0.13701388888888888,1,29,50,79
2020-05-28 14:15:45,3.0681481481481483,1,4,4,8
2020-05-28 14:13:02,3.066574074074074,1,3,3,6
2020-05-28 14:12:10,3.067083333333333,1,2,10,12
2020-05-28 11:02:35,2.935914351851852,1,5,5,10
2020-05-28 14:11:35,3.0677083333333335,1,11,15,26
2020-05-28 11:01:42,2.936516203703704,1,13,12,25
2020-05-28 14:03:17,0.12427083333333333,1,3,3,6
2020-05-28 11:01:18,2.94056712962963,1,3,3,6
2020-05-28 10:58:24,2.9544444444444444,1,1,1,2
2020-05-25 12:56:05,0.05025462962962963,1,3,3,6
2020-05-25 12:56:52,0.05451388888888889,1,5,5,10
2020-05-25 12:57:30,0.0565625,1,1,1,2
2020-05-25 12:02:20,0.01871527777777778,1,39,39,78
2020-05-25 12:57:54,0.057962962962962966,1,6,3,9
2020-06-08 22:11:43,15.614814814814816,4,17,12,29
2020-06-09 08:26:59,21.377800925925925,1,44,2,46
2020-05-24 07:15:24,0.19773148148148148,1,3,1,4
2020-05-25 10:30:35,73.58162037037037,1,18,17,35
2020-10-12 23:01:15,210.55423611111112,2,130,20,150
2020-05-23 03:47:26,0.6409837962962963,1,2,2,4
2020-05-23 03:48:15,2.4765509259259257,1,19,0,19
2020-05-23 03:46:30,0.6283796296296297,1,10,10,20
2020-05-23 07:44:30,0.6883217592592593,1,1,1,2
2020-06-02 17:24:54,16.03679398148148,1,1453,223,1676
2020-05-21 19:39:46,0.21898148148148147,1,3,3,6
2020-05-21 16:17:10,0.08233796296296296,1,2,2,4
2020-05-21 14:02:32,3.079270833333333,1,6,6,12
2020-05-21 14:03:16,3.081712962962963,1,3,3,6
2020-05-21 15:17:14,3.133449074074074,1,5,5,10
2020-05-21 14:05:40,3.0842592592592593,1,3,3,6
2020-05-21 14:10:19,3.0881481481481483,1,3,3,6
2020-05-21 14:17:44,3.0940393518518516,1,6,6,12
2020-05-21 14:14:06,3.091759259259259,1,3,5,8
2020-05-21 14:15:28,3.092858796296296,1,3,3,6
2020-05-21 14:16:39,3.093935185185185,1,1,1,2
2020-05-21 14:19:51,3.096400462962963,1,5,10,15
2020-05-21 15:13:27,3.1344560185185184,1,3,3,6
2020-05-21 14:22:51,3.0997569444444446,1,36,29,65
2020-05-21 14:25:46,3.102662037037037,1,3,3,6
2020-05-21 14:29:45,3.105486111111111,1,1,1,2
2020-05-21 14:43:33,0.02726851851851852,1,12,24,36
2020-05-21 15:41:10,0.05918981481481481,1,1,1,2
2020-05-21 14:34:52,3.110358796296296,1,59,80,139
2020-05-21 14:47:37,3.1192939814814813,1,3,3,6
2020-05-21 14:36:38,3.1120949074074074,1,1,1,2
2020-05-21 14:38:58,3.1141666666666667,1,2,2,4
2020-05-21 14:41:02,3.1156712962962962,1,1,11,12
2020-05-21 19:40:03,0.2018287037037037,1,1,1,2
2020-05-21 15:46:40,0.06292824074074074,1,2,2,4
2020-05-21 14:52:33,3.125115740740741,1,3,3,6
2020-05-20 12:04:37,2.0093402777777776,1,5,5,10
2020-05-21 14:54:55,3.1286805555555555,1,1,1,2
2020-05-21 15:02:01,3.134502314814815,1,5,5,10
2020-05-21 15:05:40,3.1380439814814816,1,6,6,12
2020-05-21 15:08:44,0.044756944444444446,1,21,16,37
2020-05-21 15:11:33,3.143460648148148,1,4,9,13
2020-05-21 15:10:45,3.1433333333333335,1,3,3,6
2020-05-21 15:45:22,3.168738425925926,1,5,10,15
2020-06-08 22:12:20,22.106354166666666,10,3997,2330,6327
2020-06-09 08:28:24,22.65709490740741,5,33,23,56
2020-05-17 15:27:37,0.013738425925925926,1,1,1,2
2020-05-15 16:41:28,0.06915509259259259,1,24,1,25
2020-05-15 15:08:59,0.07391203703703704,1,26,1,27
2020-05-15 15:15:25,0.10672453703703703,1,28,13,41
2020-05-15 09:38:13,0.515625,1,1,1,2
2020-05-14 21:28:06,0.04416666666666667,1,30,3,33
2020-05-14 21:37:38,0.10697916666666667,1,9,1,10
2020-05-15 09:38:31,0.6798263888888889,1,1,1,2
2020-05-14 07:01:24,0.034837962962962966,1,1,0,1
2020-05-14 05:45:53,0.23451388888888888,1,2,2,4
2020-05-14 05:46:11,0.32883101851851854,1,68,1,69
2020-07-01 22:45:16,17.09028935185185,250,22474,13600,36074
2020-05-13 19:20:45,0.21258101851851852,1,6,4,10
2020-05-12 19:38:25,0.11158564814814814,1,1,1,2
2020-05-12 13:24:36,0.1388425925925926,3,38,15,53
2020-06-08 22:18:48,109.621875,1,7,3,10
2020-05-12 13:28:30,9.364097222222222,1,7,1,8
2020-05-12 13:55:26,5.399409722222222,1,1,1,2
2020-05-12 13:29:45,0.8836111111111111,1,6,2,8
2020-05-11 16:10:03,0.16613425925925926,1,1,1,2
2020-05-11 15:57:22,0.1576736111111111,1,1,1,2
2020-05-11 16:10:25,0.1671527777777778,1,1,1,2
2020-05-11 15:55:22,0.1571875,1,1,1,2
2020-05-11 15:52:41,0.1570138888888889,1,1,1,2
2020-05-12 13:25:34,1.0552083333333333,4,17,16,33
2020-05-11 15:22:36,0.1379513888888889,1,1,1,2
2020-05-11 15:55:00,0.16061342592592592,1,1,1,2
2020-05-11 18:29:48,0.1923726851851852,1,5,5,10
2020-05-11 15:19:47,0.14145833333333332,1,3,3,6
2020-05-11 15:00:09,0.1282638888888889,1,6,6,12
2020-05-11 14:57:31,0.12811342592592592,1,12,12,24
2020-05-11 17:33:32,0.19322916666666667,1,4,12,16
2020-05-11 17:24:50,0.18744212962962964,1,3,19,22
2020-05-11 17:18:58,0.18359953703703705,1,1,17,18
2020-05-12 00:20:26,0.28105324074074073,1,12,47,59
2020-05-12 01:00:13,0.02613425925925926,1,106,31,137
2020-05-11 18:29:59,0.1925,1,17,157,174
2020-05-11 17:00:19,0.1709375,1,8,8,16
2020-05-11 14:01:18,0.09554398148148148,1,10,10,20
2020-05-11 13:51:15,0.08925925925925926,1,7,7,14
2020-05-11 13:21:32,0.06881944444444445,1,7,7,14
2020-05-11 13:50:28,0.08969907407407407,1,5,5,10
2020-05-11 13:22:04,0.07258101851851852,1,13,33,46
2020-05-11 12:52:38,0.05271990740740741,1,425,357,782
2020-05-11 12:53:59,0.05466435185185185,1,3,3,6
2020-05-12 00:21:14,0.31083333333333335,1,4,50,54
2020-05-11 12:54:20,0.05614583333333333,1,3,3,6
2020-05-11 16:52:04,0.16516203703703702,1,2,32,34
2020-06-25 10:15:35,45.6575,2,7383,3403,10786
2020-05-10 23:09:21,0.3176388888888889,2,10,16,26
2020-05-13 19:20:35,3.1685416666666666,3,11,6,17
2020-05-10 14:42:49,0.02636574074074074,1,2,2,4
2020-05-10 16:18:13,0.21292824074074074,1,16,1,17
2020-05-09 19:06:56,0.18664351851851851,2,10,1,11
2020-05-09 16:37:40,0.7902083333333333,1,13,1,14
2020-05-10 09:21:10,1.5495486111111112,1,32,7,39
2020-05-08 19:21:58,0.0006944444444444445,1,3,12,15
2020-05-08 18:23:17,0.0434837962962963,1,9,7,16
2020-05-08 19:22:58,10.145381944444445,2,14,1,15
2020-05-08 19:36:08,0.10993055555555556,1,3,3,6
2020-05-08 18:24:26,0.06128472222222222,2,8,6,14
2020-05-08 18:17:17,0.10121527777777778,1,38,1,39
2020-05-08 16:45:35,0.8825694444444444,1,7,7,14
2020-05-07 20:30:57,0.04158564814814815,1,1,1,2
2020-05-08 19:35:56,1.027673611111111,1,3,3,6
2020-05-08 19:35:41,1.0286921296296296,1,3,3,6
2020-05-08 16:45:04,0.9107523148148148,1,8,8,16
2020-05-08 19:36:51,1.0304861111111112,1,3,3,6
2020-05-08 19:35:25,0.0065625,1,5,5,10
2020-05-08 19:33:44,1.0311921296296296,1,3,3,6
2020-05-08 16:48:12,0.0005324074074074074,1,3,3,6
2020-05-08 19:33:24,1.0313310185185185,1,3,3,6
2020-05-08 16:42:35,0.03277777777777778,1,1,1,2
2020-05-08 19:33:02,1.031400462962963,1,13,13,26
2020-05-08 15:44:25,0.8737037037037036,1,3,3,6
2020-05-08 19:36:32,0.002210648148148148,1,23,18,41
2020-05-08 19:37:15,1.0362731481481482,1,1,1,2
2020-05-08 16:52:58,0.001712962962962963,1,5,5,10
2020-05-08 15:42:55,0.8744328703703703,1,1,1,2
2020-05-08 15:44:01,0.8758796296296296,1,1,1,2
2020-05-08 19:32:38,0.00030092592592592595,1,50,35,85
2020-05-08 19:32:10,1.0351504629629629,1,8,8,16
2020-05-08 19:31:57,1.0354282407407407,1,1,14,15
2020-05-08 16:50:38,0.03851851851851852,1,3,3,6
2020-05-08 19:31:42,1.0362962962962963,1,6,6,12
2020-05-08 19:31:19,1.0369907407407408,1,3,3,6
2020-05-08 16:51:50,0.9266435185185186,1,3,3,6
2020-05-08 16:42:20,0.032824074074074075,1,1,1,2
2020-05-08 19:31:07,0.10599537037037036,1,84,69,153
2020-05-08 15:45:23,0.8818634259259259,1,1,1,2
2020-05-08 19:30:50,1.0394097222222223,1,3,3,6
2020-05-08 16:51:37,0.9289236111111111,1,2,2,4
2020-05-08 15:52:54,0.8888657407407408,1,7,5,12
2020-05-08 16:43:27,0.033796296296296297,1,2,2,4
2020-05-08 16:50:16,0.9297222222222222,1,2,2,4
2020-05-08 19:30:23,1.0409375,1,3,3,6
2020-05-08 16:48:49,0.9291550925925925,1,4,4,8
2020-05-08 16:50:58,0.0003125,1,1,1,2
2020-05-08 19:29:04,0.10769675925925926,2,7,7,14
2020-05-08 19:27:45,1.0406365740740742,1,3,3,6
2020-05-08 19:29:25,0.0010879629629629629,1,20,20,40
2020-05-08 15:42:05,0.8845601851851852,1,1,1,2
2020-05-08 19:27:10,1.0413541666666666,1,9,6,15
2020-05-08 16:52:19,0.005451388888888889,1,1,1,2
2020-05-08 18:36:35,3.2103703703703705,1,48,2,50
2020-05-07 18:16:16,2.2972337962962963,1,1,1,2
2020-05-08 19:26:29,4.294467592592593,1,5,5,10
2020-05-08 19:26:17,4.296435185185185,1,3,3,6
2020-05-08 19:24:15,4.295439814814815,1,5,5,10
2020-05-08 19:23:46,4.295520833333334,1,5,36,41
2020-05-08 19:23:34,4.2957986111111115,1,5,5,10
2020-05-08 19:29:54,0.10524305555555556,1,52,38,90
2020-05-07 18:29:16,3.2745486111111113,1,1,1,2
2020-05-08 16:47:51,4.214027777777778,1,3,3,6
2020-05-08 16:53:12,4.218136574074074,1,3,3,6
2020-05-08 16:46:45,4.21431712962963,1,2,2,4
2020-05-08 16:42:13,0.03913194444444444,1,4,4,8
2020-05-04 11:53:42,0.011886574074074074,1,11,11,22
2020-05-04 11:52:42,0.07773148148148148,1,6,1,7
2020-05-04 11:51:35,0.1817361111111111,1,2,2,4
2020-05-10 07:50:55,6.610717592592593,2,106,64,170
2020-05-03 16:48:14,0.010717592592592593,1,5,13,18
2020-05-03 20:19:25,0.3065625,1,569,69,638
2020-06-25 10:17:11,53.58064814814815,9,253,116,369
2020-05-01 18:19:02,0.06244212962962963,1,59,51,110
2020-05-03 14:30:37,3.081770833333333,1,1315,142,1457
2020-05-01 21:45:41,1.2136689814814814,10,86,84,170
2020-06-25 10:17:54,55.74377314814815,1,6,6,12
2020-04-30 12:39:05,0.019814814814814816,1,1,1,2
2020-05-03 20:04:19,5.254375,1,9,22,31
2020-04-28 17:39:16,0.21960648148148149,4,55,33,88
2020-04-28 11:19:40,0.06827546296296297,1,2,2,4
2020-04-28 08:46:21,0.8953125,1,71,77,148
2020-04-28 08:59:01,0.9043518518518519,1,3,3,6
2020-04-28 09:12:56,0.9147106481481482,1,3,3,6
2020-04-28 09:15:19,0.9166319444444444,1,19,31,50
2020-04-28 15:30:54,1.1776273148148149,1,1,1,2
2020-04-28 09:26:31,0.9247222222222222,1,41,51,92
2020-04-28 16:39:21,1.2253819444444445,1,1,1,2
2020-04-28 15:21:34,1.1723379629629629,1,4,4,8
2020-04-28 10:23:14,0.046099537037037036,1,17,29,46
2020-04-28 15:21:54,1.1729166666666666,1,1,1,2
2020-04-28 15:26:16,1.176087962962963,1,1,1,2
2020-04-28 10:02:31,0.9518865740740741,1,3,3,6
2020-04-27 15:20:35,0.17306712962962964,1,1,1,2
2020-04-28 09:47:03,0.9418518518518518,1,8,8,16
2020-05-08 16:53:38,11.238113425925926,1,3,3,6
2020-04-28 15:24:53,1.1770601851851852,1,1,1,2
2020-04-28 09:30:51,0.9316782407407408,1,3,3,6
2020-04-28 15:15:53,1.1716087962962962,1,1,1,2
2020-04-27 08:32:06,0.1415509259259259,1,5,5,10
2020-05-10 08:16:40,13.949351851851851,1,7,0,7
2020-09-18 15:26:46,150.79189814814814,6,346,128,474
2020-10-12 22:37:21,171.04888888888888,4,218,18,236
2020-05-10 09:25:36,15.650520833333333,3,102820,36786,139606
2020-04-25 10:16:05,0.8653587962962963,1,38,16,54
2020-04-25 10:27:30,0.9005092592592593,1,2,2,4
2020-04-23 20:04:19,0.669074074074074,1,2,2,4
2020-04-27 20:17:49,4.850104166666667,8,119,77,196
2020-04-23 13:49:33,0.6944907407407407,1,7,0,7
2020-04-21 13:13:26,0.047372685185185184,1,19,45,64
2020-04-20 14:53:19,0.14252314814814815,1,3,3,6
2020-04-20 14:58:36,0.14712962962962964,1,3,3,6
2020-04-20 15:00:35,0.14891203703703704,1,5,5,10
2020-04-20 14:55:32,0.14572916666666666,1,5,5,10
2020-04-20 14:50:58,0.14299768518518519,1,1,6,7
2020-04-20 14:43:59,0.1387962962962963,1,3,3,6
2020-05-08 16:56:08,10.271331018518518,1,892,829,1721
2020-04-20 13:15:04,0.0789699074074074,1,3,3,6
2020-04-20 13:18:05,0.08136574074074074,1,3,10,13
2020-04-20 13:22:07,0.08435185185185186,1,3,5,8
2020-04-20 13:24:41,0.0972800925925926,1,1,1,2
2020-04-20 14:05:10,0.1259375,1,4,4,8
2020-04-20 14:57:04,0.03487268518518519,1,3,3,6
2020-04-20 14:33:56,0.14770833333333333,1,1,1,2
2020-04-20 15:05:09,0.04047453703703704,1,1,1,2
2020-04-20 14:24:35,0.14197916666666666,1,1,1,2
2020-04-20 13:29:15,0.10402777777777777,1,1,1,2
2020-04-25 20:01:09,5.96150462962963,1,22,3,25
2020-05-10 08:36:19,21.12363425925926,2,113,28,141
2020-04-18 19:52:40,0.12064814814814814,1,36,17,53
2020-04-28 07:43:35,9.535486111111112,1,5,1,6
2020-04-28 07:43:46,9.62943287037037,1,1,1,2
2020-04-18 13:37:04,0.03519675925925926,1,44,1,45
2020-04-17 19:54:26,0.017858796296296296,1,7,4,11
2020-04-17 17:54:59,0.10738425925925926,1,1,1,2
2020-04-17 13:14:24,0.029467592592592594,1,6,0,6
2020-04-16 18:16:20,0.030787037037037036,2,17,3,20
2020-04-16 06:04:11,0.1608101851851852,1,6,4,10
2020-04-16 06:03:25,0.30628472222222225,1,7,2,9
2020-04-15 18:33:54,0.09320601851851852,1,1,2,3
2020-04-15 14:13:44,0.7746527777777777,3,33,5,38
2020-04-13 14:04:16,0.16483796296296296,1,24,19,43
2020-04-13 14:18:02,0.1750810185185185,1,7,14,21
2020-04-13 14:06:14,0.1673611111111111,1,12,12,24
2020-04-13 14:14:38,0.17390046296296297,1,3,3,6
2020-04-13 14:08:14,0.1700810185185185,1,4,9,13
2020-04-13 14:09:24,0.17125,1,1,6,7
2020-04-13 14:11:53,0.17353009259259258,1,6,11,17
2020-04-13 15:35:21,0.05694444444444444,1,91,50,141
2020-04-13 14:20:31,0.18221064814814814,1,3,3,6
2020-04-13 14:40:23,0.19858796296296297,1,1,1,2
2020-04-13 14:36:57,0.19653935185185184,1,5,4,9
2020-04-13 14:21:32,0.18621527777777777,1,7,7,14
2020-04-13 14:16:13,0.18336805555555555,1,5,5,10
2020-04-13 14:33:54,0.19600694444444444,1,3,3,6
2020-04-13 14:16:40,0.1856712962962963,1,1,1,2
2020-04-13 04:41:44,0.4886111111111111,2,17,3,20
2020-04-12 14:41:54,0.0328125,1,1,0,1
2020-04-28 07:44:18,16.678726851851852,1,12,0,12
2020-04-12 11:38:01,1.9792824074074074,2,74,8,82
2020-04-10 06:24:24,0.4847106481481481,1,1,1,2
2020-04-12 11:37:35,3.118888888888889,2,2,2,4
2020-04-12 11:38:15,3.427164351851852,1,1,1,2
2020-04-28 08:16:56,19.708738425925926,14,583,169,752
2020-04-15 18:33:25,7.84988425925926,1,102,43,145
2020-04-07 16:21:59,0.02349537037037037,1,6,4,10
2020-06-09 08:32:01,63.7574537037037,7,153,66,219
2020-04-08 17:58:13,2.307210648148148,1,1,1,2
2020-04-08 17:59:21,2.3088310185185184,1,1,1,2
2020-04-09 18:33:13,3.332453703703704,1,1,1,2
2020-04-08 18:01:55,2.311087962962963,1,1,1,2
2020-04-09 18:32:40,3.333113425925926,1,3,3,6
2020-04-09 18:34:55,3.335,1,1,2,3
2020-04-08 18:08:53,2.3809953703703703,1,30,30,60
2020-04-08 18:10:42,2.3826851851851854,1,5,10,15
2020-04-08 18:12:30,2.3852083333333334,1,3,3,6
2020-04-08 18:15:11,2.387800925925926,1,3,3,6
2020-04-08 18:13:11,2.386863425925926,1,3,3,6
2020-04-08 18:16:15,2.389733796296296,1,33,32,65
2020-04-08 18:22:51,2.394791666666667,1,51,46,97
2020-04-08 18:17:48,2.3922685185185184,1,3,3,6
2020-04-08 18:07:56,2.3871296296296296,1,11,11,22
2020-04-06 12:11:23,0.14871527777777777,1,1,12,13
2020-04-06 12:11:48,0.15135416666666668,1,1,1,2
2020-04-06 07:43:56,0.6505324074074074,4,36,18,54
2020-05-13 20:35:21,31.14472222222222,250,11454,9217,20671
2020-04-05 13:18:42,0.007025462962962963,1,12,2,14
2020-04-05 11:58:44,0.014699074074074074,1,1,1,2
2020-04-05 10:52:08,0.1746412037037037,1,2,2,4
2020-04-05 12:40:09,0.3408449074074074,1,8,3,11
2020-04-05 04:23:46,0.0024421296296296296,1,64,1,65
2020-04-04 21:25:00,0.05130787037037037,2,49,70,119
2020-04-04 17:02:11,0.10193287037037037,2,31,5,36
2020-04-04 13:47:49,0.13164351851851852,1,1,1,2
2020-04-03 11:06:34,0.47390046296296295,1,177,377,554
2020-04-04 13:52:43,2.3311805555555556,1,8,4,12
2020-04-02 01:39:38,0.13547453703703705,1,2,2,4
2020-04-02 01:12:11,0.14167824074074073,1,2,1,3
2020-04-02 03:28:52,0.2446875,1,1,1,2
2020-04-01 01:02:35,0.24829861111111112,1,2,2,4
2020-04-01 01:05:34,0.25072916666666667,1,1,1,2
2020-04-01 00:50:26,0.24055555555555555,1,1,1,2
2020-04-01 01:02:26,0.2492476851851852,1,6,6,12
2020-04-01 01:05:27,0.2519212962962963,1,1,1,2
2020-04-02 16:54:42,1.9114699074074073,1,10,10,20
2020-04-01 01:01:52,0.25017361111111114,1,3,3,6
2020-03-31 19:59:04,0.1837962962962963,1,23,152,175
2020-03-31 16:20:49,0.04693287037037037,1,1,0,1
2020-03-31 10:39:50,0.4945717592592593,1,2,4,6
2020-03-30 18:32:34,0.07453703703703704,1,2,1,3
2020-03-31 12:10:19,1.044710648148148,1,0,1,1
2020-03-31 10:43:43,1.0003587962962963,1,1,1,2
2020-03-31 13:09:14,0.1018287037037037,1,1,1,2
2020-03-31 10:40:55,1.0099305555555556,1,1,1,2
2020-03-31 10:40:34,1.0102430555555555,1,1,1,2
2020-03-31 10:41:56,1.0115740740740742,1,1,1,2
2020-03-31 10:42:18,1.0121412037037036,1,3,3,6
2020-03-31 10:44:34,1.0140625,1,3,3,6
2020-03-31 10:42:45,1.0131481481481481,1,3,3,6
2020-03-31 14:41:52,0.0583912037037037,1,36,41,77
2020-03-31 13:10:26,1.178125,1,5,5,10
2020-03-31 13:13:32,1.1806828703703705,1,204,128,332
2020-03-31 14:37:31,0.05677083333333333,1,42,22,64
2020-03-31 13:15:07,1.1828587962962962,1,10,10,20
2020-03-31 13:15:38,1.1837384259259258,1,30,14,44
2020-03-31 13:12:53,1.182199074074074,1,73,52,125
2020-03-31 13:11:01,1.1816203703703703,1,11,11,22
2020-03-31 17:40:23,2.530127314814815,2,17,9,26
2020-03-27 21:35:58,0.2533564814814815,1,2,0,2
2020-03-26 14:09:17,0.06939814814814815,1,18,0,18
2020-03-26 03:45:12,0.11568287037037037,1,149,169,318
2020-04-05 12:56:19,10.602627314814814,250,10019,9024,19043
2020-03-26 00:56:42,0.14482638888888888,1,98,41,139
2020-03-25 21:39:19,2.071203703703704,1,1,1,2
2020-03-25 21:39:56,2.2975462962962965,1,10,2,12
2020-03-25 21:47:36,2.4686574074074072,1,2,2,4
2020-03-27 21:35:50,1.9914236111111112,1,3,3,6
2020-03-25 21:48:53,2.4703125,1,3,3,6
2020-03-25 21:46:24,2.468888888888889,1,1,1,2
2020-03-25 21:49:28,2.471423611111111,1,7,7,14
2020-03-25 21:48:22,2.4707986111111113,1,6,6,12
2020-03-25 21:46:40,2.4702199074074076,1,2,2,4
2020-03-26 00:55:33,2.659548611111111,1,71,57,128
2020-03-26 03:44:48,0.1166087962962963,1,5,5,10
2020-03-26 00:56:15,2.6613657407407407,1,19,27,46
2020-03-26 00:54:47,2.661539351851852,1,27,21,48
2020-03-26 00:53:32,2.6612037037037037,1,16,29,45
2020-03-26 00:57:35,2.664525462962963,1,29,14,43
2020-03-31 10:47:05,5.291377314814815,1,7,2,9
2020-03-22 14:25:23,0.08033564814814814,1,1,1,2
2020-03-22 01:40:03,129.06743055555555,1,5,0,5
2020-03-21 02:08:10,0.3283101851851852,1,28,12,40
2020-03-21 02:10:25,0.41876157407407405,2,3,3,6
2020-03-21 02:10:42,1.2400347222222223,1,2,2,4
2020-03-21 02:14:51,1.3869675925925926,6,10,10,20
2020-03-28 16:59:46,9.131736111111111,6,58,44,102
2020-03-25 21:40:59,6.994988425925926,1,9,1,10
2020-03-21 02:14:28,2.8282175925925928,1,6,0,6
2020-03-21 02:14:11,3.550451388888889,1,2,0,2
2020-03-17 19:43:56,1.2136689814814814,1,12,8,20
2020-03-18 11:16:47,2.0439583333333333,1,2,2,4
2020-03-18 12:48:04,2.1089814814814813,2,5,5,10
2020-03-18 10:44:22,2.0966203703703705,1,5,5,10
2020-03-18 10:43:23,2.1003356481481483,1,14,6,20
2020-03-18 10:40:50,2.0989930555555554,1,7,5,12
2020-04-02 15:10:56,20.124791666666667,1,48,38,86
2020-03-12 21:35:21,0.19315972222222222,2,79,8,87
2020-03-12 22:06:44,0.24825231481481483,1,11,2,13
2020-03-12 16:58:00,0.06952546296296297,1,48,67,115
2020-04-05 10:51:23,24.813541666666666,5,51,24,75
2020-03-10 17:39:48,0.027650462962962963,1,1,1,2
2020-03-10 10:59:45,0.012604166666666666,1,1,1,2
2020-03-10 10:58:41,0.022083333333333333,1,11,8,19
2020-03-09 22:16:00,0.1618402777777778,1,29,5,34
2020-12-15 03:30:16,280.47267361111113,2,29,5,34
2020-03-10 11:00:56,0.8460416666666667,2,2,2,4
2020-04-20 12:03:04,13.961863425925927,1,51,3,54
2020-03-18 11:02:35,9.043506944444445,1,9,7,16
2020-03-18 11:01:36,9.04383101851852,1,1,1,2
2020-03-18 11:00:21,9.043113425925926,1,2,2,4
2020-03-21 02:23:26,0.003935185185185185,1,3,3,6
2020-03-09 13:28:26,0.20453703703703704,1,7,7,14
2020-03-09 13:27:26,0.20858796296296298,1,5,5,10
2020-03-09 13:25:23,0.20769675925925926,1,21,7,28
2020-03-09 13:33:59,0.2142013888888889,1,80,31,111
2020-03-09 08:13:21,0.2749421296296296,2,18,18,36
2020-03-09 01:20:18,0.08060185185185186,1,21,31,52
2020-03-09 01:19:08,1.1010069444444444,1,15,0,15
2020-03-08 14:45:20,1.2978356481481481,1,1,0,1
2020-03-08 15:10:49,2.07587962962963,2,50,7,57
2020-03-06 14:20:15,0.0662962962962963,1,6,1,7
2020-03-08 22:56:19,2.7741550925925926,1,165,17,182
2020-03-06 04:31:52,0.11540509259259259,1,0,6,6
2020-03-06 00:29:38,0.09143518518518519,1,0,95,95
2020-03-05 14:52:16,1.507800925925926,1,10,10,20
2020-03-08 15:09:35,4.540416666666666,1,16,16,32
2020-03-08 15:08:39,4.560636574074074,1,2,2,4
2020-03-08 14:59:56,4.584178240740741,2,13,13,26
2020-05-10 07:50:07,67.33222222222223,1,2,2,4
2020-03-08 15:00:25,5.937025462962963,4,65,25,90
2020-03-02 12:46:57,0.08717592592592592,1,1,1,2
2020-03-02 12:49:41,0.17729166666666665,1,36,36,72
2020-03-02 12:55:33,0.18171296296296297,1,5,5,10
2020-03-02 12:55:53,0.18224537037037036,1,5,5,10
2020-03-18 10:42:05,16.090162037037036,1,14,6,20
2020-03-05 22:20:50,4.063032407407407,1,17,17,34
2020-03-01 21:25:13,0.10916666666666666,1,1,1,2
2020-04-28 07:53:43,57.791238425925926,1,7,7,14
2020-04-05 12:02:23,34.97758101851852,2,22,14,36
2020-03-08 14:17:40,7.489201388888889,1,275,53,328
2020-03-05 14:56:02,4.9121296296296295,1,1,0,1
2020-02-29 01:57:15,0.37061342592592594,1,1,1,2
2020-02-29 02:05:03,0.6887847222222222,1,7,7,14
2020-02-28 12:49:46,0.8839814814814815,1,10,1,11
2020-02-27 11:34:08,0.0003356481481481481,1,27,1,28
2020-02-27 11:32:55,5.923078703703704,1,202,123,325
2020-03-08 15:02:37,10.935324074074074,2,28,27,55
2020-02-29 02:00:43,2.5543171296296294,2,20,5,25
2020-03-08 14:42:21,11.886793981481482,1,1,1,2
2020-03-08 14:36:50,12.637719907407407,1,3,7,10
2020-02-24 20:15:54,0.10326388888888889,1,4,3,7
2020-02-24 20:18:27,0.26200231481481484,1,2,0,2
2020-03-08 15:22:13,13.223009259259259,1,3,3,6
2020-03-02 12:48:03,7.1163541666666665,1,1,1,2
2020-02-24 12:54:20,0.19524305555555554,1,10,11,21
2020-02-24 08:50:18,0.026319444444444444,1,10,10,20
2020-02-24 08:50:25,0.026724537037037036,1,10,10,20
2020-02-24 08:36:32,0.01775462962962963,1,33,33,66
2020-02-24 20:19:20,1.3355902777777777,1,9,3,12
2020-02-22 00:26:42,0.05063657407407408,1,1,1,2
2020-02-22 00:27:35,0.45873842592592595,1,1,1,2
2020-02-22 00:29:15,0.5045023148148148,1,7,0,7
2020-02-24 21:21:41,3.4334375,1,1,1,2
2020-05-10 08:30:28,80.46028935185186,1,14,9,23
2020-02-19 21:31:54,0.9123611111111111,1,1,1,2
2020-02-18 16:22:45,0.06938657407407407,1,33,2,35
2020-02-17 17:22:44,0.3464467592592593,1,1,1,2
2020-02-20 00:24:17,2.2883449074074074,1,3,3,6
2020-03-08 23:12:53,20.591354166666665,2,6,4,10
2020-02-17 17:27:19,0.35180555555555554,1,3,3,6
2020-02-17 17:24:21,0.35009259259259257,1,1,1,2
2020-02-17 16:58:15,0.37212962962962964,1,7,7,14
2020-02-17 16:57:29,0.37190972222222224,1,25,97,122
2020-03-18 10:55:32,29.747222222222224,1,29,21,50
2020-02-17 16:53:03,0.36953703703703705,1,5,5,10
2020-02-17 16:49:22,0.3673263888888889,1,36,15,51
2020-03-08 15:11:50,21.098287037037036,1,1,1,2
2020-02-16 11:38:22,2.692905092592593,1,1,1,2
2020-02-16 11:56:53,2.777696759259259,3,25,6,31
2020-02-15 11:52:58,2.5278240740740743,1,2,6,8
2020-02-19 21:36:53,8.181516203703703,2,67,6,73
2020-02-16 11:54:58,5.828587962962963,2,18,7,25
2020-03-08 15:01:08,26.362118055555555,2,6,4,10
2020-03-08 14:39:14,26.925416666666667,2,31,5,36
2020-02-17 15:39:00,6.994166666666667,1,3,3,6
2020-03-02 12:44:45,21.13070601851852,1,3,3,6
2020-02-10 01:55:41,0.0013657407407407407,1,6,1,7
2020-03-08 15:04:04,27.811041666666668,3,30,18,48
2020-03-08 15:04:26,28.059641203703702,1,10,2,12
2020-03-25 22:17:15,17.244386574074074,250,11481,9392,20873
2020-02-09 11:05:32,0.04383101851851852,1,3,3,6
2020-02-08 23:02:09,0.007523148148148148,1,13,5,18
2020-02-08 22:44:02,0.0016782407407407408,1,3,4,7
2020-02-08 20:39:44,0.15157407407407408,1,3,3,6
2020-02-08 16:29:41,1.0890972222222222,1,7,3,10
2020-02-07 12:21:25,0.6753125,1,3,5,8
2020-12-15 11:55:30,311.90149305555553,1,34,2,36
2020-02-07 14:24:23,2.9085185185185187,1,13,5,18
2020-02-08 20:22:39,4.843206018518519,1,55,6,61
2020-02-03 22:29:43,0.07065972222222222,1,1,1,2
2020-02-08 22:33:23,4.995821759259259,250,15934,15727,31661
2020-02-03 20:16:38,0.031469907407407405,1,5,1,6
2020-02-03 16:48:57,0.024074074074074074,1,1,1,2
2020-02-03 16:48:24,0.04280092592592592,1,29,0,29
2020-02-03 17:45:57,0.09787037037037037,1,1,1,2
2020-02-03 17:44:55,0.1359027777777778,1,4,4,8
2020-02-10 11:28:23,7.05880787037037,1,3,3,6
2020-02-10 11:46:27,7.071539351851852,1,5,6,11
2020-02-03 11:26:01,0.10741898148148148,1,1,1,2
2020-06-08 22:16:31,127.33162037037037,2,8,3,11
2020-04-19 21:38:32,79.34607638888889,2,565,397,962
2020-02-03 00:53:10,1.4589699074074074,4,98,33,131
2020-02-01 14:42:24,1.1214351851851851,3,56,17,73
2020-02-01 14:42:12,1.2558449074074074,1,1,0,1
2020-04-27 15:19:54,87.53173611111112,3,15,3,18
2020-01-30 11:05:57,0.13435185185185186,1,1,1,2
2020-01-29 17:39:45,0.011099537037037036,1,1,1,2
2020-01-29 15:18:34,0.04105324074074074,1,2,3,5
2020-01-29 16:35:55,0.7258680555555556,1,6,0,6
2020-01-28 19:56:33,0.00018518518518518518,1,1,1,2
2020-01-28 19:33:10,0.08136574074074074,1,3,1,4
2020-01-28 19:28:38,0.08222222222222222,1,15,0,15
2020-01-28 17:50:45,0.024502314814814814,4,9,4,13
2020-01-28 16:19:42,0.0011226851851851851,1,156,0,156
2020-01-28 14:23:17,0.023946759259259258,2,5,5,10
2020-01-28 01:20:48,0.04355324074074074,1,5,4,9
2020-01-28 01:21:01,0.05197916666666667,1,61,30,91
2020-01-27 12:44:30,0.05498842592592593,1,38,16,54
2020-02-10 11:46:06,14.109212962962962,1,4,4,8
2020-02-10 12:18:08,0.03342592592592593,1,1,1,2
2020-02-10 11:51:15,14.11355324074074,1,3,3,6
2020-02-10 12:26:54,0.03949074074074074,1,5,6,11
2020-02-10 11:41:59,14.160856481481481,1,5,5,10
2020-02-10 12:34:04,0.043506944444444445,1,8,8,16
2020-03-18 10:45:38,51.12243055555555,1,6,1,7
2020-02-10 11:40:33,14.160798611111112,1,5,5,10
2020-02-10 11:30:41,14.15454861111111,1,5,5,10
2020-02-10 11:29:16,14.154421296296297,1,8,16,24
2020-03-18 10:41:39,15.909525462962963,1,244,9,253
2020-01-27 10:06:35,0.308912037037037,1,3,1,4
2020-01-27 10:04:12,0.32305555555555554,1,22,5,27
2020-01-27 10:03:46,0.47366898148148145,1,38,16,54
2020-01-27 10:04:43,0.5086574074074074,1,42,36,78
2020-01-27 10:05:34,0.5333796296296296,1,49,7,56
2020-01-26 22:13:49,0.0790162037037037,4,18,8,26
2020-01-26 21:26:50,0.036412037037037034,1,5,1,6
2020-01-26 21:43:18,0.04377314814814815,1,16,9,25
2020-01-26 19:07:27,0.04010416666666667,1,101,42,143
2020-01-26 13:42:35,0.07553240740740741,2,2,0,2
2020-01-28 01:21:19,1.4381481481481482,1,1,1,2
2020-01-25 21:59:01,0.07777777777777778,1,1,0,1
2020-01-25 18:40:37,0.027881944444444445,1,16,6,22
2020-01-25 17:19:25,0.041527777777777775,2,18,4,22
2020-01-25 15:00:30,0.05271990740740741,1,49,3,52
2020-01-25 15:35:34,0.1477199074074074,6,102,78,180
2020-02-03 14:52:21,5.801689814814814,250,9713,8963,18676
2020-01-25 04:23:33,0.17554398148148148,1,9,1,10
2020-01-25 03:20:06,0.14663194444444444,1,4,0,4
2020-01-25 04:23:06,0.22466435185185185,1,66,9,75
2020-01-24 21:37:04,0.030914351851851853,1,2,1,3
2020-01-24 21:08:25,0.04861111111111111,1,1,1,2
2020-01-24 19:51:34,0.03418981481481481,2,4,0,4
2020-01-24 19:50:50,0.06547453703703704,1,2,0,2
2020-01-25 04:22:36,0.48194444444444445,1,3,18,21
2020-01-25 10:54:11,1.4672453703703703,250,13239,12523,25762
2020-01-23 23:21:14,0.03335648148148148,1,1,1,2
2020-01-23 23:20:24,0.07680555555555556,1,12,12,24
2020-01-23 23:23:31,0.09384259259259259,250,16290,16145,32435
2020-01-24 00:14:52,0.13193287037037038,1,3,3,6
2020-01-23 23:20:04,0.10628472222222222,1,0,41,41
2020-01-23 23:20:52,0.09991898148148148,1,13,5,18
2020-01-23 23:20:39,28.126921296296295,1,14,1,15
2020-01-23 19:33:21,0.04967592592592593,1,181,94,275
2021-03-19 16:22:09,421.1847916666667,4,5,6,11
2020-01-22 15:26:24,0.1726273148148148,1,0,2,2
2020-01-22 15:26:48,0.18342592592592594,1,1,0,1
2020-01-23 20:32:01,1.9527083333333333,2,5,1,6
2020-01-20 17:00:55,0.019224537037037037,1,21,6,27
2020-01-20 16:39:15,0.014513888888888889,1,1,1,2
2020-01-21 11:42:14,0.835474537037037,1,1,1,2
2020-01-23 20:27:27,3.236458333333333,1,32,17,49
2020-01-20 16:00:42,0.12605324074074073,1,2,1,3
2020-01-20 11:45:24,0.07872685185185185,1,6,6,12
2020-01-20 14:45:11,0.0875925925925926,1,3,3,6
2020-01-20 13:08:15,0.05589120370370371,1,1,1,2
2020-01-20 11:46:04,0.08074074074074074,1,3,3,6
2020-01-20 12:37:27,0.03469907407407408,1,3,3,6
2020-01-20 11:58:57,0.09140046296296296,1,3,3,6
2020-01-20 11:43:52,0.08142361111111111,1,1,1,2
2020-01-20 11:59:29,0.17401620370370371,1,5,5,10
2020-01-20 14:16:00,0.08880787037037037,1,14,14,28
2020-01-20 12:06:40,0.17971064814814816,1,24,11,35
2020-01-20 15:14:07,0.03888888888888889,1,32,104,136
2020-01-20 12:05:52,0.1799074074074074,1,5,5,10
2020-01-20 12:05:37,0.18010416666666668,1,17,119,136
2020-01-20 12:02:46,0.17856481481481482,1,17,22,39
2020-01-20 12:00:44,0.1775,1,5,5,10
2020-01-20 12:00:23,0.17756944444444445,1,5,5,10
2020-01-21 17:57:21,1.8780439814814816,1,45,9,54
2020-01-21 17:56:35,2.184548611111111,1,13,1,14
2020-01-18 22:22:36,0.044895833333333336,1,2,0,2
2020-01-18 18:50:44,0.07496527777777778,1,25,11,36
2020-01-20 14:55:04,2.0935532407407407,5,102,74,176
2020-01-21 17:56:19,3.7730555555555556,1,2,0,2
2020-01-17 09:53:54,0.14474537037037036,1,9,8,17
2020-01-20 15:34:43,3.9656944444444444,1,1,1,2
2020-01-17 06:50:31,0.6331018518518519,1,1,1,2
2020-01-14 10:20:14,0.05212962962962963,1,1,1,2
2020-01-14 03:05:33,0.020150462962962964,1,579,463,1042
2020-01-14 12:17:22,0.3818287037037037,1,48,40,88
2020-01-14 07:52:33,0.3436689814814815,1,2,0,2
2020-01-13 23:43:13,0.3583912037037037,1,0,16,16
2020-01-13 17:53:42,0.11890046296296296,1,7,7,14
2020-01-23 21:04:01,6.452430555555556,250,12007,11885,23892
2020-01-13 11:54:34,0.038125,1,1,1,2
2020-01-22 23:43:55,9.5290625,2,23,13,36
2020-01-13 18:09:32,0.12967592592592592,1,1,1,2
2020-01-13 18:02:21,0.12508101851851852,1,3,3,6
2020-01-13 18:01:43,0.12449074074074074,1,11,17,28
2020-01-13 17:58:56,0.1227662037037037,1,4,4,8
2020-01-15 01:24:36,1.4323958333333333,1,1,1,2
2020-01-14 02:34:10,0.35878472222222224,1,12,12,24
2020-01-13 17:56:48,0.12115740740740741,1,5,5,10
2020-01-13 18:05:15,0.12712962962962962,1,5,6,11
2020-01-13 17:55:31,0.12030092592592592,1,138,27,165
2020-01-13 17:56:21,0.12112268518518518,1,5,5,10
2020-01-13 17:54:46,0.11996527777777778,1,5,5,10
2020-01-15 06:45:01,2.6089467592592595,8,8,34,42
2020-01-12 14:49:31,0.010798611111111111,1,17,12,29
2020-01-13 11:02:38,0.857175925925926,250,13749,13625,27374
2020-01-12 02:13:02,0.047372685185185184,1,0,1,1
2020-01-11 20:50:00,0.16836805555555556,1,4,0,4
2020-01-11 20:38:03,0.17846064814814816,1,3,3,6
2020-01-11 20:36:54,0.20332175925925927,1,0,16,16
2020-04-26 21:29:09,106.65903935185185,1,319,105,424
2020-01-11 05:41:38,0.060648148148148145,1,2,0,2
2020-01-11 02:32:26,0.023680555555555555,1,1,1,2
2020-01-11 01:04:58,0.34077546296296296,1,22,0,22
2020-01-09 23:10:17,0.36693287037037037,1,8,1,9
2020-01-09 23:10:30,1.218888888888889,1,1,1,2
2020-01-08 21:42:05,0.18221064814814814,1,11,1,12
2020-01-11 01:14:45,2.735023148148148,1,43,28,71
2020-01-10 04:34:25,1.8683333333333334,2,35,6,41
2020-01-10 00:10:18,1.7029050925925926,1,4,4,8
2020-01-11 01:15:04,3.9498148148148147,1,10,4,14
2020-01-12 13:16:21,4.590162037037037,1,8,3,11
2020-01-07 09:41:19,0.1376388888888889,1,22,16,38
2020-01-06 17:22:18,0.025231481481481483,1,2,0,2
2020-01-11 10:53:37,4.761689814814815,2,2,2,4
2020-01-10 20:52:24,4.297199074074074,1,7,3,10
2020-01-10 22:02:17,4.540868055555555,1,5,5,10
2020-01-06 14:03:06,0.20849537037037036,1,6,6,12
2020-01-06 14:52:24,0.03311342592592593,1,1,1,2
2020-01-06 14:02:47,0.2104398148148148,1,5,5,10
2020-01-06 13:56:04,0.20614583333333333,1,4,4,8
2020-01-12 17:53:58,0.18850694444444444,1,3,3,6
2020-01-06 14:03:27,0.021747685185185186,1,5,5,10
2020-01-06 10:42:04,0.12894675925925925,1,29,19,48
2020-01-06 13:44:03,0.25568287037037035,1,5,5,10
2020-01-06 13:44:43,0.25655092592592593,1,5,5,10
2020-01-06 13:30:00,0.11592592592592593,1,10,10,20
2020-01-06 10:39:37,0.12917824074074075,1,5,5,10
2020-01-06 10:41:02,0.1304050925925926,1,5,5,10
2020-01-10 20:57:06,4.7175,1,3,3,6
2020-01-05 01:25:07,0.016354166666666666,1,9,9,18
2020-01-04 21:48:58,0.25626157407407407,6,15,15,30
2020-01-04 21:48:19,0.27444444444444444,3,4,4,8
2020-01-04 21:48:35,0.29465277777777776,2,3,3,6
2020-01-03 10:57:25,0.08534722222222223,1,5,5,10
2020-01-03 04:00:18,0.20880787037037038,1,2,3,5
2020-01-04 00:54:08,1.0890046296296296,1,80,62,142
2020-01-03 04:28:57,0.24903935185185186,1,1,5,6
2020-01-03 04:29:08,0.25438657407407406,1,1,2,3
2020-01-02 21:46:42,3.145821759259259,2,1,34,35
2020-01-03 04:35:47,0.36844907407407407,1,4,9,13
2020-01-03 04:01:46,0.3511342592592593,1,12,6,18
2020-01-02 16:14:58,0.04703703703703704,1,41,3,44
2019-12-31 21:15:06,0.8888657407407408,1,8,0,8
2019-12-31 20:39:26,0.7041550925925926,1,5,2,7
2019-12-30 18:13:03,0.022453703703703705,1,0,2,2
2019-12-30 23:55:33,0.3191898148148148,5,140,30,170
2019-12-30 14:58:25,0.2492361111111111,1,1,1,2
2019-12-30 15:13:26,0.26,1,1,1,2
2019-12-30 15:15:17,0.2616203703703704,1,3,3,6
2019-12-30 15:16:46,0.2629861111111111,1,3,3,6
2019-12-30 15:23:06,0.26773148148148146,1,1,1,2
2019-12-30 15:21:52,0.2672453703703704,1,3,3,6
2019-12-30 16:49:09,0.0641087962962963,1,11,16,27
2019-12-30 15:07:28,0.3113773148148148,1,7,7,14
2019-12-30 14:56:23,0.30398148148148146,1,17,17,34
2019-12-30 15:14:43,0.3170601851851852,1,6,14,20
2019-12-30 14:55:04,0.3038888888888889,1,15,15,30
2019-12-30 14:54:44,0.30400462962962965,1,5,5,10
2019-12-30 12:54:05,0.22078703703703703,1,6,11,17
2019-12-30 23:54:39,0.824849537037037,1,2,2,4
2019-12-30 18:20:44,0.6036689814814815,1,50,19,69
2019-12-30 03:38:31,0.048275462962962964,1,15,0,15
2019-12-30 03:38:19,0.06414351851851852,1,4,1,5
2019-12-30 02:55:11,0.05053240740740741,1,0,20,20
2019-12-30 17:30:25,0.6514351851851852,1,1,1,2
2020-01-11 01:15:26,12.214479166666667,3,70,4,74
2020-01-02 19:52:40,4.068888888888889,2,36,3,39
2019-12-29 15:59:25,0.12211805555555555,1,8,4,12
2019-12-29 16:00:44,0.22953703703703704,2,13,19,32
2019-12-30 06:41:41,1.0817708333333333,1,1,1,2
2019-12-27 02:41:56,0.3464351851851852,1,13,8,21
2019-12-29 04:39:09,2.513888888888889,1,24,16,40
2020-08-29 17:00:31,249.74077546296297,1,3,1,4
2020-01-12 13:16:46,19.96005787037037,1,16,38,54
2019-12-23 21:35:05,0.502662037037037,1,3,3,6
2019-12-23 21:37:35,0.5053472222222222,1,37,37,74
2019-12-23 21:36:07,0.504525462962963,1,1,1,2
2019-12-24 17:25:15,1.3311226851851852,1,3,3,6
2019-12-23 21:38:20,0.5072337962962963,1,1,1,2
2019-12-24 17:27:14,1.3336226851851851,1,3,3,6
2019-12-24 17:33:13,1.4152083333333334,1,5,5,10
2019-12-25 00:15:04,0.24805555555555556,1,89,103,192
2019-12-24 17:38:45,1.42,1,5,5,10
2019-12-24 17:40:59,1.421851851851852,1,5,5,10
2019-12-24 17:42:12,1.4230555555555555,1,36,31,67
2019-12-24 17:25:52,1.4122337962962963,1,39,42,81
2019-12-25 00:15:32,0.27175925925925926,1,5,5,10
2019-12-23 17:12:23,0.4778587962962963,1,4,4,8
2019-12-23 06:27:56,0.2024189814814815,1,2,2,4
2019-12-22 21:22:10,0.005405092592592592,1,1,1,2
2019-12-22 07:55:27,0.13699074074074075,1,3,4,7
2020-01-23 21:00:14,32.750474537037036,8,2886,987,3873
2019-12-29 04:39:48,8.450914351851852,6,90,51,141
2020-01-03 01:44:07,13.37207175925926,4,661,753,1414
2019-12-18 22:39:08,0.13332175925925926,1,1,1,2
2019-12-18 22:21:51,0.12878472222222223,1,1,1,2
2019-12-18 18:04:44,0.09302083333333333,1,14,2,16
2019-12-18 15:54:04,0.12407407407407407,1,1,1,2
2019-12-18 15:54:30,0.11640046296296297,1,1,1,2
2019-12-18 15:55:21,0.3670486111111111,1,3,1,4
2019-12-19 11:47:20,1.6597222222222223,1,0,1,1
2019-12-18 15:56:59,0.9630555555555556,1,1,1,2
2019-12-18 15:56:07,0.9851967592592593,1,2,2,4
2019-12-18 15:56:40,1.0302777777777778,2,0,244,244
2020-05-10 08:19:50,144.9055787037037,1,18,0,18
2019-12-16 22:53:39,0.1394675925925926,1,1,1,2
2019-12-16 22:55:28,0.21134259259259258,1,21,1,22
2019-12-17 18:32:52,1.395474537037037,1,3,3,6
2019-12-17 01:19:20,0.09975694444444444,1,1,1,2
2019-12-17 18:53:16,1.4112268518518518,1,3,3,6
2019-12-17 18:34:21,1.3983217592592592,1,1,1,2
2019-12-17 18:36:50,1.4006597222222221,1,3,3,6
2019-12-17 18:40:34,1.4681134259259259,1,25,8,33
2019-12-17 18:54:43,1.4782407407407407,1,6,11,17
2019-12-24 18:15:45,0.032928240740740744,1,7,7,14
2019-12-17 18:41:50,0.7218402777777778,1,15,15,30
2019-12-17 01:20:50,0.7474305555555556,1,62,51,113
2019-12-17 18:42:26,1.471111111111111,1,5,5,10
2019-12-17 18:42:03,0.7221180555555555,1,7,7,14
2019-12-17 01:19:59,0.7478703703703704,1,13,33,46
2019-12-16 22:55:03,1.7728819444444444,1,2,2,4
2019-12-16 22:55:17,1.9346296296296297,2,49,21,70
2019-12-13 13:04:58,0.11519675925925926,1,1,0,1
2019-12-12 18:50:08,0.5083217592592593,1,1,1,2
2019-12-17 12:30:59,4.939641203703704,2,16,31,47
2020-01-12 13:17:03,32.03771990740741,2,11,2,13
2019-12-10 18:39:03,0.0596412037037037,1,1,1,2
2019-12-10 06:40:01,0.03211805555555555,1,1,1,2
2019-12-10 06:39:55,0.03116898148148148,1,1,1,2
2019-12-12 18:50:24,3.1588773148148146,1,11,139,150
2019-12-12 17:57:45,3.3925578703703705,1,1,1,2
2019-12-12 17:57:33,3.3927430555555556,1,3,3,6
2019-12-17 23:58:54,0.22239583333333332,2,44,42,86
2019-12-10 23:55:04,1.642488425925926,1,3,3,6
2019-12-10 23:52:44,1.641539351851852,1,1,1,2
2019-12-11 11:39:12,2.133020833333333,1,6,6,12
2019-12-11 11:36:29,2.174849537037037,1,15,14,29
2019-12-11 11:32:27,2.172361111111111,1,5,5,10
2019-12-11 11:32:52,2.1729166666666666,1,14,105,119
2019-12-11 11:37:09,2.1763310185185185,1,19,7,26
2019-12-11 00:03:01,1.6946064814814814,1,25,25,50
2019-12-11 11:31:54,2.173263888888889,1,5,5,10
2019-12-11 11:37:38,2.177604166666667,1,67,4,71
2019-12-11 11:31:04,2.1733333333333333,1,5,5,10
2019-12-09 03:26:00,0.24346064814814813,1,31,9,40
2019-12-09 03:30:59,0.2973148148148148,1,1,1,2
2019-12-19 11:47:56,10.779282407407408,1,3,4,7
2019-12-08 14:37:13,0.5245138888888888,1,90,1,91
2019-12-16 22:55:50,9.905347222222222,1,32,4,36
2019-12-06 21:40:07,0.029814814814814815,1,4,0,4
2020-01-23 20:40:04,48.00320601851852,1,19,21,40
2020-05-10 09:41:44,155.60246527777778,1,40,20,60
2019-12-06 18:44:10,0.9551273148148148,1,4,4,8
2019-12-06 18:44:24,1.7000810185185184,2,3,3,6
2019-12-04 23:50:52,0.03153935185185185,1,3,2,5
2019-12-04 23:50:41,0.08824074074074074,1,2,68,70
2019-12-04 23:51:08,0.24717592592592594,1,4,0,4
2019-12-04 11:45:49,0.022349537037037036,3,7,21,28
2019-12-04 03:34:09,7.421423611111111,1,3,1,4
2019-12-02 18:55:09,0.06229166666666667,1,1,1,2
2019-12-03 18:53:17,1.1065740740740742,6,58,10,68
2019-12-29 04:41:26,26.52690972222222,1,11,9,20
2019-12-02 17:25:25,0.07570601851851852,1,4,4,8
2019-12-02 17:25:44,0.13572916666666668,1,13,6,19
2019-12-02 12:38:54,0.08643518518518518,1,104,103,207
2019-12-02 13:56:54,0.2180324074074074,1,3,3,6
2019-12-02 17:38:17,0.15346064814814814,1,3,3,6
2019-12-02 17:37:55,0.15221064814814814,1,1,1,2
2019-12-02 13:58:08,0.22167824074074075,1,7,7,14
2019-12-02 14:03:46,0.2258449074074074,1,6,6,12
2019-12-02 13:55:44,0.22078703703703703,1,3,3,6
2019-12-02 13:55:09,0.02141203703703704,1,5,5,10
2019-12-02 15:55:33,0.1350462962962963,1,55,77,132
2019-12-02 13:59:13,0.024050925925925927,1,5,5,10
2019-12-02 13:53:04,0.019733796296296298,1,128,96,224
2020-01-11 11:39:36,0.030243055555555554,1,7,7,14
2019-12-02 17:37:23,0.15001157407407406,1,37,37,74
2019-12-02 12:39:53,0.3282175925925926,2,131,7,138
2019-12-01 16:24:34,0.0908449074074074,1,1,1,2
2019-12-01 18:03:43,49.99293981481482,1,1,1,2
2019-12-03 18:56:35,2.74693287037037,1,1,1,2
2019-12-01 06:06:21,0.478125,1,29,2,31
2019-12-01 06:08:41,1.001863425925926,1,4,2,6
2019-11-29 16:02:19,0.7024652777777778,1,3,4,7
2019-11-29 16:02:36,0.7263541666666666,2,40,1,41
2019-11-29 16:03:07,0.8473263888888889,1,18,8,26
2019-11-28 03:07:50,0.22269675925925925,1,2,0,2
2019-11-28 03:08:01,0.22800925925925927,1,4,3,7
2019-12-04 03:34:32,6.700208333333333,1,60,0,60
2019-11-29 16:03:21,2.4341666666666666,1,2,2,4
2019-11-27 04:19:28,0.05403935185185185,1,1,1,2
2019-11-27 04:28:11,0.12206018518518519,1,41,0,41
2020-01-11 01:02:22,45.329988425925926,1,60,25,85
2019-11-26 21:46:31,1.049363425925926,1,1,1,2
2019-11-27 12:33:20,2.138726851851852,1,3,3,6
2019-11-27 00:03:03,1.6179513888888888,1,3,3,6
2019-11-27 02:59:58,1.741273148148148,1,4,4,8
2019-11-27 02:54:41,1.738773148148148,1,1,1,2
2019-11-27 11:49:20,0.4890393518518519,1,3,3,6
2019-11-27 02:53:51,1.738923611111111,1,3,3,6
2019-11-27 02:35:40,1.7975925925925926,1,20,11,31
2019-11-27 02:36:10,1.7983101851851853,1,5,5,10
2019-11-27 03:24:14,0.03217592592592593,1,401,396,797
2019-11-27 02:36:29,1.7997685185185186,1,5,5,10
2019-11-27 04:13:55,0.05417824074074074,1,11,19,30
2019-11-27 02:36:48,1.8010648148148147,1,10,10,20
2019-11-25 00:42:51,1.2384490740740741,1,1,1,2
2019-12-01 06:21:29,6.515891203703704,6,36,13,49
2019-12-02 20:05:28,8.573287037037037,1,1,1,2
2019-11-24 03:16:42,0.3478703703703704,1,39,20,59
2019-11-29 16:03:38,7.043229166666666,1,1,1,2
2019-11-22 14:57:00,0.7861689814814815,2,14,8,22
2019-11-21 18:03:08,0.01138888888888889,1,1,1,2
2019-11-30 17:19:48,9.167048611111111,3,12,6,18
2019-12-17 12:31:57,26.00261574074074,4,67,2,69
2019-11-21 10:35:40,0.1566087962962963,1,1,1,2
2019-11-19 23:56:23,0.001261574074074074,1,3,1,4
2019-11-19 16:22:40,71.28668981481482,1,1,0,1
2019-11-22 14:57:23,74.23549768518518,1,1,1,2
2019-11-18 13:26:08,0.20434027777777777,1,3,3,6
2019-11-18 13:29:01,0.20770833333333333,1,1,1,2
2019-11-18 13:40:17,0.21586805555555555,1,7,7,14
2019-11-18 13:40:04,0.21640046296296298,1,3,3,6
2019-11-18 13:13:24,0.1982523148148148,1,2,2,4
2019-11-20 16:56:12,2.3537962962962964,2,5,5,10
2019-11-19 20:28:01,1.5447800925925925,1,14,6,20
2019-11-18 13:43:50,0.2644560185185185,1,66,32,98
2019-11-18 14:04:54,0.03603009259259259,1,5,5,10
2019-11-18 13:30:11,0.01425925925925926,1,5,5,10
2019-12-02 14:19:00,14.045844907407407,1,5,5,10
2019-11-18 13:21:53,0.25131944444444443,1,19,11,30
2019-11-18 13:10:47,0.24449074074074073,1,11,18,29
2019-11-18 13:07:32,0.24261574074074074,1,10,12,22
2019-11-18 00:15:31,0.15578703703703703,1,1,1,2
2019-11-17 17:40:34,20.95828703703704,16,234,127,361
2019-11-17 11:25:11,0.5715393518518519,1,1,1,2
2019-11-15 20:51:43,0.012326388888888888,1,2,1,3
2019-11-15 20:23:04,0.007893518518518518,1,3,0,3
2019-11-15 20:00:09,0.0019097222222222222,1,3,2,5
2019-11-30 18:45:00,15.084560185185186,1,14,2,16
2019-11-17 16:09:42,47.61225694444445,2,4,5,9
2019-11-13 22:36:42,0.0015393518518518519,1,9,2,11
2020-01-12 14:18:03,11.698055555555555,250,13592,11228,24820
2019-11-19 20:24:17,5.941574074074074,1,229,24,253
2019-11-13 12:54:48,0.49560185185185185,2,2,2,4
2019-12-17 19:04:31,15.213252314814815,1,3,3,6
2019-11-11 13:34:49,0.10768518518518519,1,3,3,6
2019-11-11 13:37:35,0.1096875,1,4,4,8
2019-11-11 13:43:43,0.11408564814814814,1,3,3,6
2020-01-11 10:51:04,6.391817129629629,1,6,4,10
2019-11-11 13:05:17,0.08784722222222222,1,3,3,6
2019-11-11 13:42:51,0.11416666666666667,1,4,4,8
2019-11-11 13:38:07,0.11112268518518519,1,3,3,6
2019-11-11 13:50:56,0.14733796296296298,1,93,27,120
2019-11-11 13:45:58,0.14476851851851852,1,24,50,74
2019-11-11 13:51:33,0.023483796296296298,1,5,5,10
2019-11-11 15:25:34,0.06320601851851852,1,46,131,177
2019-11-11 13:24:28,0.13137731481481482,1,5,5,10
2019-11-11 13:52:25,0.022916666666666665,1,7,7,14
2019-11-11 13:22:07,0.13086805555555556,1,2,7,9
2019-11-11 13:17:22,0.12824074074074074,1,15,15,30
2019-11-11 13:15:32,0.1275925925925926,1,5,5,10
2019-11-10 22:04:25,0.03934027777777778,1,738,502,1240
2019-11-10 22:04:48,1.2461574074074073,2,7,1,8
2019-11-10 22:05:03,2.3686805555555557,2,10,7,17
2019-11-08 05:45:43,0.010798611111111111,1,3,3,6
2019-11-07 19:51:49,0.05778935185185185,1,1,1,2
2019-11-07 07:06:07,0.6622685185185185,1,2,3,5
2019-11-06 15:55:22,0.029131944444444443,1,277,149,426
2019-11-06 15:55:46,0.029444444444444443,1,5,5,10
2019-11-06 15:11:09,0.1149074074074074,1,5,5,10
2019-11-06 15:12:49,0.1168287037037037,1,5,5,10
2019-11-06 15:14:27,0.1189236111111111,1,5,5,10
2019-11-06 15:14:46,0.11939814814814814,1,20,39,59
2019-11-13 21:51:49,8.312569444444444,1,5,0,5
2019-11-10 22:05:15,6.0301736111111115,1,6,2,8
2019-11-21 16:35:05,16.941238425925928,1,2,2,4
2019-11-07 07:05:08,2.614699074074074,6,127,7,134
2019-11-07 07:07:04,2.623298611111111,1,10,6,16
2019-11-07 07:08:01,2.641423611111111,1,1,1,2
2019-11-04 15:23:26,0.03753472222222222,1,7,15,22
2019-11-04 15:28:47,0.040949074074074075,1,5,13,18
2019-11-04 14:33:06,0.035173611111111114,1,5,5,10
2019-11-04 14:27:08,0.03138888888888889,1,15,30,45
2019-11-04 14:27:51,0.03288194444444444,1,37,35,72
2019-11-04 14:21:41,0.028912037037037038,1,5,5,10
2019-11-04 14:15:24,0.025416666666666667,1,5,5,10
2019-11-04 13:55:47,0.013333333333333334,1,14,6,20
2019-11-04 11:54:09,0.7696643518518519,1,3,0,3
2019-11-04 11:55:21,1.6474652777777778,19,814,792,1606
2019-12-30 02:17:55,57.711527777777775,2,2,2,4
2019-11-04 11:56:22,2.3344097222222224,1,1,0,1
2019-11-04 11:58:20,3.318912037037037,1,3,1,4
2019-11-04 12:01:38,3.332164351851852,2,2,2,4
2019-11-04 11:59:17,3.853009259259259,1,10,0,10
2019-11-04 12:02:02,3.8061226851851853,3,14,7,21
2019-11-21 10:39:08,20.78193287037037,1,13,1,14
2019-11-04 12:01:50,3.8650231481481483,1,8,1,9
2019-11-04 12:02:16,4.650196759259259,1,4,3,7
2019-11-04 12:02:27,4.926111111111111,1,1,1,2
2019-11-04 12:00:16,4.938402777777778,2,32,4,36
2019-11-16 18:02:09,17.695231481481482,6,9821,2977,12798
2019-11-04 12:03:09,6.310150462962963,1,29,3,32
2019-10-30 10:58:11,0.008344907407407407,1,9,9,18
2019-11-30 18:58:01,32.89957175925926,1,14,6,20
2019-11-21 10:36:16,23.608136574074074,1,2,2,4
2019-10-28 11:47:15,0.13067129629629629,1,5,5,10
2019-10-29 01:55:08,0.7195254629629629,1,3,3,6
2019-10-29 01:55:57,0.7203240740740741,1,2,2,4
2019-10-29 10:40:53,1.085011574074074,1,18,18,36
2019-10-28 11:48:09,0.13215277777777779,1,3,3,6
2019-10-28 11:37:40,0.16958333333333334,1,5,5,10
2019-10-28 11:46:32,0.1764236111111111,1,9,29,38
2019-10-29 02:12:05,0.7788657407407408,1,5,5,10
2019-10-28 11:42:48,0.1758449074074074,1,9,9,18
2019-10-29 01:59:12,0.7711921296296296,1,139,63,202
2019-10-28 11:04:24,0.15034722222222222,1,10,10,20
2019-11-04 12:03:30,7.385497685185185,1,17,7,24
2019-10-27 11:45:33,0.6436111111111111,1,6,1,7
2019-10-27 11:45:56,0.7941087962962963,1,2,1,3
2019-10-27 11:46:35,0.8702314814814814,1,29,14,43
2019-10-26 10:45:53,0.0002662037037037037,1,2,1,3
2019-11-13 21:53:05,18.714895833333333,1,1,9,10
2019-11-04 12:03:45,9.761840277777777,5,245,238,483
2019-10-25 09:47:41,0.5355787037037038,1,9,0,9
2019-10-24 05:49:10,0.12278935185185186,1,2,2,4
2019-10-24 20:44:43,1.4733217592592593,1,46,45,91
2019-10-24 20:45:56,2.0810300925925924,1,1,1,2
2019-10-24 20:45:44,2.3299074074074073,1,19,8,27
2019-12-01 16:25:30,40.11694444444444,5,172,62,234
2019-10-21 14:43:50,0.2619328703703704,1,4,4,8
2019-10-24 20:46:15,4.216747685185185,1,1,1,2
2019-10-24 20:45:36,6.002592592592593,1,1,0,1
2019-10-24 20:46:59,6.428587962962963,1,9,10,19
2019-10-24 20:47:25,7.189340277777778,1,1,0,1
2019-10-25 09:48:21,8.157673611111111,3,29,5,34
2019-10-24 20:47:38,8.154293981481482,1,1,0,1
2019-10-24 20:47:49,44.29505787037037,1,96,46,142
2019-12-17 12:32:57,62.046840277777775,3,16,91,107
2019-10-24 20:47:59,9.274768518518519,1,1,0,1
2019-10-24 20:48:12,9.555104166666666,1,1,1,2
2019-10-24 20:48:22,10.456689814814816,1,1,1,2
2019-11-21 15:04:53,39.16695601851852,2,2,2,4
2019-10-24 20:49:13,11.9846875,1,2,0,2
2019-10-24 20:49:27,11.998518518518518,2,4,0,4
2019-11-30 18:53:58,49.06667824074074,2,21,3,24
2019-11-13 22:24:56,5.494965277777778,250,12409,9912,22321
2019-10-10 18:30:28,0.007893518518518518,250,14323,14219,28542
2019-10-10 18:07:39,0.001736111111111111,1,8,162,170
2019-10-10 16:47:25,0.009340277777777777,1,2,2,4
2019-10-24 20:49:45,14.57037037037037,7,1692,668,2360
2019-10-10 05:03:06,0.001261574074074074,1,5,2,7
2019-10-10 04:48:54,0.00980324074074074,1,88,0,88
2019-10-10 00:21:53,0.029479166666666667,1,4,0,4
2019-10-10 03:21:39,0.2983564814814815,1,113,70,183
2019-10-10 00:22:05,0.21354166666666666,1,2,1,3
2019-10-24 20:51:42,15.841585648148149,1,26,9,35
2019-10-09 05:10:47,0.21643518518518517,1,41,18,59
2019-10-09 01:45:06,0.050625,1,6,6,12
2019-10-08 22:30:16,0.1229050925925926,1,17,8,25
2019-10-08 20:08:56,0.6458796296296296,1,9,11,20
2019-10-08 03:59:10,0.03575231481481481,1,5,1,6
2019-10-09 05:11:24,1.1872569444444445,1,15,12,27
2019-10-09 05:36:57,1.3928125,1,31,1,32
2019-10-07 18:04:57,0.033483796296296296,1,12,0,12
2019-10-21 10:16:01,13.977337962962963,1,40,8,48
2019-10-21 10:16:25,13.982407407407408,1,5,5,10
2019-10-21 10:32:44,13.99423611111111,1,5,5,10
2019-10-21 16:30:43,14.243148148148148,1,5,5,10
2019-10-21 16:51:06,14.257604166666667,2,37,15,52
2019-10-21 16:35:40,14.283634259259259,1,1,1,2
2019-10-21 16:34:00,14.28326388888889,1,1,1,2
2019-10-21 16:32:18,14.282754629629629,1,2,2,4
2019-10-21 14:45:03,14.208576388888888,1,2,2,4
2019-10-30 10:04:00,1.338310185185185,1,4,4,8
2019-10-30 10:00:42,6.170625,1,7,7,14
2019-10-07 03:05:02,0.011319444444444444,1,1,2,3
2019-10-07 02:36:33,0.003460648148148148,1,244,422,666
2019-10-07 04:05:15,0.0812962962962963,1,1,1,2
2019-10-07 02:33:31,0.019305555555555555,1,1,0,1
2019-10-07 02:24:05,0.021967592592592594,1,25,11,36
2019-10-07 02:14:37,0.027453703703703702,1,36,1,37
2019-10-07 01:56:21,0.021203703703703704,1,3,1,4
2019-10-06 20:11:30,0.02875,1,3,0,3
2019-10-06 17:48:26,0.0540625,1,3,0,3
2019-10-06 19:36:27,0.4253587962962963,1,1,1,2
2019-10-06 04:20:58,0.08875,1,1,0,1
2019-10-06 20:11:18,0.7559143518518519,1,132,141,273
2019-10-24 20:50:10,19.825011574074075,1,178,162,340
2019-10-06 02:30:08,1.4148032407407407,1,0,1,1
2019-10-10 17:59:28,5.214027777777778,250,8901,8131,17032
2019-12-04 19:36:34,62.0571875,7,11701,3768,15469
2019-10-03 19:06:56,0.035520833333333335,1,1,1,2
2019-10-03 20:37:13,0.12412037037037037,1,1,9,10
2019-10-03 20:41:22,0.17600694444444445,36,524,382,906
2019-10-03 15:50:49,0.02542824074074074,1,1,1,2
2019-10-03 15:51:00,0.0908449074074074,1,14,4,18
2019-10-03 02:13:23,0.0006712962962962962,1,25,2,27
2019-10-03 01:59:44,0.006261574074074074,1,18,8,26
2019-10-03 16:24:56,0.6107638888888889,199,15435,15241,30676
2019-10-03 01:17:42,0.025578703703703704,1,36,1,37
2019-10-03 01:17:30,0.06222222222222222,1,109,14,123
2019-10-02 19:02:49,0.012372685185185184,1,5,1,6
2019-10-02 23:09:13,53.418449074074076,5,168,52,220
2019-10-03 01:34:58,0.31788194444444445,1,99,9,108
2019-10-02 15:10:57,0.1019675925925926,1,1,1,2
2019-10-02 16:30:34,0.1841435185185185,1,2,2,4
2019-12-01 17:52:22,60.325011574074075,1,10,4,14
2019-10-02 15:28:32,0.4474074074074074,1,1,1,2
2019-10-02 19:50:44,96.97405092592592,6,37,16,53
2019-10-02 13:20:44,0.3701157407407407,1,1,1,2
2019-10-02 02:54:33,0.35082175925925924,1,2,2,4
2019-10-02 02:53:18,0.1590625,1,2,2,4
2019-10-03 01:36:53,1.1114351851851851,250,16103,15064,31167
2019-10-02 02:49:54,0.19163194444444445,1,7,7,14
2019-10-02 02:59:37,0.20300925925925925,1,92,1,93
2019-10-01 21:55:12,0.017222222222222222,1,1,1,2
2019-10-02 18:04:47,0.9598842592592592,1,10,8,18
2019-10-01 15:11:15,0.016921296296296295,1,43,1,44
2019-10-01 22:39:57,0.3522106481481482,3,5,2,7
2019-10-01 13:10:00,0.0962962962962963,2,13,2,15
2019-10-01 13:07:59,0.1261574074074074,1,1,0,1
2019-10-01 18:48:49,0.6047222222222223,1,108,8,116
2019-10-01 17:19:11,0.5951967592592593,1,13,0,13
2019-10-01 02:57:28,0.06309027777777777,1,44,10,54
2019-10-01 02:54:18,0.06893518518518518,1,3,0,3
2019-10-01 02:54:30,0.0821412037037037,1,20,7,27
2019-10-01 02:54:11,0.08672453703703703,1,3,16,19
2019-11-06 16:15:21,0.041886574074074076,2,29,58,87
2019-09-30 23:19:37,0.03726851851851852,1,229,222,451
2019-09-30 23:19:25,0.041400462962962965,1,1,1,2
2019-09-30 23:19:12,0.04506944444444445,1,46,8,54
2019-09-30 15:12:34,0.022453703703703705,1,2,2,4
2019-10-01 17:18:51,1.279201388888889,1,1,1,2
2019-10-04 01:21:22,3.0829166666666667,1,10,20,30
2019-10-04 01:23:33,3.618472222222222,1,10,16,26
2019-10-04 02:11:37,3.6723958333333333,2,3,3,6
2019-10-04 01:23:55,3.6405671296296296,1,1,1,2
2019-10-04 01:21:57,3.6396064814814815,1,3,3,6
2019-10-04 01:19:55,3.6390625,1,8,8,16
2019-10-04 01:19:19,3.6390046296296297,1,1,1,2
2019-10-04 01:18:59,3.6399421296296297,1,5,2,7
2019-09-30 23:20:23,0.7516319444444445,3,43,78,121
2019-09-30 15:02:04,0.48408564814814814,1,1,1,2
2019-09-29 19:31:52,221.91087962962962,27,592,305,897
2019-09-29 19:23:40,0.02241898148148148,1,1,1,2
2019-10-03 20:44:23,4.1619675925925925,1,5,5,10
2019-09-29 16:50:17,0.007094907407407407,1,5,1,6
2019-10-01 22:46:37,2.3105439814814814,250,14750,13460,28210
2019-09-29 14:54:36,0.007824074074074074,1,312,203,515
2019-09-29 14:54:25,0.031157407407407408,1,1,0,1
2019-09-29 20:20:56,0.2661689814814815,1,1,1,2
2019-09-29 03:03:20,0.1287962962962963,1,144,18,162
2019-09-29 19:46:06,46.30196759259259,8,247,113,360
2019-09-28 17:41:36,0.09569444444444444,1,10,9,19
2019-10-01 22:25:26,3.9694675925925926,1,44,15,59
2019-09-28 03:23:33,0.0002199074074074074,1,1,1,2
2019-09-29 14:27:01,1.6246643518518518,1,14,6,20
2019-09-29 15:10:02,1.6626967592592592,244,17059,14949,32008
2019-09-27 23:05:27,0.0271875,1,2,2,4
2019-09-27 23:33:03,0.04880787037037037,1,1,1,2
2019-09-27 23:33:17,0.05087962962962963,1,5,1,6
2019-09-29 14:23:13,1.6748032407407407,1,67,8,75
2019-09-27 23:33:28,0.12369212962962962,1,16,0,16
2019-09-27 23:02:22,0.16157407407407406,1,22,17,39
2019-09-27 17:40:27,0.049247685185185186,1,2,2,4
2019-09-27 19:13:52,0.2615162037037037,8,119,23,142
2019-09-27 13:22:12,0.038043981481481484,1,4,1,5
2019-09-27 13:23:30,0.31680555555555556,1,5,3,8
2019-09-27 13:24:14,0.3919328703703704,1,23,1,24
2019-09-27 01:07:20,0.032997685185185185,1,3,0,3
2019-09-29 14:23:02,2.7988541666666666,1,65,84,149
2019-09-27 00:14:50,0.3134837962962963,3,8,1,9
2019-09-27 00:16:12,0.2903125,1,17,6,23
2019-09-27 00:13:35,0.3076157407407407,1,10,7,17
2019-09-27 00:13:52,0.3183796296296296,1,4,2,6
2019-09-26 16:06:08,0.9877199074074074,3,17,16,33
2019-09-25 00:19:49,0.06275462962962963,1,167,1,168
2019-09-24 18:28:26,0.1245949074074074,2,15,7,22
2019-09-24 15:32:12,0.516099537037037,1,1,1,2
2019-09-24 02:35:37,0.05831018518518519,1,139,98,237
2019-09-25 00:07:12,1.1390162037037037,1,2,2,4
2019-09-23 15:25:11,0.03699074074074074,1,1,1,2
2019-09-23 13:39:12,0.17663194444444444,1,3,3,6
2019-09-23 10:48:03,0.0584837962962963,1,1,1,2
2019-09-23 10:54:26,0.06447916666666667,1,1,1,2
2019-09-23 10:52:30,0.06409722222222222,1,10,10,20
2019-09-23 11:05:41,0.026412037037037036,1,2,2,4
2019-09-23 10:26:00,0.04636574074074074,1,3,3,6
2019-09-23 10:53:10,0.06568287037037036,1,1,1,2
2019-10-21 16:31:28,28.335613425925924,2,102,121,223
2019-09-23 10:53:31,0.02232638888888889,1,26,21,47
2019-09-23 10:22:52,0.08077546296296297,1,5,5,10
2019-09-23 10:19:53,0.0790162037037037,1,5,5,10
2019-09-23 10:19:14,0.07886574074074074,1,1,145,146
2019-09-23 10:12:00,0.13895833333333332,1,0,18,18
2019-09-23 13:37:46,0.4054861111111111,1,44,1,45
2019-09-23 00:19:08,0.004178240740740741,1,0,4,4
2019-09-22 22:48:32,0.0421412037037037,1,6,6,12
2019-09-22 22:48:44,0.046377314814814816,1,1,1,2
2019-09-29 20:58:01,7.400104166666667,5,129,36,165
2019-09-22 10:58:30,0.0352662037037037,2,2,2,4
2019-09-22 00:37:16,0.1064699074074074,1,16,8,24
2019-09-27 22:56:00,5.251875,250,17318,18602,35920
2019-09-21 18:01:02,0.0027546296296296294,1,1,1,2
2019-09-21 07:11:39,0.07461805555555556,1,5,0,5
2019-09-21 07:11:59,0.12846064814814814,1,1,0,1
2019-09-21 07:11:22,0.19020833333333334,2,8,1,9
2019-09-21 00:59:38,0.06438657407407407,1,1,1,2
2019-09-21 18:04:44,0.8737847222222223,239,15118,14574,29692
2019-09-21 18:02:15,0.8755208333333333,1,8,4,12
2019-09-20 20:59:30,41.95194444444444,1,60,1,61
2019-09-21 07:12:14,0.4547453703703704,1,33,4,37
2019-09-20 19:22:17,0.14020833333333332,1,1,1,2
2019-09-21 18:01:16,1.1043287037037037,1,280,69,349
2019-09-20 15:13:45,0.15113425925925925,1,1,1,2
2019-09-20 08:51:52,0.5628125,1,2,0,2
2019-09-20 08:52:16,0.6470254629629629,1,142,29,171
2019-09-19 17:58:15,0.02494212962962963,1,1,1,2
2019-09-19 17:58:27,0.04990740740740741,1,2,2,4
2019-09-19 17:58:40,0.056331018518518516,1,52,18,70
2019-09-19 11:24:50,0.023055555555555555,1,2,2,4
2019-09-19 09:09:06,0.6153819444444445,1,322,209,531
2019-09-18 13:41:51,0.10185185185185185,2,35,2,37
2019-09-18 09:27:11,0.02228009259259259,1,7,6,13
2019-09-18 08:58:09,0.19689814814814816,1,11,1,12
2019-09-18 02:02:22,0.022546296296296297,1,2,1,3
2019-09-18 14:37:28,0.7483796296296297,1,567,50,617
2019-09-18 00:48:41,0.1745486111111111,1,13,13,26
2019-09-17 21:20:49,0.23677083333333335,1,1,1,2
2019-09-17 14:59:17,0.06063657407407407,1,3,3,6
2019-09-17 08:06:44,0.08290509259259259,1,2,2,4
2019-09-17 06:44:26,0.029849537037037036,1,2,2,4
2019-09-17 12:58:03,0.7096643518518518,1,20,4,24
2019-09-16 17:39:45,0.1988425925925926,1,9,5,14
2019-09-17 06:44:46,0.6506712962962963,1,19,5,24
2019-09-16 18:42:19,0.15925925925925927,1,6,2,8
2019-09-16 18:42:30,0.18844907407407407,1,17,13,30
2019-09-20 21:05:24,4.304884259259259,250,8741,8109,16850
2019-09-16 13:44:52,0.02113425925925926,1,1,1,2
2019-09-16 13:45:07,0.0645949074074074,3,15,7,22
2019-09-16 12:29:30,0.09923611111111111,1,3,3,6
2019-09-16 12:29:45,0.09978009259259259,1,1,1,2
2019-09-19 17:19:12,3.1994328703703703,1,3,3,6
2019-09-16 12:25:38,0.09768518518518518,1,2,2,4
2019-09-16 14:12:31,0.0699074074074074,1,3,3,6
2019-09-16 12:30:29,0.10215277777777777,1,1,1,2
2019-09-16 10:16:03,0.10873842592592593,1,26,21,47
2019-09-16 10:15:21,0.10886574074074074,1,6,6,12
2019-09-16 12:26:16,0.9274305555555555,6,43,43,86
2019-09-19 18:58:19,4.9053125,1,542,73,615
2019-09-15 13:48:01,0.27650462962962963,1,1,1,2
2019-09-14 08:36:11,0.3939930555555556,1,2,2,4
2019-09-13 22:52:56,0.14881944444444445,1,1,1,2
2019-09-16 12:32:26,2.731574074074074,4,69,39,108
2019-09-16 14:12:19,2.8126736111111112,1,3,0,3
2019-09-15 19:08:39,2.0815277777777776,2,66,61,127
2019-09-29 12:30:59,15.85994212962963,1,46,31,77
2019-09-16 12:27:30,2.9227083333333335,4,121,59,180
2019-09-13 17:16:00,0.09394675925925926,1,1,0,1
2019-09-13 17:15:48,0.09769675925925926,1,7,1,8
2019-09-13 14:00:47,0.06729166666666667,1,0,10,10
2019-09-13 14:11:14,0.07633101851851852,1,27,71,98
2019-09-13 14:01:40,0.07335648148148148,1,2,2,4
2019-09-13 14:01:27,0.09819444444444445,1,7,2,9
2019-09-13 14:00:20,0.09572916666666667,1,2,2,4
2019-09-13 14:00:34,0.09425925925925926,1,2,2,4
2019-09-13 14:01:09,0.09141203703703704,1,4,3,7
2020-09-02 00:13:11,354.7055902777778,1,42,0,42
2019-09-12 18:15:00,0.015046296296296295,1,7,1,8
2019-09-13 14:02:53,0.8650925925925926,1,1,1,2
2019-09-12 02:58:33,0.1175462962962963,3,19,1,20
2019-09-11 23:51:01,0.004606481481481481,1,1,1,2
2019-09-11 23:51:13,0.0022453703703703702,1,2,0,2
2019-09-18 10:53:14,6.8831597222222225,1,66,29,95
2019-09-11 14:32:45,0.19185185185185186,1,98,45,143
2019-09-11 06:44:59,0.47400462962962964,1,10,0,10
2019-09-10 18:55:23,0.07903935185185185,1,2,2,4
2019-09-13 14:03:47,2.8869907407407407,1,5,0,5
2019-09-10 18:56:08,0.10652777777777778,1,7,3,10
2019-09-10 18:56:43,0.1345023148148148,1,18,2,20
2019-09-16 13:11:02,5.265787037037037,250,15546,14595,30141
2019-09-09 18:42:44,0.027037037037037037,1,6,2,8
2019-09-09 20:44:18,0.3125810185185185,1,281,176,457
2019-09-09 10:50:09,0.03180555555555555,1,142,19,161
2019-09-09 10:52:34,0.10846064814814815,1,1,1,2
2019-09-09 10:50:38,0.10747685185185185,1,1,1,2
2019-09-09 11:03:07,0.1165162037037037,1,4,4,8
2019-09-09 10:49:55,0.1077199074074074,1,2,2,4
2019-09-09 11:08:46,0.12114583333333333,1,4,4,8
2019-09-09 11:10:17,0.12256944444444444,1,1,1,2
2019-09-09 10:49:14,0.10832175925925926,2,3,3,6
2019-09-09 11:07:03,0.1264699074074074,1,455,263,718
2019-09-09 10:42:40,0.10960648148148149,1,35,35,70
2019-09-09 10:40:31,0.10822916666666667,1,10,10,20
2019-09-09 08:50:34,1.2687268518518517,2,92,17,109
2019-09-10 11:48:48,1.7217476851851852,1,200,337,537
2019-09-10 13:29:13,1.9695138888888888,1,92,16,108
2019-09-08 17:17:58,0.8846180555555555,1,3,2,5
2019-09-07 00:47:52,0.3468865740740741,1,15,3,18
2019-09-07 03:12:21,0.5335300925925925,1,6,8,14
2019-09-05 13:51:52,0.035138888888888886,1,2,0,2
2019-09-05 04:14:30,0.0571875,1,4,1,5
2019-09-05 04:14:06,0.025752314814814815,1,4,1,5
2019-09-05 04:13:50,0.030983796296296297,1,1,1,2
2019-09-06 11:55:52,1.5467939814814815,1,219,2,221
2019-09-04 20:30:50,0.012013888888888888,1,1,0,1
2019-09-05 03:32:54,0.7143402777777778,2,49,31,80
2019-09-04 18:44:09,0.4023148148148148,1,2,0,2
2019-09-04 08:10:19,0.03009259259259259,1,2,2,4
2019-09-04 02:14:13,0.05416666666666667,1,1,1,2
2019-09-04 02:13:55,0.0671412037037037,1,77,23,100
2019-09-03 20:53:28,0.16126157407407407,2,19,10,29
2019-09-03 20:52:33,0.5272453703703703,3,24,29,53
2019-09-03 02:56:40,0.017361111111111112,1,6,4,10
2019-09-03 02:56:55,0.025486111111111112,1,19,3,22
2019-09-03 05:59:52,0.18344907407407407,1,1,1,2
2019-09-03 04:35:45,0.12260416666666667,1,2,2,4
2019-09-03 03:57:31,0.09725694444444444,1,3,3,6
2019-09-03 02:57:08,0.05202546296296296,1,1,1,2
2019-09-02 16:11:35,0.2388310185185185,1,2,0,2
2019-09-02 16:12:13,0.2950115740740741,1,1,1,2
2019-09-04 16:42:35,2.3269675925925926,1,3,3,6
2019-09-04 16:44:02,2.3283217592592593,1,3,3,6
2019-09-05 03:31:47,0.01752314814814815,1,5,5,10
2019-09-05 03:04:46,2.760011574074074,2,7,7,14
2019-09-04 16:45:20,2.3303356481481483,1,2,2,4
2019-09-04 16:46:37,2.3315046296296296,1,5,5,10
2019-09-04 16:45:46,2.3318287037037035,1,2,2,4
2020-03-21 03:04:55,198.43100694444445,6,16587,5201,21788
2019-09-02 11:18:23,0.14950231481481482,1,5,5,10
2019-09-02 11:19:17,0.1502662037037037,1,13,48,61
2019-09-02 16:12:28,0.4835069444444444,1,130,7,137
2019-09-02 16:12:41,1.1655208333333333,2,5,1,6
2019-09-13 14:04:10,12.113854166666666,1,4,4,8
2019-09-01 18:04:36,0.3100347222222222,1,42,1,43
2019-09-01 17:43:35,0.4153125,1,19,4,23
2019-09-01 17:44:06,0.4370949074074074,1,5,2,7
2019-09-02 16:11:14,1.5025810185185184,1,179,37,216
2019-08-31 18:06:50,0.13407407407407407,1,2,2,4
2019-08-30 14:59:11,0.19793981481481482,1,10,10,20
2019-08-31 18:07:30,1.3377546296296297,3,7,7,14
2019-08-30 05:41:38,0.10357638888888888,1,1,1,2
2019-08-30 05:41:17,0.14493055555555556,1,83,5,88
2019-08-29 23:34:34,0.09829861111111111,1,4,6,10
2019-08-30 00:19:17,0.17857638888888888,1,18,10,28
2019-08-29 23:34:48,0.1625,1,41,3,44
2019-08-30 00:49:34,0.23271990740740742,1,1,1,2
2019-08-30 00:49:45,0.226875,1,1,2,3
2019-08-29 23:34:22,0.19049768518518517,1,3,3,6
2019-08-29 23:34:59,0.17252314814814815,1,3,3,6
2019-08-30 00:49:55,0.24015046296296297,1,5,0,5
2019-08-29 23:35:12,0.18204861111111112,1,3,0,3
2019-08-29 18:51:31,17.124525462962964,1,1,1,2
2019-08-29 22:14:37,1.1679282407407408,2,716,160,876
2019-08-30 02:30:29,1.3310300925925926,2,4,4,8
2019-08-29 23:57:38,1.312824074074074,1,27,17,44
2019-08-28 01:56:21,0.2908101851851852,1,3,3,6
2019-08-27 14:50:40,0.8106597222222223,2,19,9,28
2019-08-26 19:17:44,0.029733796296296296,1,8,6,14
2020-03-08 23:10:30,195.29052083333335,4,76,32,108
2019-08-26 16:24:11,0.05996527777777778,3,156,43,199
2019-08-26 14:04:53,0.2356712962962963,1,5,5,10
2019-08-26 14:05:20,0.23631944444444444,1,1,1,2
2019-08-26 13:46:10,0.223125,1,1,1,2
2019-08-26 09:54:51,0.08512731481481481,1,15,15,30
2019-08-26 13:40:41,0.2423611111111111,1,5,5,10
2019-08-26 13:39:42,0.2424537037037037,1,12,29,41
2019-08-25 14:22:21,0.012905092592592593,2,29,26,55
2019-08-25 13:48:50,0.1701851851851852,1,14,4,18
2019-08-25 13:49:03,0.19967592592592592,1,26,2,28
2019-08-25 13:09:19,0.32122685185185185,2,31,8,39
2019-08-25 00:13:41,0.0034837962962962965,1,9,3,12
2019-08-24 02:12:28,0.16012731481481482,1,13,1,14
2019-08-23 19:03:00,0.01733796296296296,1,1,1,2
2019-08-23 20:38:03,0.7314930555555555,1,337,15,352
2019-08-23 03:05:21,0.2579166666666667,1,13,1,14
2019-08-23 20:37:24,1.9827083333333333,1,85,14,99
2019-08-22 02:17:13,0.2059837962962963,1,22,10,32
2019-08-21 10:35:41,0.2149074074074074,1,1,1,2
2019-08-22 02:37:19,1.1872569444444445,4,33,8,41
2019-08-20 22:18:08,0.03357638888888889,1,1,1,2
2019-08-20 17:46:42,0.1957986111111111,1,7,1,8
2019-09-10 10:43:07,10.908020833333333,250,8851,7071,15922
2019-08-20 00:19:02,0.09872685185185186,1,5,5,10
2019-08-22 19:55:57,3.1555092592592593,3,43,9,52
2019-08-19 18:36:45,0.06959490740740741,1,1,1,2
2019-08-19 18:36:59,0.07049768518518519,1,4,2,6
2019-08-19 16:49:18,0.22989583333333333,1,3,3,6
2019-08-19 16:49:41,0.13193287037037038,1,1,1,2
2019-08-19 13:37:23,0.09773148148148147,1,4,4,8
2019-09-10 10:44:48,5.750266203703704,1,2,2,4
2019-08-19 13:36:46,0.09793981481481481,1,3,3,6
2019-08-19 13:34:31,0.0965625,1,3,3,6
2019-08-19 13:32:29,0.09576388888888888,1,3,3,6
2019-08-19 13:24:32,0.0945949074074074,1,8,1,9
2019-08-19 13:30:02,0.0990162037037037,1,5,5,10
2019-08-19 13:29:02,0.09870370370370371,1,5,5,10
2019-08-19 13:26:06,0.09752314814814815,1,5,5,10
2019-08-30 05:42:51,11.365046296296295,1,1,1,2
2019-08-18 12:57:05,0.4366087962962963,1,1,0,1
2019-08-18 12:55:03,0.44362268518518516,1,52,3,55
2019-08-19 17:05:14,1.6310995370370371,247,12774,12655,25429
2020-09-02 00:11:13,380.99444444444447,1,49,16,65
2019-08-18 12:55:33,0.6725462962962963,1,29,5,34
2019-08-18 01:48:39,0.23827546296296295,167,12374,12322,24696
2019-08-17 20:59:40,0.04702546296296296,1,7,3,10
2019-08-18 16:03:57,0.8415162037037037,1,20,1,21
2019-08-18 16:04:18,0.8424421296296296,1,7,0,7
2019-08-17 20:04:16,0.026979166666666665,1,7,7,14
2019-08-17 20:04:32,0.041041666666666664,1,12,0,12
2019-08-17 16:07:52,1.0187731481481481,1,45,13,58
2019-08-16 17:15:06,0.0990625,1,32,63,95
2019-08-16 20:58:52,0.4893402777777778,4,11,10,21
2019-08-16 11:00:31,0.3327893518518519,1,25,15,40
2019-08-18 01:45:52,2.0841203703703703,2,151,15,166
2019-08-15 23:54:37,0.06815972222222222,1,14,4,18
2019-08-15 20:47:52,0.05510416666666667,1,8,3,11
2019-08-15 20:49:01,0.06952546296296297,2,11,4,15
2019-08-16 00:08:36,0.23913194444444444,1,2,0,2
2019-08-15 18:28:57,0.009594907407407408,1,33,2,35
2019-08-15 18:28:45,0.008576388888888889,1,0,2,2
2019-08-15 15:24:46,0.023078703703703702,3,25,13,38
2019-08-15 09:52:27,0.041122685185185186,1,1,1,2
2019-08-15 18:20:03,0.6675231481481482,1,1,1,2
2019-08-15 13:13:26,0.7697453703703704,1,275,34,309
2019-08-14 02:07:33,0.033032407407407406,1,157,126,283
2019-08-13 13:30:38,0.10611111111111111,1,2,0,2
2019-08-13 10:22:16,0.5384837962962963,1,95,1,96
2019-08-13 10:22:33,0.5980439814814815,1,3,1,4
2019-08-12 20:26:08,0.03181712962962963,1,4,0,4
2019-08-12 15:52:12,0.013449074074074073,1,1,1,2
2019-08-15 18:20:21,3.312349537037037,1,1,1,2
2019-08-12 11:11:56,0.06582175925925926,1,10,10,20
2019-08-12 11:14:23,0.06765046296296297,1,1,1,2
2019-08-12 11:11:18,0.06561342592592592,1,4,4,8
2019-08-12 11:10:16,0.06505787037037038,1,2,2,4
2019-08-12 11:08:38,0.10039351851851852,1,31,24,55
2019-08-12 12:19:50,0.047893518518518516,1,5,5,10
2019-08-12 11:07:58,0.1025462962962963,1,5,5,10
2019-08-12 11:06:05,0.10263888888888889,1,71,33,104
2019-08-11 21:48:57,0.02417824074074074,1,1,1,2
2019-08-11 20:59:40,0.02533564814814815,1,6,0,6
2019-08-15 23:24:04,4.386064814814815,8,226,193,419
2019-08-11 11:15:19,0.15693287037037038,1,1,1,2
2019-08-08 21:04:20,0.07875,1,24,5,29
2019-08-08 21:04:05,0.15638888888888888,1,2,1,3
2019-08-11 11:14:52,2.7580324074074074,1,31,13,44
2019-08-08 21:03:29,0.1721990740740741,1,4,3,7
2019-08-08 15:05:52,0.13523148148148148,2,9,10,19
2019-08-08 06:56:55,0.4891550925925926,1,4,1,5
2019-08-07 19:14:08,0.02199074074074074,1,40,11,51
2019-08-08 21:03:10,1.142962962962963,1,3,1,4
2019-08-07 18:20:40,0.038483796296296294,1,57,0,57
2019-08-07 18:20:23,0.17969907407407407,9,140,36,176
2019-08-07 14:13:35,0.013981481481481482,1,18,6,24
2019-08-07 15:08:31,0.07400462962962963,1,13,8,21
2019-08-07 11:58:54,0.12907407407407406,1,44,7,51
2019-08-07 08:01:19,0.4504398148148148,1,8,8,16
2019-08-07 08:01:56,0.5144560185185185,2,8,16,24
2019-08-06 17:40:07,5.352013888888889,1,19,1,20
2019-08-07 08:00:59,0.6314930555555556,1,7,2,9
2019-08-06 15:57:53,0.09712962962962964,1,189,13,202
2019-08-06 10:09:29,0.032337962962962964,1,10,101,111
2019-08-06 10:08:20,0.0777199074074074,1,8,0,8
2019-08-06 09:59:14,0.5852777777777778,1,1,1,2
2019-08-06 09:59:29,0.7292013888888889,1,23,0,23
2019-08-06 09:59:59,0.799675925925926,3,58,4,62
2019-08-06 09:59:47,0.8830439814814814,5,32,23,55
2019-08-05 17:54:29,0.15744212962962964,1,258,173,431
2019-08-06 13:33:04,1.1702546296296297,2,17,17,34
2019-08-05 09:52:58,0.050011574074074076,1,2,2,4
2019-08-05 09:42:52,0.04412037037037037,1,5,5,10
2019-08-05 09:53:31,0.053020833333333336,1,3,3,6
2019-08-05 09:25:41,0.03715277777777778,1,3,3,6
2019-08-05 09:25:57,0.04034722222222222,1,5,5,10
2019-08-05 09:00:16,0.024027777777777776,1,5,5,10
2019-08-05 08:40:36,0.012118055555555556,1,5,5,10
2019-08-04 21:00:39,0.2634722222222222,1,1,1,2
2019-08-03 17:10:40,0.02238425925925926,1,2,2,4
2019-08-03 17:10:50,0.08273148148148148,3,48,10,58
2019-09-09 12:15:53,36.95834490740741,2,114,43,157
2019-08-01 17:57:09,0.04369212962962963,1,1,1,2
2019-08-01 17:17:18,0.031712962962962964,1,55,30,85
2019-08-01 17:14:03,0.3253009259259259,1,1,91,92
2019-08-01 10:26:59,0.6782870370370371,1,53,15,68
2019-08-03 17:11:09,2.940150462962963,4,17,9,26
2019-07-31 07:23:30,0.025381944444444443,1,1,1,2
2019-07-31 08:06:59,0.30712962962962964,2,2,2,4
2019-07-30 18:29:51,0.2969560185185185,3,7,5,12
2019-07-30 10:06:22,0.020381944444444446,1,2,1,3
2019-07-29 18:42:05,0.21079861111111112,1,2,1,3
2019-07-29 13:04:50,0.05362268518518518,1,17,17,34
2019-07-29 18:40:22,0.3060648148148148,1,51,4,55
2019-07-29 13:29:18,0.22869212962962962,1,8,8,16
2019-07-29 13:37:02,0.2341550925925926,1,3,3,6
2019-07-29 13:48:56,0.24253472222222222,1,3,3,6
2019-07-29 13:39:55,0.23644675925925926,1,1,1,2
2019-07-29 13:51:04,0.2444212962962963,1,1,1,2
2019-07-29 18:42:20,0.4710300925925926,1,19,3,22
2019-07-29 13:03:06,0.23677083333333335,1,148,73,221
2019-07-29 13:30:44,0.25725694444444447,1,85,7,92
2019-07-29 13:06:16,0.24131944444444445,1,28,28,56
2019-07-29 12:54:15,0.23447916666666666,1,8,8,16
2019-07-30 11:10:41,1.6625231481481482,2,18,6,24
2019-07-30 10:13:30,1.6921180555555555,7,116,25,141
2019-07-28 15:47:38,0.00032407407407407406,1,42,17,59
2019-07-28 15:30:13,0.27671296296296294,1,17,42,59
2019-07-28 12:37:53,0.17322916666666666,1,107,27,134
2019-07-28 11:46:04,0.23064814814814816,1,2,2,4
2019-07-27 17:25:16,0.03215277777777778,1,3,0,3
2019-07-28 03:59:52,1.3981597222222222,1,53,18,71
2019-07-27 08:24:27,0.04065972222222222,1,36,2,38
2019-07-26 16:55:33,0.04,3,16,8,24
2019-07-27 02:42:09,0.5365509259259259,1,112,6,118
2019-07-27 03:49:51,0.6980787037037037,2,77,9,86
2019-07-27 02:41:56,0.86625,1,1,1,2
2019-07-26 05:57:28,32.10296296296296,1,5,5,10
2019-07-28 04:00:52,2.5089236111111113,1,5,0,5
2019-07-30 11:18:23,4.866527777777778,3,26,5,31
2019-07-28 11:48:05,2.9336574074074075,1,13,36,49
2019-07-24 12:19:18,0.9054629629629629,5,26,7,33
2019-07-23 13:47:49,0.04701388888888889,1,0,3,3
2019-07-23 13:47:19,0.09793981481481481,1,4,0,4
2019-07-25 02:22:10,1.6768865740740742,1,7,7,14
2019-07-25 02:17:36,1.737789351851852,1,51,35,86
2019-07-22 14:11:02,0.02528935185185185,1,1,1,2
2019-07-22 14:07:43,0.024166666666666666,1,3,3,6
2019-07-22 14:05:35,0.023194444444444445,1,4,4,8
2019-07-22 14:04:18,0.0228125,1,5,5,10
2019-07-22 14:06:35,0.02476851851851852,1,3,3,6
2019-07-22 08:37:11,0.05414351851851852,1,69,53,122
2019-07-23 09:07:48,1.0772800925925925,2,53,46,99
2019-07-22 08:36:56,0.04680555555555556,1,10,68,78
2019-07-22 07:27:45,0.011875,1,5,5,10
2019-07-22 07:27:17,0.015833333333333335,1,5,5,10
2019-07-22 04:16:31,0.1689351851851852,2,15,3,18
2019-07-23 09:08:12,1.340625,1,65,65,130
2019-07-22 08:48:51,1.2815856481481482,1,298,148,446
2019-07-21 16:11:10,0.23738425925925927,1,1,1,2
2019-07-21 01:40:09,0.8065972222222222,1,2,1,3
2019-07-19 21:13:22,0.09052083333333333,1,3,3,6
2019-07-19 21:22:36,0.12439814814814815,2,6,2,8
2019-07-19 07:25:22,0.030914351851851853,1,162,42,204
2019-07-18 23:44:58,0.1942824074074074,2,6,0,6
2019-07-19 01:58:47,0.3521064814814815,6,16,13,29
2019-07-18 18:28:06,0.07803240740740741,1,3,2,5
2019-07-21 01:40:28,2.4317824074074075,1,1,1,2
2019-07-19 07:18:24,0.6826967592592592,1,1,1,2
2019-07-21 16:10:41,3.1004745370370372,6,154,27,181
2019-07-18 01:02:56,0.09498842592592592,1,38,2,40
2019-07-17 22:48:27,0.009270833333333334,1,1,1,2
2019-07-21 16:10:08,3.740439814814815,2,2,2,4
2019-07-18 01:02:31,0.14292824074074073,1,8,8,16
2019-07-18 01:02:15,0.18641203703703704,1,4,4,8
2019-07-17 15:14:25,0.23074074074074075,1,1,1,2
2019-07-17 17:29:38,0.5233796296296296,1,2,0,2
2019-07-21 20:32:17,4.662002314814814,1,64,50,114
2019-07-16 23:53:37,0.050416666666666665,2,8,2,10
2019-07-16 22:00:39,0.08307870370370371,2,13,4,17
2019-07-16 12:25:57,0.012650462962962962,1,0,15,15
2019-07-16 04:51:37,0.032337962962962964,1,1,1,2
2019-07-18 23:44:43,3.378726851851852,19,220,131,351
2019-07-28 11:48:20,13.092395833333333,5,150,77,227
2019-07-15 14:10:25,0.16618055555555555,1,1,1,2
2019-07-28 11:48:44,12.879907407407407,2,22,10,32
2019-07-15 16:04:47,0.057337962962962966,1,5,5,10
2019-07-15 16:24:27,0.020543981481481483,1,8,7,15
2019-07-17 23:07:02,2.3508796296296297,1,3,3,6
2019-07-15 16:06:31,0.05856481481481481,1,5,5,10
2019-07-23 09:10:43,1.2818402777777778,2,7,7,14
2019-07-15 15:52:23,0.048657407407407406,1,5,5,10
2019-07-15 16:13:58,0.06358796296296296,1,10,16,26
2019-07-17 23:06:40,2.350439814814815,1,1,1,2
2019-07-19 16:08:02,4.0596875,1,1,1,2
2019-07-17 23:06:15,2.3500694444444443,1,4,3,7
2019-08-17 20:02:38,17.484467592592594,250,8110,6290,14400
2019-07-15 05:50:14,0.07966435185185185,1,43,0,43
2019-07-21 02:08:00,5.954791666666667,1,14,203,217
2019-07-15 03:56:35,0.03795138888888889,1,4,4,8
2019-07-15 00:29:04,0.17092592592592593,1,3,1,4
2019-08-19 09:35:49,35.79163194444445,11,240,48,288
2019-07-17 19:09:16,3.305810185185185,4,37,20,57
2019-07-15 00:29:40,0.5335532407407407,1,1,1,2
2019-07-14 05:05:12,0.4946875,2,26,50,76
2019-07-12 16:46:22,0.034895833333333334,1,1,1,2
2019-07-30 09:10:47,24.398912037037036,1,302,53,355
2019-07-11 12:50:28,0.1378125,1,1,1,2
2019-07-11 04:33:08,0.05503472222222222,1,5,5,10
2019-07-11 12:49:56,0.7606712962962963,1,43,40,83
2019-07-10 15:10:44,0.21091435185185184,1,0,6,6
2019-07-10 15:10:12,0.22858796296296297,1,5,4,9
2019-07-10 15:09:10,0.2398611111111111,1,5,0,5
2019-07-09 22:43:31,0.31074074074074076,1,0,10,10
2019-07-11 18:11:09,2.7730324074074075,4,120,65,185
2019-07-09 01:27:37,0.1700462962962963,1,108,51,159
2019-12-17 12:33:37,161.79443287037037,7,32,22,54
2019-07-08 16:17:23,0.011863425925925927,1,1,1,2
2019-07-08 09:26:42,0.08133101851851852,1,8,8,16
2019-07-08 09:28:34,0.08313657407407407,1,5,5,10
2019-07-08 09:29:01,0.08359953703703704,1,1,1,2
2019-07-08 09:26:12,0.08206018518518518,1,1,1,2
2019-07-13 14:52:09,5.308587962962963,1,4,4,8
2019-07-08 07:48:45,0.025949074074074076,1,9,9,18
2019-07-08 07:49:27,0.027962962962962964,1,7,2,9
2019-07-08 09:24:39,0.09581018518518518,1,10,10,20
2019-07-08 09:25:20,0.0973611111111111,1,19,16,35
2019-07-10 16:59:29,2.6174074074074074,1,142,216,358
2019-07-08 10:04:07,0.3715509259259259,1,0,113,113
2019-07-08 10:03:45,0.6248726851851852,1,299,289,588
2019-07-07 16:13:20,0.02474537037037037,1,1,1,2
2019-07-07 14:16:52,0.621875,1,130,2791,2921
2019-07-06 16:18:08,0.04266203703703704,1,4,1,5
2019-07-07 00:05:39,0.4709143518518519,4,56,43,99
2019-07-06 11:54:33,0.5097106481481481,1,6,3,9
2019-07-08 00:24:26,2.1918171296296296,2,3,1,4
2019-07-05 20:03:01,0.038391203703703705,1,1,1,2
2019-07-02 14:03:55,0.0928125,1,44,24,68
2019-07-01 22:59:53,0.05210648148148148,1,1,1,2
2019-07-02 09:34:39,0.5697106481481482,1,3,21,24
2019-07-07 01:37:02,5.256053240740741,1,10,6,16
2019-07-01 23:01:17,0.14907407407407408,1,5,3,8
2019-07-01 13:36:45,0.22907407407407407,1,4,4,8
2019-07-01 13:33:55,0.22768518518518518,1,1,1,2
2019-07-01 13:34:26,0.2285763888888889,1,1,1,2
2019-07-01 13:34:51,0.2296412037037037,1,4,4,8
2019-07-08 07:49:48,6.808252314814815,1,69,12,81
2019-07-01 12:29:57,0.19533564814814816,1,5,5,10
2019-07-01 12:23:40,0.19265046296296295,1,122,59,181
2019-07-01 17:13:31,0.5872685185185185,1,4,2,6
2019-07-13 14:45:51,12.887060185185184,12,433,61,494
2019-07-05 00:15:13,5.117222222222222,1,0,1,1
2019-07-05 00:15:25,5.116180555555555,1,2,27,29
2019-07-05 00:14:57,5.12037037037037,1,0,172,172
2019-06-29 22:12:39,0.11211805555555555,3,40,21,61
2019-06-30 14:10:44,0.7851388888888889,1,3,1,4
2019-08-19 17:00:34,51.41212962962963,1,19,17,36
2019-06-29 16:32:06,0.41230324074074076,1,4,2,6
2019-06-29 16:32:37,0.4587731481481481,1,2,1,3
2019-07-06 21:26:17,8.065196759259258,3,71,3570,3641
2019-06-30 14:11:22,1.7935300925925926,1,7,0,7
2019-07-01 22:36:16,3.164525462962963,1,7,1,8
2019-06-28 17:29:11,0.020150462962962964,1,1,1,2
2019-06-28 11:52:15,0.020729166666666667,1,5,1,6
2019-06-28 13:54:11,0.6119560185185186,1,86,18,104
2019-09-22 12:15:18,86.88148148148149,4,32,7,39
2019-06-27 17:41:56,0.17452546296296295,2,50,1,51
2019-06-27 07:16:55,0.018692129629629628,1,1,1,2
2019-06-26 17:32:37,0.08219907407407408,1,36,3,39
2019-06-26 17:33:05,0.14827546296296296,3,25,7,32
2019-06-26 12:28:36,0.6127893518518519,1,2,2,4
2019-06-26 00:16:25,0.19180555555555556,1,1,1,2
2019-06-25 18:18:16,0.1958912037037037,1,6,2,8
2019-06-25 12:45:15,0.8745138888888889,3,12,3,15
2019-06-25 13:45:33,1.2494560185185186,1,8,8,16
2019-06-25 13:49:45,1.2531712962962962,1,1,1,2
2019-06-25 13:37:27,1.2450347222222222,1,3,3,6
2019-06-25 13:39:35,1.2468402777777778,1,1,1,2
2019-06-25 18:51:35,1.4800694444444444,1,5,5,10
2019-06-25 13:36:57,1.262349537037037,1,46,5,51
2019-06-25 13:32:59,1.2603819444444444,1,23,10,33
2019-06-25 13:51:58,1.2743171296296296,1,138,95,233
2019-06-25 13:24:50,1.2565625,1,6,6,12
2019-06-22 16:13:53,0.0006365740740740741,1,4,4,8
2019-07-15 04:12:06,18.435127314814814,250,7195,6695,13890
2019-06-22 15:28:27,0.00030092592592592595,1,15,1,16
2019-06-22 14:54:06,0.07030092592592592,1,19,2,21
2019-06-22 13:29:25,0.06710648148148148,1,1,1,2
2019-06-22 10:08:17,0.3924652777777778,1,10,2,12
2019-06-22 00:50:37,0.008414351851851852,1,10,2,12
2019-06-22 15:26:10,0.6599537037037037,14,554,536,1090
2019-06-21 23:51:28,0.028738425925925924,1,27,2,29
2019-06-21 20:59:44,0.03832175925925926,2,9,4,13
2019-06-21 22:39:09,0.25288194444444445,1,13,16,29
2019-06-21 22:13:10,0.3975578703703704,3,95,31,126
2019-06-20 08:52:36,0.3635185185185185,1,26,4,30
2019-06-20 00:18:07,0.10108796296296296,1,0,4,4
2019-06-19 16:25:07,0.018819444444444444,1,1,1,2
2019-06-19 21:42:39,0.2637731481481482,2,80,48,128
2019-06-19 15:30:09,0.23288194444444443,3,2,2,4
2019-06-21 22:57:50,2.0491319444444445,250,11437,11282,22719
2019-06-18 16:23:08,0.10464120370370371,1,12,2,14
2019-06-27 19:12:27,9.25900462962963,2,26,6,32
2019-06-18 16:22:03,0.15730324074074073,1,1,1,2
2019-06-17 15:19:01,0.07806712962962963,1,8,38,46
2019-06-17 15:04:25,0.06818287037037037,1,19,5,24
2019-06-17 15:20:55,0.08002314814814815,1,11,5,16
2019-06-17 15:28:29,0.015046296296296295,1,76,46,122
2019-06-17 14:14:53,0.034652777777777775,1,7,7,14
2019-06-17 12:23:30,0.053252314814814815,1,1,1,2
2019-06-17 13:50:20,0.06337962962962963,1,3,3,6
2019-06-17 14:23:14,0.0803125,1,3,3,6
2019-06-16 16:36:48,0.14900462962962963,1,3,1,4
2019-06-16 16:46:55,0.17943287037037037,1,3,2,5
2019-06-16 17:12:13,2.1684490740740743,2,1,2,3
2019-06-14 12:52:32,0.022060185185185186,1,49,84,133
2019-06-18 20:58:19,4.982951388888889,184,4361,2754,7115
2019-06-13 18:17:57,0.07688657407407408,7,152,138,290
2019-06-13 18:19:22,0.8010185185185185,1,2,2,4
2019-06-13 16:05:52,0.03784722222222222,9,203,180,383
2019-06-12 22:43:59,0.00045138888888888887,1,4,1,5
2019-06-13 14:49:20,0.022372685185185186,250,11968,11943,23911
2019-06-12 22:14:28,0.11688657407407407,1,5,5,10
2019-06-12 22:16:47,0.12744212962962964,1,6,2,8
2019-06-13 15:07:43,0.8646527777777778,1,1,14,15
2019-06-12 22:14:42,0.22534722222222223,1,5,2,7
2019-06-12 22:16:28,0.23541666666666666,1,2,1,3
2019-06-12 21:46:20,0.19006944444444446,250,12276,12089,24365
2019-06-12 13:53:05,0.018449074074074073,1,6,0,6
2019-06-12 13:56:18,0.028622685185185185,250,13710,15164,28874
2019-06-12 13:56:41,0.6748842592592592,1,2,2,4
2019-06-11 17:55:30,0.028842592592592593,3,106,3,109
2019-06-11 15:37:53,0.029548611111111112,2,11,11,22
2019-06-11 04:06:43,0.012326388888888888,1,1,1,2
2019-06-11 04:08:41,0.03315972222222222,1,216,124,340
2019-06-11 00:26:38,0.0812962962962963,1,6,1,7
2019-06-10 19:36:21,0.05084490740740741,1,34,14,48
2019-06-10 17:26:44,0.07193287037037037,1,1,1,2
2019-06-10 17:27:11,0.1187962962962963,1,5,0,5
2019-06-17 12:17:33,0.28391203703703705,1,5,5,10
2019-06-17 12:17:12,0.2834027777777778,1,7,17,24
2019-06-17 12:17:03,0.28324074074074074,1,32,31,63
2019-06-17 12:16:48,0.28300925925925924,1,27,48,75
2019-06-12 00:29:49,1.5063657407407407,2,15,4,19
2019-06-17 12:16:24,0.28292824074074074,1,1,1,2
2019-06-17 12:16:15,0.28278935185185183,1,1,1,2
2019-06-17 12:16:04,0.2825578703703704,1,2,2,4
2019-06-17 12:17:46,0.28358796296296296,1,6,6,12
2019-06-17 12:15:34,0.28202546296296294,1,5,5,10
2019-06-10 07:25:28,0.009467592592592593,1,9,8,17
2019-06-10 10:27:17,0.19342592592592592,1,1,1,2
2019-06-10 04:07:11,0.07934027777777777,1,2,2,4
2019-06-10 04:12:28,0.09195601851851852,1,9,0,9
2019-06-10 04:12:52,0.11180555555555556,1,3,0,3
2019-06-10 10:28:14,0.490787037037037,1,8,0,8
2019-06-09 20:55:29,0.01826388888888889,1,2,2,4
2019-06-09 20:55:38,0.09425925925925926,6,17,12,29
2019-06-09 19:07:50,0.06391203703703703,1,11,0,11
2019-06-09 14:23:31,0.012002314814814815,1,1,1,2
2019-06-09 13:52:43,0.005092592592592593,1,156,0,156
2019-06-09 13:53:08,0.5992708333333333,1,54,3,57
2019-06-08 23:59:43,0.02244212962962963,1,2,2,4
2019-06-09 10:47:34,0.4795833333333333,1,7,2,9
2019-06-08 16:43:12,0.0103125,1,2,2,4
2019-06-08 23:32:23,561.6983912037037,35,18984,8460,27444
2019-06-13 15:04:53,5.020462962962963,2,16,0,16
2019-06-08 20:33:00,0.2621875,2,108,3,111
2019-06-08 15:58:41,0.06873842592592593,5,20,7,27
2019-06-08 13:30:06,0.013356481481481481,2,18,19,37
2019-06-08 08:23:42,0.5076967592592593,1,290,51,341
2019-06-07 21:35:27,0.09775462962962964,1,4,0,4
2019-06-07 15:15:19,0.0103125,1,10,7,17
2019-06-07 14:51:09,0.06938657407407407,1,18,7,25
2019-06-07 10:12:18,0.022025462962962962,1,11,0,11
2019-06-07 01:24:11,0.1733912037037037,1,5,2,7
2019-06-08 15:40:59,2.112222222222222,4,53,44,97
2019-06-06 16:51:47,0.1680324074074074,1,84,310,394
2019-06-07 10:41:09,0.9933101851851852,1,0,1,1
2019-06-06 11:04:35,0.02789351851851852,1,1,0,1
2019-06-06 10:30:15,0.1608449074074074,2,12,4,16
2019-06-06 11:40:18,0.3013310185185185,1,1,1,2
2019-06-07 01:39:25,1.0493981481481482,1,129,295,424
2019-06-06 10:31:48,0.7775462962962963,2,11,0,11
2019-06-06 11:04:50,0.9613310185185185,1,17,0,17
2019-06-05 12:03:00,0.23945601851851853,3,8,46,54
2019-06-05 11:40:00,0.19591435185185185,1,3,5,8
2019-06-05 13:29:46,0.3076157407407407,2,20,8,28
2019-06-05 11:40:21,0.23710648148148147,1,1,1,2
2019-06-04 21:24:32,0.15762731481481482,2,4,16,20
2019-06-04 21:11:18,4.5873842592592595,1,79,153,232
2019-06-04 17:35:20,0.003935185185185185,1,0,8,8
2019-06-04 21:11:45,0.2049074074074074,1,2,2,4
2019-06-04 17:50:39,0.06759259259259259,1,2,1,3
2019-06-04 16:00:10,0.016087962962962964,1,6,1,7
2019-06-04 21:11:58,0.2597453703703704,1,4,0,4
2019-06-04 18:10:27,0.1308912037037037,2,31,4,35
2019-06-04 15:23:18,0.11793981481481482,2,502,65,567
2019-06-04 13:25:52,0.05561342592592593,1,9,1,10
2019-06-04 12:17:09,0.026944444444444444,1,51,29,80
2019-06-04 15:56:32,0.2076736111111111,1,5,5,10
2019-06-04 11:28:59,0.02207175925925926,1,16,16,32
2019-06-04 09:23:20,0.00951388888888889,1,2,2,4
2019-06-04 11:50:07,0.21253472222222222,1,1,1,2
2019-06-04 05:15:33,0.45743055555555556,1,3,3,6
2019-06-03 18:04:01,0.05233796296296296,1,1,1,2
2019-06-04 11:52:49,0.8133101851851852,1,10,10,20
2019-06-03 15:46:52,0.02351851851851852,1,5,5,10
2019-06-03 15:14:18,0.036284722222222225,1,7,7,14
2019-06-03 12:12:09,0.043645833333333335,1,1,156,157
2019-06-03 12:12:35,0.044305555555555556,1,5,5,10
2019-06-03 22:00:36,0.4529398148148148,6,380,273,653
2019-06-03 21:59:55,0.4527777777777778,3,33,15,48
2019-06-02 16:04:42,0.02290509259259259,1,1,0,1
2019-06-02 16:08:26,0.12619212962962964,1,1,1,2
2019-06-02 16:22:39,0.16258101851851853,1,5,5,10
2019-06-01 18:08:49,0.014224537037037037,1,410,289,699
2019-06-01 17:46:12,0.02423611111111111,1,169,187,356
2019-06-01 18:09:54,0.029722222222222223,1,12,12,24
2019-06-01 17:24:55,0.010486111111111111,1,5,5,10
2019-06-02 08:05:54,1.1369907407407407,2,96,59,155
2019-06-01 04:59:21,0.2677777777777778,1,0,1,1
2019-05-31 15:33:09,0.03508101851851852,1,2,2,4
2019-06-01 06:08:17,0.7432638888888888,1,0,1,1
2019-05-31 12:33:39,0.029513888888888888,1,27,62,89
2019-05-31 11:51:17,0.018171296296296297,1,5,5,10
2019-05-31 11:52:06,0.019085648148148147,1,5,5,10
2019-05-31 11:48:59,0.017708333333333333,1,20,8,28
2019-05-31 11:44:01,0.021655092592592594,1,1,1,2
2019-05-30 19:35:30,0.02162037037037037,1,3,3,6
2019-05-30 22:28:05,0.15488425925925925,1,1,1,2
2019-05-30 16:27:19,0.017280092592592593,1,1,10,11
2019-05-30 14:17:55,0.01542824074074074,1,4,4,8
2019-05-30 14:50:34,0.021423611111111112,1,1,1,2
2019-05-30 12:39:53,0.04125,1,5,5,10
2019-05-30 14:55:26,0.024074074074074074,1,8,17,25
2019-05-30 11:38:27,0.04116898148148148,1,165,75,240
2019-05-30 11:37:10,0.040740740740740744,1,11,11,22
2019-05-30 00:37:14,0.05075231481481481,1,4,4,8
2019-05-30 03:58:23,0.044375,1,6,6,12
2019-05-29 13:53:21,0.03045138888888889,1,148,120,268
2019-05-31 03:04:12,0.5301967592592592,1,5,5,10
2019-05-29 13:30:53,0.027511574074074074,1,5,5,10
2019-05-29 08:57:09,0.05028935185185185,1,2,0,2
2019-05-29 09:03:57,0.08752314814814814,1,1,0,1
2019-05-29 09:16:07,0.09875,1,1,1,2
2019-05-29 14:17:02,0.030381944444444444,1,5,5,10
2019-05-29 09:12:54,0.13087962962962962,1,7,7,14
2019-05-29 09:20:37,0.13658564814814814,1,35,34,69
2019-05-29 09:19:17,0.1360300925925926,1,5,5,10
2019-05-29 10:03:32,0.02820601851851852,1,36,11,47
2019-05-29 06:00:52,0.1515162037037037,1,10,0,10
2019-05-29 02:10:01,1.481076388888889,1,111,46,157
2019-05-29 00:52:41,2.385775462962963,1,1,0,1
2019-05-29 14:33:16,1.1873726851851851,1,12,6,18
2019-05-29 09:23:00,0.2989583333333333,1,4,4,8
2019-05-29 02:10:26,0.610625,1,11,14,25
2019-05-28 11:26:37,0.2131597222222222,1,1,1,2
2019-05-28 12:31:52,0.2604976851851852,1,1,1,2
2019-05-28 03:42:05,0.037766203703703705,1,1,1,2
2019-05-27 22:26:08,0.07962962962962963,1,3,2,5
2019-05-28 01:21:31,0.21363425925925925,1,2,0,2
2019-05-27 19:57:50,0.17012731481481483,3,24,7,31
2019-05-27 19:56:30,0.1552662037037037,1,1,1,2
2019-05-29 02:21:23,1.8172916666666667,1,5,5,10
2019-05-29 14:33:36,2.726585648148148,1,2,2,4
2019-05-30 11:30:39,3.6046064814814813,1,19,2,21
2019-05-27 19:58:42,0.9594444444444444,1,40,47,87
2019-05-27 01:33:40,0.2408449074074074,1,16,41,57
2019-05-26 10:26:40,0.011168981481481481,1,4,2,6
2019-05-26 10:22:34,449.31091435185186,181,137575,61055,198630
2019-05-26 11:48:17,0.3677314814814815,3,29,7,36
2019-05-26 11:48:46,0.42408564814814814,1,12,1,13
2019-06-16 19:46:37,21.81627314814815,1,41,0,41
2019-05-26 00:55:38,0.04886574074074074,2,86,24,110
2019-05-25 20:34:40,0.033935185185185186,1,2,0,2
2019-05-25 21:20:29,0.19105324074074073,1,1,1,2
2019-05-25 21:20:19,0.25385416666666666,1,3,3,6
2019-05-26 20:26:46,1.7653935185185186,1,0,2,2
2019-05-25 21:19:40,1.0004629629629629,1,1,1,2
2019-05-25 19:27:01,1.735613425925926,5,401,108,509
2019-05-24 13:57:32,4.965775462962963,2,35,2,37
2019-05-24 13:21:43,6.862523148148148,2,44,12,56
2019-05-26 21:13:30,2.507349537037037,3,12,14,26
2019-05-23 18:00:40,0.015590277777777778,1,5,1,6
2019-05-23 13:00:55,0.005706018518518518,1,2,0,2
2019-05-23 13:22:40,0.10586805555555556,2,14,17,31
2019-05-23 13:00:31,0.12702546296296297,1,1,1,2
2019-05-23 18:01:11,0.7513194444444444,1,56,14,70
2019-05-22 23:35:23,1.2613425925925925,5,297,119,416
2019-05-22 16:19:16,0.1887037037037037,1,11,28,39
2019-05-22 13:31:05,0.013020833333333334,1,8,8,16
2019-05-22 13:09:11,0.30846064814814816,1,3,3,6
2019-05-22 16:00:35,0.49594907407407407,1,1,0,1
2019-05-22 01:00:58,0.09416666666666666,2,864,813,1677
2019-05-21 11:29:07,0.13681712962962964,1,2,2,4
2019-05-21 11:28:50,1.462986111111111,6,103,29,132
2019-05-21 06:41:16,0.034837962962962966,1,3,3,6
2019-05-20 06:18:29,0.018090277777777778,1,1,5,6
2019-05-20 06:19:56,0.01949074074074074,1,1,1,2
2019-05-19 19:40:37,0.03680555555555556,1,7,3,10
2019-05-19 20:51:45,0.09342592592592593,4,5,5,10
2019-05-20 06:42:20,0.5321759259259259,7,22,22,44
2019-05-19 17:27:32,0.04165509259259259,2,5,5,10
2019-05-19 16:41:42,0.034826388888888886,1,1,1,2
2019-05-19 13:42:10,0.04138888888888889,1,16,16,32
2019-05-19 11:49:32,0.02396990740740741,1,24,1,25
2019-05-19 05:39:17,0.022708333333333334,1,2,2,4
2019-05-18 18:57:46,0.08412037037037037,1,2,0,2
2019-05-18 12:40:55,0.07260416666666666,1,1,3,4
2019-05-17 22:28:52,0.037870370370370374,1,13,3,16
2019-05-17 06:23:21,0.027731481481481482,1,3,3,6
2019-05-17 04:32:47,0.8076388888888889,2,4,4,8
2019-05-16 06:00:25,0.011666666666666667,1,9,9,18
2019-05-16 07:13:53,0.01605324074074074,1,8,4,12
2019-05-15 04:53:24,0.037002314814814814,1,10,0,10
2019-05-15 04:54:07,0.7141435185185185,1,5,14,19
2019-05-14 10:55:48,0.041354166666666664,1,16,13,29
2019-05-14 06:00:59,0.01070601851851852,1,6,6,12
2019-05-14 06:01:48,1.0129513888888888,1,3,3,6
2019-05-14 06:01:23,1.0137037037037038,1,1,1,2
2019-05-15 05:52:12,2.279074074074074,1,1,1,2
2019-05-12 03:15:43,0.16797453703703705,2,2,1,3
2019-05-11 21:56:08,0.08839120370370371,1,1,1,2
2019-05-11 04:46:02,0.38505787037037037,1,1,1,2
2019-05-10 15:59:58,0.16686342592592593,2,42,8,50
2019-05-10 16:09:47,0.27912037037037035,5,11,3,14
2019-05-10 16:09:35,0.28228009259259257,3,4,2,6
2019-05-09 21:16:05,0.593125,2,13,10,23
2019-05-09 20:03:03,0.9675115740740741,3,41,33,74
2019-05-09 21:15:40,2.048703703703704,3,118,43,161
2019-05-09 21:16:24,2.1113541666666666,4,18,14,32
2019-05-07 05:47:46,0.012129629629629629,1,1,1,2
2019-05-09 20:03:21,2.642662037037037,2,7,2,9
2019-05-09 20:03:33,3.1207986111111112,1,6,3,9
2019-05-06 15:55:38,528.3812037037037,32,13432,5048,18480
2019-05-06 06:12:55,0.015694444444444445,1,3,3,6
2019-05-08 16:01:34,2.5191898148148146,1,19,0,19
2019-05-06 03:33:56,1.3960532407407407,1,2,1,3
2019-05-07 21:53:59,2.1807523148148147,2,8,0,8
2019-05-05 19:33:25,0.08760416666666666,2,2,1,3
2019-05-05 19:34:33,0.49528935185185186,2,36,24,60
2019-05-05 08:25:35,0.009421296296296296,1,3,2,5
2019-05-05 06:33:34,0.6560300925925926,2,4,1,5
2019-05-05 15:14:16,0.46273148148148147,1,13,1,14
2019-05-04 23:07:16,0.04699074074074074,1,0,1,1
2019-05-09 20:03:45,4.925092592592593,1,9,1,10
2019-05-04 20:52:55,0.009988425925925927,1,1,1,2
2019-05-04 15:39:54,0.07225694444444444,1,6,2,8
2019-05-04 15:39:18,0.13416666666666666,1,1,1,2
2019-05-04 15:36:44,0.1308449074074074,2,4,3,7
2019-05-04 11:09:26,0.012835648148148148,1,1,0,1
2019-05-03 23:02:58,0.005162037037037037,1,23,0,23
2019-05-03 22:31:06,0.016122685185185184,1,40,1,41
2019-05-18 12:41:17,14.710983796296297,1,10,8,18
2019-05-03 18:49:28,0.016793981481481483,1,6,1,7
2019-05-03 21:44:45,0.141875,2,6,2,8
2019-05-03 18:44:21,0.02318287037037037,1,5,0,5
2019-05-03 08:29:54,0.03013888888888889,1,6,6,12
2019-05-03 06:01:38,0.011284722222222222,1,1,1,2
2019-05-03 14:16:31,0.44721064814814815,2,119,12,131
2019-05-03 02:02:56,0.14413194444444444,1,1,2,3
2019-05-03 02:34:55,0.03820601851851852,2,19,35,54
2019-05-11 04:46:44,8.588125,3,20,12,32
2019-05-02 06:34:33,0.3148958333333333,1,172,117,289
2019-05-01 22:10:20,0.06180555555555556,1,1,0,1
2019-05-03 18:36:37,2.188449074074074,3,86,13,99
2019-05-01 13:19:56,0.011481481481481481,1,3,3,6
2019-05-14 17:05:03,13.318113425925926,14,335,224,559
2019-05-01 06:49:17,0.0421412037037037,1,1,1,2
2019-05-02 02:30:13,1.2083796296296296,4,88,4,92
2019-05-03 18:39:19,3.3745023148148148,1,11,0,11
2019-04-30 16:05:23,0.4391087962962963,1,4,6,10
2019-04-30 16:06:10,1.430763888888889,1,2,2,4
2019-05-25 21:20:52,27.424085648148147,2,75,12,87
2019-04-28 03:51:20,0.012199074074074074,1,2,2,4
2019-04-27 21:55:17,0.014004629629629629,1,1,1,2
2019-04-26 16:07:37,0.3808912037037037,1,4,3,7
2019-04-30 16:05:49,5.436469907407408,1,3,3,6
2019-04-25 11:36:57,0.25016203703703704,1,2,2,4
2019-04-25 00:47:34,0.3525115740740741,1,1,0,1
2019-04-25 00:48:55,0.36787037037037035,1,3,1,4
2019-04-27 01:24:10,4.247488425925926,9,273,87,360
2019-04-23 14:39:07,0.37497685185185187,1,1,1,2
2019-04-23 09:53:53,0.17730324074074075,1,3,3,6
2019-04-23 02:39:49,0.16321759259259258,1,1,0,1
2019-04-23 02:39:22,0.1678125,1,1,1,2
2019-04-25 00:49:07,2.1010648148148148,1,1,1,2
2019-04-25 00:49:26,2.2155092592592593,1,9,1,10
2019-04-23 01:02:58,0.08774305555555556,1,1,1,2
2019-04-22 13:03:20,0.31657407407407406,1,4,4,8
2019-04-22 12:54:20,0.31070601851851853,1,5,5,10
2019-04-21 20:30:05,0.03508101851851852,1,2,2,4
2019-05-03 21:45:38,12.115405092592592,3,6,4,10
2019-04-22 12:55:25,0.7591435185185185,1,20,26,46
2019-04-21 16:44:52,0.03025462962962963,2,4,4,8
2019-04-22 12:55:51,3.017048611111111,1,6,1,7
2019-04-21 02:48:20,1.6000925925925926,1,1,1,2
2019-04-22 12:56:15,3.2037037037037037,1,18,2,20
2019-04-22 22:54:52,0.41497685185185185,1,3,3,6
2019-04-21 02:46:09,2.247326388888889,4,31,4,35
2019-04-21 02:41:35,2.617349537037037,3,8,4,12
2019-05-03 14:16:11,15.35704861111111,2,6,4,10
2019-04-22 13:03:00,4.307337962962963,1,4,4,8
2019-04-18 06:08:59,0.5278472222222222,1,7,4,11
2019-04-21 02:42:03,3.4326273148148148,1,4,4,8
2019-05-03 04:20:36,17.403136574074075,1,51,22,73
2019-04-21 02:49:45,3.8806018518518517,1,1,1,2
2019-04-21 02:48:47,4.012962962962963,1,1,1,2
2019-04-16 12:59:55,0.032476851851851854,3,10,8,18
2019-04-21 02:49:05,4.878506944444444,1,3,3,6
2019-04-15 23:23:08,0.2587847222222222,1,4,8,12
2019-04-15 22:16:12,0.36605324074074075,8,63,63,126
2019-04-15 13:18:51,0.015729166666666666,1,1,1,2
2019-04-15 13:18:28,0.04297453703703704,1,1,0,1
2019-04-16 13:00:57,1.0787268518518518,1,1,1,2
2019-04-15 10:51:11,0.20587962962962963,1,1,1,2
2019-04-16 13:00:16,1.2958912037037038,1,1,1,2
2019-05-09 20:05:44,26.010358796296295,3,74,5,79
2019-04-21 02:52:20,7.493888888888889,1,386,1,387
2019-04-21 02:53:25,8.245960648148149,1,1,1,2
2019-04-13 12:23:42,0.7009953703703704,1,20,3,23
2019-04-13 12:23:53,0.8229861111111111,5,41,34,75
2019-04-13 12:24:01,0.8422453703703704,2,4,4,8
2019-04-21 02:53:46,512.8382407407407,29,11792,4525,16317
2019-05-09 20:10:28,28.210671296296297,5,331,27,358
2019-04-22 22:54:27,11.514027777777779,1,2,2,4
2019-04-13 12:24:20,2.2771064814814816,1,2,2,4
2019-04-10 21:32:09,0.0033449074074074076,1,2,2,4
2019-04-21 02:47:39,10.286412037037037,2,17,2,19
2019-04-10 20:33:05,0.0887037037037037,5,12,6,18
2019-04-10 18:28:43,0.023055555555555555,1,23,18,41
2019-04-10 16:11:53,0.010729166666666666,1,1,1,2
2019-04-10 16:17:25,13.952731481481482,25,7776,7632,15408
2019-04-10 16:05:12,0.037696759259259256,2,15,6,21
2019-04-10 15:17:17,0.08762731481481481,1,1,0,1
2019-04-10 12:52:09,1.8228125,3,11,1,12
2019-04-10 12:50:40,0.08047453703703704,1,52,52,104
2019-04-10 12:49:41,0.16483796296296296,1,11,0,11
2019-04-10 12:50:15,2.1736921296296297,7,513,386,899
2019-04-10 12:49:07,0.3057523148148148,1,8,0,8
2019-04-10 15:36:45,0.5331481481481481,2,27,15,42
2019-04-10 02:25:10,0.010949074074074075,1,2,1,3
2019-04-10 01:34:17,0.023935185185185184,1,9,6,15
2019-04-10 01:47:11,0.06324074074074074,2,44,125,169
2019-04-09 22:35:49,0.11896990740740741,1,9,2,11
2019-04-09 22:36:01,0.1399537037037037,1,21,4,25
2019-04-09 18:42:02,0.04273148148148148,1,162,162,324
2019-04-09 15:02:13,0.2569560185185185,4,32,4,36
2019-04-09 14:06:31,0.27090277777777777,3,126,63,189
2019-04-09 08:23:19,0.10504629629629629,1,1,1,2
2019-04-09 08:23:53,0.10674768518518518,1,4,4,8
2019-04-09 05:19:53,0.028425925925925927,1,2,2,4
2019-04-09 03:02:48,0.0985763888888889,1,54,6,60
2019-04-10 18:43:08,1.8702430555555556,9,1152,641,1793
2019-04-08 22:39:50,0.18564814814814815,3,4,2,6
2019-04-08 17:01:42,0.38373842592592594,3,4,0,4
2019-04-08 16:35:42,0.06939814814814815,1,6,4,10
2019-04-08 12:11:40,0.9762615740740741,1,3,1,4
2019-04-08 12:14:09,0.14862268518518518,3,9,0,9
2019-04-08 12:12:07,0.18263888888888888,1,3,0,3
2019-08-18 18:54:37,135.2624189814815,3,29123,19688,48811
2019-04-09 03:04:12,0.8683217592592593,1,10,3,13
2019-04-13 12:24:45,5.269768518518519,1,2,2,4
2019-04-08 03:35:37,0.042569444444444444,1,6,0,6
2019-04-08 00:22:09,6.629756944444445,2,27,27,54
2019-04-07 12:32:28,0.046550925925925926,2,5,2,7
2019-04-08 05:28:27,0.7663194444444444,4,112,17,129
2019-04-08 00:16:15,0.7810532407407408,2,41,34,75
2019-04-07 02:59:14,0.17337962962962963,3,107,148,255
2019-04-07 02:26:44,0.15269675925925927,1,4,0,4
2019-04-07 00:34:52,0.2798263888888889,1,9,4,13
2019-04-06 18:13:04,0.018773148148148146,1,8,8,16
2019-04-08 05:55:39,1.5278819444444445,1,1,1,2
2019-04-06 14:26:51,0.03214120370370371,2,10,10,20
2019-04-08 05:46:56,2.1512962962962963,5,185,28,213
2019-04-06 02:47:27,0.11761574074074074,1,9,1,10
2019-04-06 02:47:17,0.14439814814814814,1,6,0,6
2019-04-06 02:47:05,0.1501736111111111,1,31,0,31
2019-04-05 17:51:14,0.02625,1,75,2,77
2019-04-05 13:16:29,0.025277777777777777,3,32,32,64
2019-04-06 02:41:20,0.8748842592592593,1,4,4,8
2019-04-04 21:12:09,1.2146180555555555,7,89,25,114
2019-04-06 03:02:04,1.8549537037037036,2,2,2,4
2019-04-04 14:22:56,0.3746990740740741,1,0,2,2
2019-04-06 15:53:46,2.4683912037037037,1,130,3,133
2019-04-03 23:30:45,0.2850810185185185,1,33,5,38
2019-04-03 16:16:55,0.04711805555555556,1,30,33,63
2019-08-19 09:40:43,137.80074074074074,1,17,1,18
2019-04-03 23:31:09,0.402337962962963,1,76,0,76
2019-04-03 15:54:55,0.08688657407407407,1,8,0,8
2019-04-03 09:19:11,0.03193287037037037,3,93,30,123
2019-04-04 14:46:28,1.3685532407407408,3,14,1,15
2019-04-02 22:24:40,0.11177083333333333,1,142,31,173
2019-04-04 01:25:21,495.77684027777775,25,9171,3378,12549
2019-04-02 16:31:37,494.40619212962963,21,8506,3177,11683
2019-04-02 15:10:28,0.010358796296296297,1,15,14,29
2019-04-02 05:38:17,0.011238425925925926,1,3,3,6
2019-04-02 05:34:38,0.00900462962962963,1,1,1,2
2019-04-06 15:53:18,4.850416666666667,2,6,12,18
2019-04-01 19:24:29,0.007395833333333333,1,1,1,2
2019-04-01 17:10:44,0.3107175925925926,1,2,0,2
2019-04-01 18:06:14,0.3772800925925926,12,152,78,230
2019-04-01 17:17:22,0.5841550925925926,1,1,5,6
2019-03-31 15:27:25,0.17059027777777777,1,4,1,5
2019-04-01 05:30:47,1.1087615740740742,5,13,5,18
2019-03-31 03:03:57,0.0096875,1,3,0,3
2019-03-30 17:15:24,0.19631944444444444,1,2,0,2
2019-04-01 03:50:05,1.9619097222222222,4,121,62,183
2019-03-30 06:47:26,0.007974537037037037,1,0,52,52
2019-03-30 02:14:32,0.03958333333333333,1,1,0,1
2019-03-30 00:13:20,0.24800925925925926,1,2,0,2
2019-03-29 23:43:39,0.24393518518518517,1,1,0,1
2019-03-29 23:43:29,0.24489583333333334,1,34,20,54
2019-03-29 15:59:48,0.04247685185185185,1,8,3,11
2019-03-29 13:06:16,0.6450578703703703,4,35,6,41
2019-03-29 13:04:56,0.21547453703703703,1,1,1,2
2019-03-29 13:14:24,0.19686342592592593,2,8,1,9
2019-03-29 13:06:57,0.32011574074074073,1,3,3,6
2019-03-30 01:12:07,1.0125231481481483,2,93,4,97
2019-03-30 00:41:35,1.0738310185185185,1,24,82,106
2019-03-28 17:33:27,0.031655092592592596,1,6,2,8
2019-03-28 17:01:29,0.06346064814814815,1,5,3,8
2019-03-28 07:25:12,0.05625,1,38,38,76
2019-03-28 07:25:28,0.06059027777777778,1,5,5,10
2019-03-28 01:16:02,0.024837962962962964,1,15,5,20
2019-03-28 01:16:11,0.04598379629629629,1,26,0,26
2019-03-28 03:45:00,0.16224537037037037,1,45,43,88
2019-03-27 23:30:47,0.24828703703703703,2,517,1654,2171
2019-03-27 18:58:25,0.06644675925925926,1,4,0,4
2019-03-27 16:07:36,0.04962962962962963,1,6,6,12
2019-03-27 16:45:32,0.024965277777777777,1,3,3,6
2019-03-27 16:44:49,0.024247685185185185,1,2,2,4
2019-03-28 01:20:54,0.024872685185185185,1,8,8,16
2019-03-27 16:08:26,0.5479513888888888,1,1,1,2
2019-03-26 22:05:21,0.06898148148148148,2,7,3,10
2019-03-26 16:33:07,0.027800925925925927,1,1,1,2
2019-03-26 10:13:21,0.14842592592592593,1,6,2,8
2019-03-26 11:53:11,0.25136574074074075,1,1,1,2
2019-03-26 09:37:04,0.1573263888888889,1,3,3,6
2019-03-26 09:36:18,0.1671875,1,1,1,2
2019-03-26 04:31:10,0.032824074074074075,1,9,0,9
2019-03-27 14:55:23,1.4877662037037036,1,235,61,296
2019-03-26 00:24:00,0.01457175925925926,1,6,4,10
2019-03-28 17:01:09,8.11107638888889,1,214,25,239
2019-03-25 23:36:35,0.08478009259259259,1,6,2,8
2019-03-26 00:24:10,0.11493055555555555,1,10,2,12
2019-03-25 14:01:09,0.23126157407407408,1,1,0,1
2019-03-25 19:54:01,0.5836921296296296,1,4,4,8
2019-03-25 14:27:46,0.3575231481481482,1,1,1,2
2019-03-28 16:56:26,3.4952430555555556,1,74,1,75
2019-03-26 00:24:20,0.8444560185185185,1,43,72,115
2019-03-24 17:45:00,6.974479166666667,250,52954,50678,103632
2019-03-26 16:34:03,2.058726851851852,1,44,6,50
2019-03-24 18:15:59,0.16429398148148147,1,5,4,9
2019-03-24 04:00:03,0.006388888888888889,1,1,1,2
2019-03-24 11:36:26,0.3673958333333333,1,1,1,2
2019-03-26 16:33:26,2.7571064814814816,2,9,5,14
2019-07-01 22:34:39,100.20265046296296,13,705,240,945
2019-03-23 13:07:17,0.3924768518518518,1,2,2,4
2019-03-23 13:07:47,0.618912037037037,1,1,1,2
2019-03-23 01:23:49,0.1391087962962963,1,9,3,12
2019-03-23 13:07:05,0.6351388888888889,3,141,111,252
2019-03-23 01:24:01,0.20907407407407408,1,55,11,66
2019-03-22 13:42:59,0.3374652777777778,1,8,8,16
2019-03-22 13:43:23,0.3380902777777778,1,1,1,2
2019-03-30 01:13:43,7.940787037037037,1,262,86,348
2019-03-21 22:33:19,0.0084375,1,5,1,6
2019-03-21 22:33:29,0.06800925925925926,1,4,3,7
2019-03-25 23:36:25,5.875231481481482,2,356,461,817
2019-04-03 16:17:43,13.075590277777778,3,128,20,148
2019-03-21 13:24:10,0.025092592592592593,1,2,5,7
2019-03-21 10:02:48,0.17431712962962964,1,1,1,2
2019-03-21 10:03:03,0.17474537037037038,1,1,1,2
2019-03-21 10:02:22,0.1749537037037037,1,3,3,6
2019-03-21 03:06:42,0.11400462962962964,1,1,1,2
2019-03-20 16:20:17,0.03153935185185185,1,15,5,20
2019-03-20 16:29:13,1.0349189814814814,4,35,7,42
2019-03-19 15:33:31,0.07898148148148149,1,2,2,4
2019-03-19 15:34:22,0.40697916666666667,1,7,9,16
2019-03-19 15:34:05,0.4070486111111111,1,6,8,14
2019-03-23 15:11:59,5.382291666666666,1,2,2,4
2019-03-18 10:32:28,0.20697916666666666,1,1,1,2
2019-03-18 10:32:10,0.20703703703703705,1,1,1,2
2019-03-18 13:41:44,0.3468865740740741,1,3,3,6
2019-03-18 02:53:18,0.0553125,1,26,12,38
2019-03-17 14:34:57,0.06221064814814815,1,52,6,58
2019-03-17 13:54:10,0.11693287037037037,2,23,1,24
2019-03-17 07:39:31,0.02869212962962963,1,1,1,2
2019-03-17 02:12:47,0.053599537037037036,1,33,31,64
2019-03-18 20:00:55,81.02435185185185,42,5245,1894,7139
2019-03-17 02:13:30,0.20797453703703703,1,2,0,2
2019-03-18 20:55:22,2.0745138888888888,1,6,0,6
2019-03-16 19:43:15,10.37701388888889,157,51992,49407,101399
2019-03-17 21:36:55,1.163900462962963,1,24,0,24
2019-03-16 19:10:42,0.053148148148148146,1,7,2,9
2019-03-19 22:47:11,3.291678240740741,1,1,1,2
2019-03-16 10:23:55,0.19586805555555556,2,1,6,7
2019-03-16 10:24:27,0.2433912037037037,1,0,3,3
2019-03-16 03:02:31,0.022060185185185186,1,1,13,14
2019-05-09 20:39:27,54.85850694444444,1,11,9,20
2019-03-19 04:48:18,3.5060185185185184,1,17,15,32
2019-03-16 19:13:16,1.631712962962963,5,86,28,114
2019-03-16 19:18:47,1.2794444444444444,2,72,56,128
2019-03-15 13:53:35,0.34649305555555554,1,16,13,29
2019-03-15 13:53:25,0.34672453703703704,1,1,1,2
2019-03-15 14:05:31,8.34710648148148,1,1694,1690,3384
2019-03-15 04:07:10,0.031041666666666665,1,26,9,35
2019-03-15 04:35:45,121.4361574074074,8,340,160,500
2019-03-15 04:35:18,0.12475694444444445,1,11,10,21
2019-03-14 19:59:27,0.014039351851851851,1,43,1,44
2019-03-14 19:10:44,0.07039351851851852,2,16,14,30
2019-03-16 10:23:22,1.7123842592592593,1,264,660,924
2019-03-14 13:04:08,0.037037037037037035,1,1,1,2
2019-03-14 13:20:23,0.050034722222222223,1,2,2,4
2019-03-15 12:36:39,1.3428472222222223,1,14,10,24
2019-03-18 17:34:57,4.571666666666666,1,0,23,23
2019-03-14 04:25:50,0.02795138888888889,1,46,25,71
2019-03-13 23:25:54,0.0121875,1,39,39,78
2019-03-13 18:29:55,0.10655092592592592,4,25,3,28
2019-03-13 13:56:42,0.45815972222222223,2,117,33,150
2019-03-13 12:01:58,0.028055555555555556,1,1,1,2
2019-03-13 05:57:03,0.014004629629629629,1,1,1,2
2019-03-14 04:28:31,6.08130787037037,1,282,249,531
2019-03-13 12:02:14,0.6360185185185185,1,24,4,28
2019-03-12 21:08:19,0.021122685185185185,1,12,0,12
2019-03-12 21:34:56,0.04537037037037037,1,3,3,6
2019-03-12 21:59:00,0.16011574074074075,5,62,54,116
2019-03-12 20:53:57,0.12019675925925925,1,7,3,10
2019-03-12 12:05:21,0.24010416666666667,1,1,1,2
2019-03-11 19:47:50,0.18434027777777778,1,4,2,6
2019-03-11 19:48:24,0.2876851851851852,2,16,6,22
2019-03-11 12:27:58,0.016898148148148148,1,1,1,2
2019-03-11 12:29:54,0.29002314814814817,1,1,1,2
2019-03-11 14:29:07,0.38230324074074074,1,5,5,10
2019-03-11 12:31:17,0.3017476851851852,1,1,1,2
2019-03-10 23:50:31,0.16050925925925927,1,16,2,18
2019-03-12 16:34:00,16.759340277777778,1,516,1619,2135
2019-03-10 23:51:23,0.34097222222222223,1,6,3,9
2019-03-10 15:18:59,0.038252314814814815,2,60,1,61
2019-03-10 15:00:23,0.13773148148148148,1,12,1,13
2019-03-10 15:00:55,1.0208217592592592,3,9,13,22
2019-03-09 16:07:59,0.11305555555555556,1,2,2,4
2019-03-08 18:59:09,0.03877314814814815,1,1,0,1
2019-03-08 10:16:56,0.19056712962962963,1,1,1,2
2019-03-14 01:13:43,6.012650462962963,1,155,120,275
2019-03-07 23:54:51,0.1099537037037037,2,26,1,27
2019-03-07 21:18:06,0.024537037037037038,1,1,1,2
2019-03-08 15:12:48,0.9028935185185185,1,17,15,32
2019-03-08 13:36:29,0.8921759259259259,2,8,0,8
2019-03-10 23:49:31,3.369340277777778,14,266,72,338
2019-03-07 14:52:39,0.023310185185185184,1,11,6,17
2019-03-07 11:38:11,0.24645833333333333,1,1,1,2
2019-03-07 00:49:43,0.02224537037037037,1,1,1,2
2019-03-07 00:50:38,0.07953703703703703,1,1,1,2
2019-03-07 00:50:07,0.11386574074074074,1,20,2,22
2019-03-07 01:52:43,0.23030092592592594,1,23,14,37
2019-03-06 18:53:57,0.16212962962962962,2,12,1,13
2019-03-06 14:09:18,0.05351851851851852,1,7,0,7
2019-03-06 14:10:33,0.013530092592592592,1,2,0,2
2019-03-06 05:58:14,0.01431712962962963,1,3,3,6
2019-03-06 04:35:53,0.010763888888888889,3,19,8,27
2019-03-06 03:54:33,0.028923611111111112,1,4,0,4
2019-03-07 21:53:48,1.783900462962963,2,15,25,40
2019-03-06 03:54:13,0.04259259259259259,1,20,20,40
2019-03-06 02:57:47,0.016979166666666667,1,14,3,17
2019-03-06 03:53:38,0.493275462962963,5,435,20,455
2019-03-05 22:58:58,0.008981481481481481,1,1,1,2
2019-03-05 21:13:04,0.0011921296296296296,1,2,2,4
2019-03-05 21:42:37,0.0430787037037037,3,6,6,12
2019-03-05 20:52:41,10.183831018518518,108,32908,28313,61221
2019-03-05 17:22:47,0.008993055555555556,1,15,1,16
2019-03-05 14:19:55,0.011215277777777777,1,2,1,3
2019-03-05 14:21:14,0.17287037037037037,2,18,4,22
2019-03-05 04:09:02,0.000462962962962963,1,1,1,2
2019-03-05 14:21:32,0.44829861111111113,1,1,0,1
2019-03-05 03:10:02,0.0010763888888888889,1,1,0,1
2019-03-05 02:45:57,0.14208333333333334,1,7,0,7
2019-03-05 02:46:25,0.14429398148148148,1,3,2,5
2019-03-05 02:46:37,0.14984953703703704,1,14,0,14
2019-03-05 02:51:19,0.17034722222222223,7,54,21,75
2019-03-04 21:46:39,0.06834490740740741,1,2,2,4
2019-03-04 21:47:48,0.07945601851851852,1,1,1,2
2019-03-05 20:09:18,1.0244560185185185,3,8,4,12
2019-03-04 21:51:24,0.24699074074074073,3,40,10,50
2019-03-04 21:52:42,0.30190972222222223,1,2,1,3
2019-03-04 17:03:13,0.11981481481481482,1,34,2,36
2019-03-04 00:53:59,0.006898148148148148,1,2,2,4
2019-03-04 00:54:15,0.025798611111111112,3,17,8,25
2019-03-04 00:06:20,0.003460648148148148,1,4,0,4
2019-03-03 23:52:19,0.0001388888888888889,1,1,1,2
2019-03-03 23:50:57,0.00015046296296296297,1,1,1,2
2019-03-03 23:44:35,0.0006018518518518519,1,2,2,4
2019-03-04 00:13:43,0.02488425925925926,1,42,3,45
2019-03-03 23:39:06,0.01721064814814815,3,4,4,8
2019-03-03 23:40:21,0.03246527777777778,1,1,1,2
2019-03-03 22:44:53,0.005162037037037037,1,1,1,2
2019-03-03 22:45:03,0.00800925925925926,1,9,4,13
2019-03-03 22:41:31,0.00730324074074074,1,1,1,2
2019-03-03 14:38:48,0.026875,1,1,1,2
2019-03-01 06:08:38,0.030613425925925926,1,1,1,2
2019-03-07 21:17:53,6.829467592592593,1,28,7,35
2019-03-01 10:11:36,0.357974537037037,1,3,1,4
2019-02-28 20:35:17,0.04506944444444445,1,6,4,10
2019-02-28 17:16:35,0.08684027777777778,1,67,3,70
2019-02-27 18:13:17,0.07777777777777778,1,8,5,13
2019-02-27 13:57:15,0.03375,1,1,1,2
2019-02-27 13:58:09,0.3426273148148148,1,1,1,2
2019-02-26 14:23:25,0.17753472222222222,1,3,3,6
2019-02-26 11:16:49,0.21976851851851853,1,3,3,6
2019-02-27 14:02:58,1.3401273148148147,1,3,3,6
2019-02-26 10:46:13,0.20368055555555556,1,1,1,2
2019-02-25 14:54:17,0.053877314814814815,1,1,0,1
2019-02-25 14:55:53,0.3580324074074074,1,6,6,12
2019-02-25 14:55:23,0.3658912037037037,1,2,2,4
2019-02-25 14:56:35,0.3669212962962963,1,5,3,8
2019-03-03 21:18:24,6.731643518518519,9,1106,87,1193
2019-02-25 03:06:25,0.025300925925925925,1,1,1,2
2019-03-15 01:39:20,18.09638888888889,1,43,0,43
2019-02-25 00:10:57,0.05171296296296296,1,1,0,1
2019-02-28 14:22:22,4.14712962962963,11,387,61,448
2019-02-23 21:20:36,0.0865625,1,4,0,4
2019-02-23 17:41:28,11.432384259259258,147,39703,31502,71205
2019-02-23 21:20:21,0.2079513888888889,1,18,1,19
2019-02-24 15:32:41,1.0545717592592592,1,121,84,205
2019-02-22 11:06:02,0.21011574074074074,1,5,5,10
2019-02-24 13:28:37,2.953564814814815,2,10,8,18
2019-02-21 18:36:49,0.1987847222222222,1,4,0,4
2019-02-26 14:21:37,5.694733796296297,5,191,260,451
2019-02-22 15:52:05,1.9036805555555556,1,3,0,3
2019-05-09 20:41:28,78.29486111111112,1,1,0,1
2019-02-20 16:47:39,0.22140046296296295,3,3,3,6
2019-02-20 06:55:51,0.050729166666666665,1,1,1,2
2019-02-20 06:56:13,0.05126157407407408,1,1,1,2
2019-02-19 19:00:41,0.018217592592592594,2,4,3,7
2019-02-19 13:01:22,0.8154282407407407,1,1,1,2
2019-02-27 14:03:29,8.887673611111111,1,1,0,1
2019-02-18 12:37:13,0.049791666666666665,1,3,2,5
2019-02-18 13:59:47,0.11700231481481481,1,6,0,6
2019-02-18 13:59:20,0.15226851851851853,1,25,4,29
2019-02-17 23:10:22,0.07457175925925925,1,0,1,1
2019-02-17 19:24:13,0.019328703703703702,1,82,31,113
2019-02-17 14:16:37,0.45568287037037036,1,32,14,46
2019-03-11 12:45:17,22.60096064814815,1,58,0,58
2019-02-17 02:38:25,0.4351851851851852,1,525,313,838
2019-02-16 13:53:27,0.035,1,1,1,2
2019-02-16 04:23:48,0.18131944444444445,1,5,1,6
2019-02-16 04:27:06,0.21184027777777778,1,6,2,8
2019-02-16 10:56:10,0.4973842592592593,1,16,4,20
2019-02-15 22:33:26,0.11645833333333333,1,26,8,34
2019-02-15 18:43:10,0.034375,1,23,7,30
2019-02-15 14:38:29,0.3692361111111111,1,1,1,2
2019-02-15 15:09:00,0.6645833333333333,1,2,0,2
2019-02-15 15:08:49,0.6710648148148148,1,16,6,22
2019-02-14 16:03:02,0.03259259259259259,1,2,2,4
2019-02-14 05:27:55,0.06950231481481481,1,9,2,11
2019-02-15 17:19:46,1.5811921296296296,2,25,13,38
2019-02-14 14:46:43,0.4809259259259259,1,12,5,17
2019-02-14 02:11:48,0.21592592592592594,3,8,17,25
2019-02-13 20:28:19,0.021354166666666667,1,13,5,18
2019-02-14 00:04:44,0.24976851851851853,3,4,5,9
2019-02-13 17:33:04,0.05084490740740741,1,3,1,4
2019-02-13 17:52:37,0.4445138888888889,1,1,1,2
2019-02-13 17:37:28,0.48086805555555556,1,1,1,2
2019-02-13 17:36:41,0.5245717592592593,1,3,16,19
2019-02-13 17:34:58,0.5499421296296296,1,128,53,181
2019-02-13 04:30:50,0.06545138888888889,1,4,0,4
2019-02-12 21:24:15,0.1478125,1,1,0,1
2019-02-13 01:54:28,0.8084722222222223,1,1,1,2
2019-02-13 01:55:07,0.8229398148148148,1,4,4,8
2019-02-13 01:54:49,0.8243518518518519,1,1,1,2
2019-02-13 01:45:03,0.8179398148148148,1,1,1,2
2019-02-12 14:17:27,0.3407523148148148,1,1,1,2
2019-02-12 04:10:32,0.0868287037037037,1,1,1,2
2019-02-12 04:10:44,0.2763541666666667,1,14,1,15
2019-02-13 17:53:02,1.9103587962962962,3,9,9,18
2019-02-12 13:48:05,1.2817824074074073,2,39,0,39
2019-02-11 12:19:06,0.24506944444444445,1,6,0,6
2019-02-11 06:41:36,21.748344907407407,91,25902,20967,46869
2019-02-12 04:11:07,0.9531944444444445,1,3,3,6
2019-02-13 17:42:48,2.8585069444444446,1,34,3,37
2019-02-11 12:19:59,1.0725462962962964,3,134,12,146
2019-02-10 12:05:00,0.22197916666666667,2,19,1,20
2019-02-13 17:36:23,3.998587962962963,4,87,27,114
2019-02-09 19:13:12,0.06716435185185185,1,55,5,60
2019-02-09 16:33:42,0.1850462962962963,1,1,1,2
2019-02-09 02:39:39,0.4433564814814815,2,9,1,10
2019-02-10 17:17:35,2.460335648148148,1,3,3,6
2019-07-16 04:30:48,158.17799768518518,1,181,70,251
2019-02-11 03:19:50,4.199421296296296,1,43,0,43
2019-02-06 22:36:44,0.07997685185185185,1,1,1,2
2019-02-06 15:46:38,0.389375,1,5,5,10
2019-02-06 01:50:53,0.013900462962962963,1,1,1,2
2019-02-05 14:11:12,0.0857175925925926,1,1,1,2
2019-02-05 14:12:46,0.09226851851851851,1,1,1,2
2019-02-05 14:13:35,0.11121527777777777,1,18,0,18
2019-02-05 14:11:36,0.735462962962963,1,1,1,2
2019-02-04 23:27:19,0.026238425925925925,1,3,3,6
2019-02-04 22:14:58,0.009791666666666667,1,3,0,3
2019-02-04 21:25:43,0.09369212962962963,1,5,0,5
2019-02-05 03:46:19,0.9348263888888889,2,1,1,2
2019-02-05 14:13:20,1.7698032407407407,1,3,4,7
2019-02-05 04:11:52,1.8656712962962962,1,1,1,2
2019-02-02 00:26:50,11.343472222222223,2,10,2,12
2019-02-03 02:59:52,1.3982060185185186,2,149,44,193
2019-02-01 00:18:41,0.00900462962962963,1,12,12,24
2019-01-31 23:13:48,0.009131944444444444,1,6,6,12
2019-01-31 23:07:09,0.008402777777777778,1,3,3,6
2019-02-20 10:57:09,19.63550925925926,1,2,2,4
2019-01-31 12:45:15,0.3490972222222222,1,5,5,10
2019-01-31 23:14:06,0.9637962962962963,3,222,157,379
2019-01-31 23:15:39,1.1600578703703703,1,54,3,57
2019-01-29 19:21:16,0.06538194444444445,3,32,5,37
2019-01-29 19:23:00,0.5613425925925926,1,2,2,4
2019-02-03 02:40:23,4.301226851851852,1,1,1,2
2019-01-28 21:57:43,0.14662037037037037,1,1,1,2
2019-02-05 18:11:25,8.121724537037037,2,942,338,1280
2019-02-03 02:40:41,5.849814814814815,1,3,3,6
2019-01-28 03:17:11,0.007511574074074074,1,5,3,8
2019-01-28 03:24:13,0.02627314814814815,1,15,1,16
2019-01-28 03:18:36,0.18797453703703704,1,1,1,2
2019-01-27 20:18:16,0.04776620370370371,2,9,1,10
2019-01-27 16:54:55,0.2129861111111111,1,79,8,87
2019-02-04 03:46:06,8.329513888888888,1,6,2,8
2019-01-26 22:59:41,0.22378472222222223,1,15,2,17
2019-01-25 11:36:55,0.7487384259259259,1,3,0,3
2019-01-24 14:38:18,0.08444444444444445,1,1,1,2
2019-01-24 12:32:23,1.4697685185185185,1,1,1,2
2019-02-04 03:45:30,12.511585648148149,1,2,2,4
2019-01-22 11:33:21,0.236875,1,1,1,2
2019-01-22 11:32:50,0.23702546296296295,1,2,2,4
2019-02-02 18:18:15,11.987291666666666,2,28,7,35
2019-01-21 19:03:05,0.12721064814814814,2,18,1,19
2019-01-21 19:03:44,0.2934027777777778,1,12,0,12
2019-01-21 12:39:53,0.26686342592592593,1,2,2,4
2019-01-21 12:39:01,0.28064814814814815,1,1,1,2
2019-01-21 12:38:38,0.2806134259259259,1,1,1,2
2019-01-21 12:38:01,0.2804861111111111,1,3,3,6
2019-02-02 11:25:04,12.907569444444444,2,240,240,480
2019-01-27 22:56:07,7.3215972222222225,1,1,1,2
2019-01-20 11:57:06,0.014328703703703703,1,2,0,2
2019-01-20 11:30:26,0.0008564814814814815,1,1,1,2
2019-01-20 11:37:59,0.009247685185185185,1,0,16,16
2019-01-20 11:56:54,0.037766203703703705,1,1,1,2
2019-01-20 11:37:39,0.027777777777777776,2,12,5,17
2019-01-19 22:43:07,1.550185185185185,43,11715,11534,23249
2019-01-19 21:01:01,0.031041666666666665,1,2,0,2
2019-01-19 21:01:13,0.2053587962962963,1,251,0,251
2019-01-19 15:25:21,0.014351851851851852,1,290,244,534
2019-03-15 02:53:39,54.68429398148148,1,12,49,61
2019-01-18 22:52:10,0.0078009259259259256,1,1,0,1
2019-02-02 19:22:06,14.953275462962964,3,47,19,66
2019-01-18 20:31:12,0.01511574074074074,1,1,1,2
2019-01-18 19:58:12,0.059236111111111114,1,11,3,14
2019-03-15 03:36:42,55.396006944444444,1,10,4,14
2019-01-18 19:58:01,0.08434027777777778,1,1,1,2
2019-01-18 14:57:42,0.3874768518518519,1,3,3,6
2019-01-18 14:23:31,0.36407407407407405,1,2,2,4
2019-01-17 23:48:09,2.354386574074074,17,6819,6342,13161
2019-01-18 00:02:51,0.05561342592592593,1,3,1,4
2019-01-18 00:37:00,0.09328703703703704,1,3,0,3
2019-01-18 14:56:22,0.7043518518518519,1,15,3,18
2019-01-17 22:27:51,0.03733796296296296,1,6,0,6
2019-01-17 22:28:31,0.03849537037037037,1,1,1,2
2019-01-18 21:55:02,1.117037037037037,1,25,1,26
2019-01-17 20:32:55,0.08291666666666667,1,8,0,8
2019-01-18 09:25:45,0.6327314814814815,1,46,2,48
2019-01-17 13:06:08,0.014722222222222222,1,63,44,107
2019-01-18 14:56:56,1.1303472222222222,4,57,3,60
2019-01-17 13:21:02,0.2976736111111111,1,1,1,2
2019-01-17 13:21:33,0.2992824074074074,1,5,5,10
2019-01-17 08:22:13,0.2978125,1,1,1,2
2019-01-16 19:36:11,0.08296296296296296,2,9,1,10
2019-01-16 17:36:17,0.012210648148148148,1,2,2,4
2019-01-16 18:47:47,0.1734837962962963,1,392,77,469
2019-01-16 14:47:56,0.17175925925925925,1,2,9,11
2019-01-15 22:11:46,0.07739583333333333,1,1,4,5
2019-01-15 22:12:00,2.667037037037037,1,1,1,2
2019-01-16 14:42:01,0.9829398148148148,2,12,4,16
2019-01-16 18:48:14,1.1569675925925926,3,4,4,8
2019-01-15 14:30:31,6.778935185185185,93,39667,40378,80045
2019-01-18 14:57:20,3.8032523148148147,1,33,0,33
2019-01-14 22:29:22,0.141875,1,3,3,6
2019-01-15 08:24:36,0.8486574074074074,1,123,2,125
2019-01-14 16:29:05,44.80501157407407,1,8,2,10
2019-01-14 16:28:41,0.09811342592592592,2,27,2,29
2019-01-14 16:30:32,0.09232638888888889,1,1,6,7
2019-01-14 09:13:35,0.1254976851851852,1,8,8,16
2019-01-14 09:16:43,0.12805555555555556,1,1,1,2
2019-01-14 09:18:56,0.1300462962962963,1,5,4,9
2019-01-14 09:15:56,0.13082175925925926,1,7,7,14
2019-01-14 15:34:44,0.2615277777777778,1,3,3,6
2019-01-14 15:34:28,0.2608449074074074,1,1,1,2
2019-01-14 07:44:27,0.4580787037037037,5,8,7,15
2019-01-17 15:18:41,4.061770833333333,1,2,2,4
2019-01-11 07:26:25,0.08841435185185186,1,1,1,2
2019-01-11 07:30:20,0.42008101851851853,2,4,0,4
2019-01-13 09:23:55,2.7660069444444444,2,56,34,90
2019-01-11 07:29:18,0.7783796296296296,1,5,2,7
2019-01-11 07:28:09,1.2390972222222223,1,8,0,8
2019-01-10 14:13:30,0.9316666666666666,1,18,10,28
2019-01-10 14:13:00,0.9499768518518519,1,5,5,10
2019-01-11 10:15:44,2.0610300925925924,2,7,5,12
2019-01-11 07:26:04,1.9895833333333333,1,127,0,127
2019-01-11 07:27:05,2.0699768518518518,1,3,2,5
2019-01-08 17:17:57,0.0007986111111111112,1,53,36,89
2019-01-08 17:12:11,0.12365740740740741,1,105,0,105
2019-01-08 16:41:28,0.0009722222222222222,1,1,6,7
2019-01-08 16:31:59,0.0008564814814814815,1,0,1176,1176
2019-01-08 13:32:37,0.014363425925925925,1,3,4,7
2019-01-08 13:09:58,12.034872685185185,139,59072,52951,112023
2019-01-08 13:10:30,0.023773148148148147,1,3,3,6
2019-02-04 03:26:00,26.70221064814815,5,266,36,302
2019-01-10 14:12:32,2.4580671296296295,2,9,11,20
2019-01-08 08:42:57,0.23673611111111112,1,0,2,2
2019-01-08 03:18:47,0.018090277777777778,1,0,10,10
2019-01-08 03:18:28,0.04666666666666667,2,26,2,28
2019-01-07 14:54:41,0.08552083333333334,1,4,0,4
2019-02-13 17:52:02,37.19167824074074,2,89,13,102
2019-01-07 13:50:21,0.08273148148148148,1,2,2,4
2019-01-07 22:59:07,0.49560185185185185,1,22,2,24
2019-01-07 14:36:27,0.18109953703703704,2,31,92,123
2019-01-07 08:47:01,0.010914351851851852,1,1,1,2
2019-01-07 07:17:35,0.0862962962962963,1,2,1,3
2019-01-07 07:23:10,0.09945601851851851,1,2,2,4
2019-01-07 07:14:54,0.13627314814814814,1,1,1,2
2019-01-06 22:53:46,0.14880787037037038,1,9,1,10
2019-01-06 22:52:59,0.15579861111111112,1,3,1,4
2019-01-06 22:54:02,0.16167824074074075,1,1,1,2
2019-01-06 15:38:41,0.08381944444444445,1,1,1,2
2019-01-06 11:03:28,0.02574074074074074,1,10,6,16
2019-01-06 08:21:17,0.010844907407407407,1,1,1,2
2019-01-05 18:13:12,0.011793981481481482,1,2,0,2
2019-01-05 17:29:53,0.008981481481481481,1,1,1,2
2019-01-05 10:27:59,0.03453703703703704,1,2,2,4
2019-01-08 13:10:54,3.89962962962963,1,3,3,6
2019-01-05 06:16:46,0.6177777777777778,1,25,3,28
2019-01-04 12:54:57,0.02903935185185185,1,1,0,1
2019-01-04 11:44:47,0.04608796296296296,1,15,0,15
2019-01-04 10:40:03,0.03320601851851852,1,5,3,8
2019-01-04 11:29:40,0.0708912037037037,1,6,8,14
2019-01-04 10:28:14,0.031226851851851853,1,1,1,2
2019-01-05 11:43:29,1.8908101851851853,1,432,98,530
2019-01-04 10:28:39,0.8288078703703704,1,218,214,432
2019-01-03 06:59:05,0.035625,1,1,1,2
2019-01-03 07:22:02,0.052523148148148145,1,4,4,8
2019-01-03 06:58:05,0.04393518518518519,1,1,1,2
2019-01-03 05:40:17,0.028425925925925927,1,1,5,6
2019-01-03 04:10:21,0.022766203703703705,1,34,0,34
2019-01-03 04:10:03,0.05863425925925926,2,57,11,68
2019-01-02 19:48:22,0.2671875,1,4,4,8
2019-01-02 06:28:53,0.08172453703703704,1,175,195,370
2019-01-02 09:47:33,0.7519560185185186,1,25,30,55
2019-01-01 15:40:18,0.012743055555555556,1,1,1,2
2019-01-02 00:12:03,0.3943287037037037,2,65,7,72
2019-01-01 15:19:52,0.14280092592592591,1,1,1,2
2019-01-02 21:37:50,0.0741087962962963,1,1,1,2
2019-01-02 21:38:19,0.07469907407407407,1,1,1,2
2019-01-02 21:39:41,0.0757638888888889,1,1,1,2
2019-01-02 21:39:24,0.07527777777777778,1,1,1,2
2019-01-02 21:39:03,0.0753125,1,3,3,6
2019-01-01 03:03:55,0.007962962962962963,1,5,1,6
2019-01-01 12:44:05,0.7922800925925926,1,82,4,86
2019-01-01 12:43:11,0.9201041666666666,1,45,0,45
2018-12-31 17:12:07,0.11575231481481481,1,8,10,18
2019-01-09 00:52:02,8.536898148148149,4,80,61,141
2018-12-31 14:29:10,0.2829976851851852,1,0,1,1
2018-12-31 04:08:51,0.18594907407407407,1,1,1,2
2018-12-31 17:11:49,1.4434722222222223,37,2644,3125,5769
2019-01-07 20:45:14,8.136851851851851,4,47,28,75
2018-12-30 17:57:50,0.07311342592592593,1,4,2,6
2018-12-30 17:58:26,0.2093287037037037,1,6,6,12
2018-12-30 17:57:40,0.2786574074074074,1,1,1,2
2019-01-05 06:17:13,5.935347222222222,6,20,16,36
2018-12-30 18:00:04,0.4368402777777778,1,8,44,52
2018-12-30 08:49:00,0.09949074074074074,5,43,37,80
2018-12-29 07:24:53,0.019895833333333335,1,51,0,51
2018-12-30 18:00:30,1.5261111111111112,2,8,6,14
2018-12-29 06:22:51,0.11670138888888888,1,53,2,55
2018-12-29 06:23:08,0.1662847222222222,5,41,41,82
2018-12-29 06:23:44,0.1819097222222222,2,43,11,54
2018-12-28 09:09:32,0.04034722222222222,1,57,0,57
2018-12-28 07:18:48,0.040671296296296296,2,23,12,35
2019-01-08 12:39:50,44.80311342592593,1,159,531,690
2018-12-28 00:01:16,0.15921296296296297,2,2,2,4
2018-12-28 02:38:42,0.5538773148148148,1,201,248,449
2018-12-27 11:25:31,7.730358796296296,55,22360,22250,44610
2018-12-27 11:23:28,0.23038194444444443,1,3,3,6
2018-12-27 02:42:35,0.1763425925925926,1,6,4,10
2018-12-27 02:42:30,0.18217592592592594,1,1,1,2
2018-12-26 18:16:16,0.06620370370370371,1,1,1,2
2018-12-26 18:16:40,0.09630787037037038,3,3,3,6
2019-02-02 18:11:39,38.53011574074074,3,10097,5773,15870
2018-12-26 05:39:18,0.006412037037037037,1,3,3,6
2018-12-26 05:38:43,0.026145833333333333,1,20,17,37
2018-12-26 05:39:00,0.11630787037037037,1,1,1,2
2018-12-29 01:24:37,2.958483796296296,1,136,3,139
2018-12-26 18:15:53,0.6699537037037037,1,14,2,16
2020-01-11 10:55:34,381.42782407407407,2,3,10,13
2018-12-25 18:35:27,0.20309027777777777,1,6,4,10
2018-12-25 17:29:31,0.4102314814814815,1,1,0,1
2018-12-25 17:29:52,0.41246527777777775,1,0,2,2
2018-12-24 18:12:01,0.05971064814814815,1,4,2,6
2018-12-26 18:15:43,2.0834027777777777,1,1,0,1
2018-12-24 18:12:18,0.08721064814814815,1,1,1,2
2018-12-27 12:15:40,4.251018518518518,2,65,3,68
2018-12-22 22:31:24,0.02494212962962963,1,1,1,2
2018-12-22 22:32:01,0.028506944444444446,1,55,90,145
2018-12-22 17:27:04,0.11186342592592592,2,22,22,44
2019-03-15 15:57:24,83.43060185185185,3,26016,11433,37449
2018-12-22 01:35:56,0.020439814814814813,1,0,5,5
2018-12-21 17:52:42,0.008240740740740741,1,4,2,6
2018-12-21 17:52:58,0.4034027777777778,1,70,0,70
2018-12-21 08:34:35,0.1037962962962963,1,22,0,22
2018-12-21 07:59:57,0.14731481481481482,1,33,0,33
2018-12-21 17:56:25,1.2194212962962963,1,22,22,44
2018-12-20 16:51:55,0.3625347222222222,1,167,0,167
2018-12-20 16:52:19,0.4235763888888889,1,48,0,48
2018-12-20 16:52:08,0.4358796296296296,5,120,0,120
2018-12-21 05:16:18,0.9857291666666667,1,3,0,3
2018-12-20 03:23:09,0.006712962962962963,1,94,0,94
2018-12-20 02:51:32,0.06042824074074074,1,24,0,24
2018-12-20 02:51:42,0.0627199074074074,1,24,0,24
2018-12-20 02:47:52,0.06253472222222223,1,24,0,24
2018-12-20 02:24:29,0.04954861111111111,1,38,0,38
2018-12-24 18:06:15,4.887222222222222,1,11,1,12
2018-12-19 21:23:17,0.04446759259259259,1,1,1,2
2018-12-19 12:07:06,5.817291666666667,41,13244,11715,24959
2018-12-19 17:24:15,0.3767013888888889,1,45,0,45
2018-12-19 07:57:00,0.0061805555555555555,1,86,0,86
2018-12-19 07:51:03,11.996608796296297,1,174,12,186
2018-12-20 00:30:44,0.7564120370370371,1,1,1,2
2018-12-24 18:12:38,5.515532407407408,5,186,35,221
2018-12-19 06:24:04,0.06905092592592593,1,52,0,52
2018-12-19 04:19:21,0.013449074074074073,1,28,0,28
2018-12-18 21:00:18,0.11895833333333333,1,1,10,11
2018-12-18 21:28:10,0.14142361111111112,1,2,0,2
2018-12-18 15:43:51,0.115625,1,19,5,24
2018-12-18 15:43:03,0.3571990740740741,1,26,0,26
2018-12-18 15:40:31,0.3778587962962963,1,5,0,5
2018-12-18 15:41:42,0.40891203703703705,1,5,5,10
2018-12-18 00:22:30,0.012604166666666666,1,2,2,4
2018-12-17 20:08:41,0.005127314814814815,1,7,46,53
2018-12-23 01:16:35,5.36068287037037,1,2,0,2
2018-12-17 16:02:59,0.035451388888888886,2,13,4,17
2018-12-17 10:36:21,0.13729166666666667,1,17,0,17
2018-12-17 10:35:56,0.16105324074074073,1,21,0,21
2018-12-17 10:32:25,0.1741550925925926,1,21,0,21
2018-12-17 09:15:15,0.1295138888888889,1,5,5,10
2018-12-17 10:32:45,0.19870370370370372,1,17,0,17
2018-12-17 05:03:52,0.059131944444444445,1,46,0,46
2018-12-17 03:32:36,0.006631944444444445,1,1,0,1
2018-12-17 02:14:29,0.08855324074074074,2,43,62,105
2018-12-16 20:17:15,0.01337962962962963,1,0,2,2
2018-12-16 20:17:57,0.05431712962962963,1,12,6,18
2018-12-30 17:58:52,13.995219907407407,1,0,2,2
2018-12-16 04:50:10,0.184375,1,1,1,2
2018-12-17 10:07:18,38.664155092592594,5,428,627,1055
2018-12-15 08:08:54,0.02722222222222222,2,11,11,22
2018-12-14 19:36:41,0.4576851851851852,1,39,0,39
2018-12-14 19:36:19,0.4981481481481482,1,14,0,14
2018-12-14 19:37:02,0.5083912037037037,1,14,0,14
2018-12-14 05:52:07,0.012337962962962964,1,3,3,6
2018-12-22 19:02:10,8.768703703703704,2,683,537,1220
2018-12-14 04:07:22,0.27055555555555555,7,53,28,81
2018-12-14 00:44:39,0.16631944444444444,1,1,0,1
2018-12-14 00:41:39,0.2088310185185185,1,8,5,13
2018-12-14 19:34:19,1.110439814814815,4,9,12,21
2018-12-13 15:59:51,16.0853125,154,68954,71649,140603
2018-12-13 01:53:53,0.7695138888888889,1,21,0,21
2018-12-13 04:19:53,0.29465277777777776,1,1,1,2
2018-12-17 18:19:46,5.204328703703704,3,31,2,33
2018-12-12 17:13:21,0.15631944444444446,1,4,0,4
2018-12-12 21:32:14,0.6757523148148148,1,24,82,106
2018-12-12 04:54:10,0.9583217592592592,1,1,6,7
2018-12-12 04:54:35,0.971712962962963,1,4,17,21
2018-12-14 19:35:27,3.0463194444444444,1,5,1,6
2018-12-12 21:32:44,1.1609606481481483,5,18,16,34
2018-12-11 18:18:29,0.17451388888888889,2,31,5,36
2018-12-11 18:28:04,0.2036226851851852,2,26,3,29
2018-12-14 00:47:51,2.477337962962963,1,4,0,4
2018-12-11 05:34:03,0.01005787037037037,1,3,3,6
2018-12-11 04:38:57,2.443136574074074,6,92,21,113
2018-12-10 21:53:26,0.07596064814814815,1,94,6,100
2018-12-10 20:39:48,0.3191319444444444,1,4,0,4
2018-12-10 20:39:26,0.5465972222222222,2,27,2,29
2018-12-10 20:38:22,0.6405324074074074,1,7,0,7
2018-12-10 20:38:02,0.8074074074074075,1,0,21,21
2018-12-10 20:37:39,0.6869791666666667,1,72,1,73
2018-12-11 04:30:58,4.130231481481482,4,29,7,36
2018-12-09 16:19:28,1.554525462962963,1,16,0,16
2018-12-17 10:40:52,9.158368055555556,2,6,18,24
2018-12-08 00:32:27,0.010914351851851852,1,8,3,11
2018-12-07 23:40:12,0.017592592592592594,1,2,1,3
2018-12-07 20:08:30,0.21613425925925925,1,23,0,23
2018-12-07 15:40:02,0.33547453703703706,1,23,1,24
2018-12-07 15:39:21,0.42538194444444444,1,51,11,62
2018-12-07 15:38:51,0.5828472222222222,1,0,8,8
2018-12-07 15:53:55,0.5539004629629629,1,0,5,5
2018-12-07 15:37:57,0.48761574074074077,1,34,1,35
2018-12-07 15:42:51,0.42768518518518517,1,1,1,2
2018-12-13 04:22:02,5.983796296296297,1,19,1,20
2018-12-07 15:37:33,0.46456018518518516,4,10,5,15
2018-12-07 03:18:38,0.04005787037037037,1,3,3,6
2018-12-07 15:42:23,0.9318981481481482,5,11,6,17
2018-12-06 08:39:15,0.07912037037037037,1,0,4,4
2018-12-06 08:38:50,0.021030092592592593,1,12,1,13
2018-12-06 07:09:14,0.0528587962962963,1,1,1,2
2018-12-06 07:08:54,0.05303240740740741,1,3,3,6
2019-01-04 15:15:09,29.77371527777778,1,2,3,5
2018-12-05 21:51:13,0.016574074074074074,2,3,3,6
2018-12-17 02:14:13,11.591481481481482,1,5,2,7
2018-12-06 07:10:19,1.0529513888888888,1,38,38,76
2018-12-14 19:37:30,9.572314814814815,1,5,5,10
2018-12-06 16:36:12,2.5289930555555555,1,578,7,585
2018-12-05 01:12:29,0.12818287037037038,3,21,15,36
2018-12-05 04:08:43,0.6699652777777778,2,19,5,24
2018-12-04 00:26:41,0.791238425925926,1,2,2,4
2018-12-04 00:26:56,0.7922569444444445,1,4,4,8
2018-12-11 04:40:01,7.9682407407407405,1,5,5,10
2019-01-01 15:24:26,29.624953703703703,1,60,0,60
2018-12-02 16:41:39,0.0340162037037037,1,10,1,11
2018-12-02 15:46:14,0.06259259259259259,1,59,0,59
2018-12-01 17:36:41,0.013900462962962963,1,2,2,4
2018-12-01 16:39:14,0.10443287037037037,4,34,33,67
2018-12-01 13:25:16,0.2040625,3,8,5,13
2018-11-30 20:38:10,0.07206018518518519,1,6,1,7
2018-11-30 18:16:32,0.008356481481481482,1,9,141,150
2018-12-16 04:56:41,15.802442129629629,26,392,155,547
2018-11-30 18:36:09,0.4421875,1,9,9,18
2018-11-30 18:08:32,0.523287037037037,1,1,1,2
2018-11-30 18:09:32,0.5260416666666666,1,1,1,2
2018-11-30 13:20:15,0.46641203703703704,1,20,1,21
2018-12-04 00:27:18,4.779444444444445,1,3,3,6
2019-06-20 00:52:35,203.19221064814815,1,735,1,736
2018-11-28 15:34:54,0.40877314814814814,1,6,6,12
2018-11-27 22:34:40,0.004988425925925926,1,39,39,78
2018-12-03 00:32:27,5.1015393518518515,1,2,0,2
2018-11-27 18:46:06,0.02802083333333333,1,15,1,16
2018-11-27 17:49:38,0.02673611111111111,1,1,1,2
2018-11-27 17:13:37,0.003715277777777778,1,5,1,6
2018-12-28 02:51:32,30.788888888888888,1,12,2,14
2018-11-27 16:39:42,0.028055555555555556,2,2,2,4
2018-11-27 15:40:40,0.00866898148148148,1,1,1,2
2018-11-27 12:38:04,0.014467592592592593,1,0,4,4
2018-11-27 12:56:26,107.47984953703704,4,58,14,72
2018-11-27 12:56:48,3.6419907407407406,1,35,1,36
2018-11-27 11:19:13,0.04324074074074074,1,1,0,1
2018-11-27 11:50:27,28.940671296296298,123,31461,28869,60330
2018-11-27 11:25:39,0.09252314814814815,3,127,10,137
2018-11-27 18:15:08,1.1261458333333334,1,2,0,2
2018-11-27 11:27:01,1.2347453703703704,1,5,5,10
2018-11-25 15:26:16,0.04567129629629629,1,1,1,2
2018-11-27 11:28:02,1.9547106481481482,1,8,2,10
2018-11-26 14:53:28,1.8502314814814815,4,48,267,315
2018-11-23 20:58:01,0.0018287037037037037,1,0,3,3
2018-11-23 05:29:59,0.009016203703703703,1,3,3,6
2018-11-22 19:12:05,0.22998842592592592,9,60,41,101
2018-11-21 16:02:59,0.014004629629629629,1,5,1,6
2018-11-22 11:47:15,1.2685069444444443,1,8,8,16
2018-11-24 19:48:51,3.912337962962963,1,34,2,36
2018-11-21 16:00:57,0.7732175925925926,1,1,1,2
2018-11-20 01:52:53,0.012719907407407407,1,1,1,2
2018-11-20 21:24:36,1.108101851851852,1,4,4,8
2018-11-22 11:47:36,3.2627083333333333,1,3,4,7
2018-11-22 11:46:57,3.2633449074074075,1,1,1,2
2018-11-19 09:37:58,0.4266666666666667,1,4,0,4
2018-11-20 21:25:05,2.800173611111111,1,1,1,2
2018-11-19 11:49:51,2.3274189814814816,1,5,6,11
2018-11-17 10:07:49,0.2942708333333333,2,3,2,5
2018-11-16 18:34:11,0.019467592592592592,1,3,0,3
2018-11-18 23:43:53,2.246226851851852,1,203,68,271
2018-11-20 21:25:33,4.245208333333333,1,2,1,3
2018-11-16 18:46:24,0.18746527777777777,1,10,2,12
2018-11-16 14:02:19,0.01738425925925926,1,20,20,40
2018-12-03 00:32:09,16.466851851851853,1,153,76,229
2018-11-16 10:19:10,0.1953587962962963,1,5,5,10
2018-11-16 08:47:40,0.251724537037037,2,2,2,4
2018-11-16 02:16:10,3.573101851851852,1,1,1,2
2018-11-15 05:49:06,0.02017361111111111,1,4,4,8
2018-11-12 21:07:31,0.0003587962962962963,1,1,1,2
2018-11-13 13:58:15,0.8119560185185185,1,2,2,4
2018-11-29 01:56:10,16.377534722222222,1,2,1,3
2018-11-12 17:17:51,0.020243055555555556,1,1,1,2
2018-11-16 10:18:44,3.9199074074074076,3,6,5,11
2018-11-12 11:50:22,0.26087962962962963,1,1,1,2
2018-11-12 11:50:12,0.2610300925925926,1,1,1,2
2018-11-12 11:49:52,0.2620138888888889,1,3,3,6
2018-11-12 11:50:49,0.2631597222222222,1,3,3,6
2018-11-11 22:20:21,0.07810185185185185,1,1,1,2
2018-11-11 17:57:17,0.6567476851851852,2,75,17,92
2018-11-10 22:59:52,0.11922453703703703,1,2,2,4
2018-11-10 19:42:05,0.09230324074074074,1,5,4,9
2018-11-10 14:04:14,0.023217592592592592,2,27,15,42
2018-12-09 12:03:01,29.62957175925926,4,29,13,42
2018-11-09 17:06:44,0.01494212962962963,1,17,6,23
2018-11-09 16:43:26,0.018194444444444444,1,0,3,3
2018-11-09 08:07:45,0.09023148148148148,1,2,4,6
2018-11-09 05:55:42,0.020439814814814813,1,3,3,6
2018-11-09 05:56:47,0.024965277777777777,1,1,1,2
2018-11-09 05:55:20,0.024467592592592593,1,1,1,2
2018-11-08 20:56:00,0.001863425925925926,1,1,1,2
2018-11-09 08:08:02,0.47303240740740743,1,3,1,4
2018-11-08 20:35:59,0.9814583333333333,2,7,2,9
2018-11-08 20:06:14,0.24388888888888888,2,7,4,11
2018-11-08 17:45:21,0.5967361111111111,1,20,21,41
2018-11-08 20:06:02,0.9390740740740741,2,2,2,4
2018-11-08 20:06:27,1.1717476851851851,2,10,5,15
2018-11-08 20:08:57,1.1871064814814816,1,12,6,18
2018-11-08 06:42:18,0.6398032407407407,1,1,1,2
2018-11-08 20:35:07,1.4355324074074074,2,155,72,227
2018-11-08 20:05:43,2.2687962962962964,4,71,30,101
2018-11-08 20:13:45,2.618923611111111,1,1,1,2
2018-11-08 20:13:27,2.618877314814815,1,1,1,2
2018-11-06 04:36:57,0.1761111111111111,1,1,1,2
2018-11-05 17:51:27,0.04880787037037037,1,1,2,3
2018-11-05 18:01:18,0.5295486111111111,1,1,1,2
2018-11-05 17:51:45,1.0852777777777778,2,8,2,10
2020-09-01 11:31:28,667.0204166666666,7,221,70,291
2018-11-05 17:59:42,1.749375,1,48,2,50
2018-11-05 17:54:07,4.461006944444445,1,1,1,2
2018-11-03 00:34:43,1.7977314814814815,1,1,1,2
2018-11-05 17:50:53,4.519247685185185,1,1,1,2
2018-11-22 11:49:08,24.49704861111111,3,11,4,15
2018-11-08 20:14:27,8.621006944444444,1,3,3,6
2018-10-30 23:55:21,0.0029976851851851853,1,1,1,2
2018-10-31 00:04:46,0.012824074074074075,1,7,1,8
2018-10-30 23:43:34,0.0014814814814814814,1,5,14,19
2018-10-30 21:06:32,0.019675925925925927,5,15,15,30
2018-10-30 20:09:33,0.007847222222222222,1,6,24,30
2018-10-30 18:46:21,0.010914351851851852,1,1,1,2
2018-10-30 16:37:49,0.005046296296296296,2,10,5,15
2018-10-30 16:06:12,0.020625,1,1,1,2
2018-10-30 16:00:35,0.024930555555555556,1,1,1,2
2018-10-30 15:25:54,0.010914351851851852,1,0,9,9
2018-10-30 13:59:11,0.013414351851851853,1,1,1,2
2018-10-30 14:02:25,0.11976851851851852,1,3,5,8
2018-10-30 14:05:01,0.8431944444444445,4,8,8,16
2018-11-08 20:15:33,9.616712962962962,1,5,5,10
2018-10-30 05:39:52,0.009444444444444445,1,3,3,6
2018-11-08 20:15:09,9.619074074074074,1,1,1,2
2018-10-30 14:02:56,0.40931712962962963,2,9,3,12
2018-10-30 14:03:56,0.45787037037037037,1,21,5,26
2018-10-30 21:07:00,0.8747222222222222,2,10,10,20
2018-10-30 00:06:47,0.009652777777777777,1,14,21,35
2018-10-29 23:47:32,0.10730324074074074,2,4,4,8
2018-10-29 23:49:29,0.11193287037037038,1,5,0,5
2018-10-29 23:47:44,0.11773148148148148,2,6,2,8
2018-12-28 23:43:41,60.210972222222225,1,10,0,10
2018-10-29 13:15:55,0.006122685185185185,2,13,2,15
2018-10-29 13:05:54,0.011655092592592592,1,12,10,22
2018-10-29 13:05:26,0.019988425925925927,1,8,8,16
2018-10-29 12:46:40,0.009016203703703703,1,5,4,9
2018-10-29 11:55:56,0.2742013888888889,1,3,3,6
2018-10-29 11:55:35,0.27471064814814816,1,1,1,2
2018-10-29 11:55:17,0.27532407407407405,1,5,5,10
2018-10-29 11:54:57,0.2757060185185185,1,1,1,2
2018-10-29 03:42:08,0.02454861111111111,1,8,86,94
2018-10-30 14:07:58,1.5934606481481481,3,14,5,19
2018-11-25 15:35:22,28.002465277777777,5,19,4,23
2018-10-28 05:40:00,0.015173611111111112,1,1,0,1
2018-10-27 20:32:54,0.16912037037037037,1,15,7,22
2018-10-29 12:23:30,2.03255787037037,1,1,1,2
2018-10-28 05:35:04,1.0298032407407407,3,61,11,72
2018-10-28 05:42:35,1.036886574074074,2,14,4,18
2018-10-26 20:48:36,0.037037037037037035,1,1,1,2
2018-10-26 20:49:17,0.0625,1,2,2,4
2018-10-26 10:59:59,0.01824074074074074,2,2,2,4
2018-10-29 12:20:30,8.688773148148147,184,68490,69801,138291
2018-10-26 20:49:40,0.5804282407407407,3,19,1,20
2018-10-26 21:08:35,0.7428356481481482,2,19,2,21
2018-10-27 20:56:17,1.7631944444444445,1,62,33,95
2018-10-26 01:31:24,0.01287037037037037,1,1,1,2
2018-10-28 06:15:20,2.184340277777778,4,79,198,277
2018-10-25 23:54:59,0.22449074074074074,1,1,0,1
2018-10-25 23:55:08,0.2255787037037037,1,10,10,20
2018-10-28 05:40:46,2.4691087962962963,3,43,11,54
2018-10-25 23:55:25,0.22221064814814814,3,5,268,273
2018-10-25 14:05:34,0.12961805555555556,1,19,0,19
2018-10-25 16:12:23,0.3229166666666667,1,15,4,19
2018-10-29 12:24:16,4.224930555555556,1,1,1,2
2018-10-25 06:29:26,0.0496412037037037,1,3,3,6
2018-10-25 06:29:13,0.05074074074074074,1,6,6,12
2018-10-25 02:42:25,0.0032523148148148147,2,6,1,7
2018-10-24 23:44:02,0.02587962962962963,1,47,1,48
2018-10-24 22:09:46,0.05738425925925926,3,32,50,82
2018-10-25 01:13:36,0.26256944444444447,1,4,0,4
2018-10-24 22:10:02,0.2399537037037037,1,88,2,90
2018-10-24 05:50:35,0.021886574074074076,1,1,1,2
2018-10-24 05:51:05,0.022604166666666668,1,2,2,4
2018-10-24 14:22:19,0.3779398148148148,1,7,5,12
2018-10-24 16:18:09,0.6507175925925925,1,5,11,16
2018-10-24 16:17:15,0.6970023148148148,1,9,3,12
2018-10-23 23:31:32,0.008310185185185184,1,2,2,4
2018-10-24 23:17:02,1.016886574074074,2,64,70,134
2018-10-23 21:11:38,0.17782407407407408,1,1,1,2
2018-10-25 10:45:19,1.8686805555555555,3,9,3,12
2018-10-23 06:17:26,0.043715277777777777,1,3,3,6
2019-05-19 09:29:26,208.1846064814815,1,1,1,2
2018-11-05 17:52:39,20.51241898148148,2,418,4,422
2019-03-17 14:39:25,145.62542824074075,1,17,2,19
2018-10-22 21:23:01,0.2683217592592593,1,1,2,3
2018-10-22 22:08:25,0.9644791666666667,1,7,10,17
2018-10-22 14:58:08,0.6783796296296296,1,1,1,2
2018-10-22 22:43:19,1.0047916666666667,1,3,1,4
2018-10-22 14:58:36,0.6831828703703704,1,8,8,16
2018-10-21 20:52:11,0.06059027777777778,1,1,1,2
2018-10-21 16:37:58,0.047141203703703706,1,6,0,6
2018-10-21 20:52:27,0.34457175925925926,2,15,3,18
2018-10-21 14:42:23,0.10136574074074074,1,5,0,5
2018-10-21 14:45:09,0.11762731481481481,2,10,8,18
2018-10-21 23:04:36,0.4804861111111111,2,3,2,5
2018-10-21 11:31:40,0.008356481481481482,1,1,1,2
2018-10-21 14:41:34,0.20613425925925927,1,1,2,3
2018-10-21 05:35:26,0.0888425925925926,2,3,3,6
2018-10-20 15:28:05,0.32178240740740743,1,39,38,77
2018-10-20 05:32:26,0.20146990740740742,2,38,40,78
2018-10-23 03:21:28,3.1107175925925925,1,1,1,2
2018-10-20 22:49:37,0.9276388888888889,3,153,39,192
2018-10-20 00:39:40,0.011782407407407408,2,17,88,105
2018-10-20 00:25:26,0.034583333333333334,1,49,15,64
2018-10-20 00:23:59,0.061585648148148146,1,152,108,260
2018-10-19 23:05:17,0.03391203703703704,1,29,0,29
2018-10-19 18:35:42,0.01056712962962963,1,1,3,4
2018-10-19 11:16:14,0.16194444444444445,1,4,0,4
2018-10-19 11:20:08,0.2487962962962963,1,1,1,2
2018-10-19 16:51:40,0.47932870370370373,1,1,1,2
2018-10-19 14:41:26,0.42527777777777775,4,33,52,85
2018-10-19 16:49:35,0.5419212962962963,5,78,81,159
2018-10-22 22:08:40,3.8752893518518516,1,143,6,149
2018-10-18 23:47:30,0.059305555555555556,1,98,11,109
2018-10-18 22:00:20,0.008090277777777778,1,1,1,2
2018-10-18 19:19:32,0.015520833333333333,1,1,1,2
2018-10-18 17:52:02,0.04702546296296296,1,1,1,2
2018-10-18 12:35:49,0.18314814814814814,1,12,0,12
2018-10-18 20:32:48,0.9814699074074074,3,4,4,8
2018-10-17 20:04:41,0.14788194444444444,2,6,2,8
2018-10-17 14:56:16,0.1748611111111111,1,1,1,2
2018-10-17 14:55:00,23.283761574074074,1,2,0,2
2018-10-17 14:56:27,0.4025347222222222,1,1,1,2
2018-10-16 21:42:55,0.07350694444444444,2,2,2,4
2018-10-16 17:55:06,0.015613425925925926,1,5,0,5
2018-10-16 12:09:04,0.025694444444444443,1,1,1,2
2018-10-16 05:50:10,0.022164351851851852,1,4,4,8
2018-10-16 01:01:08,0.035798611111111114,5,66,35,101
2018-10-15 14:09:09,0.10712962962962963,1,1,1,2
2018-10-15 02:38:42,0.10733796296296297,2,2,1,3
2018-10-15 02:39:21,0.6817013888888889,1,0,1,1
2018-10-13 15:00:15,0.37060185185185185,1,2,2,4
2018-10-12 23:51:31,0.10407407407407407,1,12,15,27
2018-10-12 23:51:15,18.272696759259258,35,12719,11113,23832
2018-10-12 17:07:31,0.008912037037037038,1,3,2,5
2018-10-16 12:07:54,4.456261574074074,1,5,4,9
2018-10-12 02:04:09,0.04434027777777778,1,12,1,13
2018-10-12 00:19:11,0.01568287037037037,1,10,4,14
2018-10-11 23:43:09,0.026712962962962963,1,15,5,20
2018-10-11 23:36:52,0.022743055555555555,1,4,0,4
2018-10-11 22:24:10,0.0010648148148148149,1,5,1,6
2018-10-11 22:15:56,2.478275462962963,6,55,11,66
2018-10-12 00:04:08,0.11320601851851853,1,27,25,52
2018-10-11 18:35:47,49.31050925925926,2,18,11,29
2018-10-11 17:24:44,0.009756944444444445,2,36,8,44
2018-10-11 17:26:39,0.5052546296296296,1,1,1,2
2018-10-11 00:29:33,3.2608680555555556,1,11,1,12
2018-10-11 00:10:16,0.0006597222222222222,1,1,1,2
2018-10-10 22:50:19,0.012222222222222223,1,52,33,85
2018-10-17 15:13:05,6.935231481481481,9,163,56,219
2018-10-10 13:09:24,0.32582175925925927,1,3,3,6
2018-10-10 13:09:54,0.3264814814814815,1,1,1,2
2018-10-10 17:36:42,0.5120717592592593,1,3,3,6
2018-10-09 23:31:11,0.0593287037037037,1,23,0,23
2018-10-10 00:21:31,0.10424768518518518,1,14,3,17
2018-10-10 23:31:04,1.1009259259259259,2,53,65,118
2018-10-09 17:36:14,0.20662037037037037,1,1,1,2
2018-10-09 10:39:47,0.22157407407407406,1,1,1,2
2018-10-09 17:43:26,0.5160763888888888,1,3,3,6
2018-10-09 10:59:35,0.23597222222222222,1,3,3,6
2018-10-09 17:43:06,0.27847222222222223,1,5,5,10
2018-10-08 22:12:38,0.30672453703703706,1,13,1,14
2018-10-08 05:44:53,0.018483796296296297,1,4,4,8
2018-10-08 05:45:09,0.01898148148148148,1,1,1,2
2018-10-08 05:45:32,0.01954861111111111,1,3,3,6
2018-10-08 05:24:08,0.004965277777777778,1,3,8,11
2018-10-08 12:43:39,0.4263310185185185,1,9,2,11
2018-10-08 02:48:55,0.19354166666666667,1,0,10,10
2018-10-07 17:45:41,9.238773148148148,1,1,1,2
2018-10-08 02:50:12,0.5625,4,41,41,82
2018-10-09 17:35:15,2.610023148148148,1,37,1,38
2018-10-07 16:26:27,0.5686342592592593,1,4,0,4
2018-11-05 17:53:26,50.911377314814814,35,8711,5773,14484
2018-10-07 02:40:38,0.05862268518518519,1,41,9,50
2018-10-06 11:42:37,0.16099537037037037,1,1409,2,1411
2018-10-06 06:12:06,0.006655092592592593,1,2,2,4
2018-10-06 05:33:37,0.15868055555555555,2,41,41,82
2018-10-05 22:05:12,0.02122685185185185,3,7,2,9
2018-10-05 23:33:27,0.19166666666666668,2,0,5,5
2018-10-05 16:44:45,0.08540509259259259,2,49,23,72
2018-10-05 17:01:01,0.4882060185185185,1,2,2,4
2018-10-05 16:59:36,0.48743055555555553,1,3,3,6
2018-10-05 16:58:14,0.4866435185185185,1,3,3,6
2018-10-05 02:07:44,0.004398148148148148,1,1,1,2
2018-10-04 15:38:04,0.05305555555555556,4,48,47,95
2018-10-04 13:35:19,0.12377314814814815,1,22,21,43
2018-10-04 10:36:54,0.2167361111111111,1,55,79,134
2018-10-04 10:33:02,0.22010416666666666,1,3,3,6
2018-10-04 10:34:17,0.22109953703703702,1,3,3,6
2018-10-12 20:48:17,7.156689814814815,1,3,3,6
2018-10-04 10:31:23,0.2194212962962963,1,3,3,6
2018-10-04 10:32:27,0.22032407407407406,1,4,4,8
2018-10-04 13:47:04,0.5808217592592593,1,108,65,173
2018-10-03 23:04:13,0.11234953703703704,1,3,3,6
2018-10-03 21:44:14,0.22930555555555557,1,6,2,8
2018-10-05 17:17:46,2.299363425925926,2,20,8,28
2018-10-03 23:07:13,0.7419444444444444,1,6,6,12
2018-10-03 13:21:31,0.3355787037037037,1,1,1,2
2018-10-03 13:24:49,0.33800925925925923,1,10,10,20
2018-10-03 13:22:07,0.33643518518518517,1,3,3,6
2018-10-03 13:20:57,0.3357986111111111,1,3,3,6
2018-10-09 01:02:53,6.123090277777778,2,4,1,5
2018-10-02 18:16:05,0.5413773148148148,1,1,1,2
2018-10-02 18:16:52,0.5420601851851852,1,9,7,16
2018-10-03 23:06:54,1.7437152777777778,1,11,9,20
2018-10-02 08:20:52,0.12851851851851853,1,1,1,2
2018-10-02 06:37:29,0.057060185185185186,1,1,1,2
2018-10-01 20:34:26,0.03824074074074074,1,3,1,4
2018-10-04 13:37:32,3.3376967592592592,1,2,2,4
2018-10-01 12:10:07,0.2856944444444444,1,1,1,2
2018-10-03 02:56:01,1.256863425925926,1,4,4,8
2018-10-01 20:49:26,0.6471643518518518,1,4,4,8
2018-10-01 12:08:34,0.2856712962962963,1,3,3,6
2018-10-01 12:06:41,0.3936689814814815,1,1,1,2
2018-10-01 01:38:10,0.11584490740740741,1,1,1,2
2018-10-07 21:44:59,7.925590277777777,9,904,132,1036
2018-09-29 22:06:00,0.12318287037037037,1,1,1,2
2018-10-20 06:02:45,20.527685185185184,1,54,23,77
2018-10-04 14:05:54,4.877523148148148,1,30,25,55
2018-09-29 17:14:49,0.019699074074074074,1,1,0,1
2018-09-29 17:03:34,0.015543981481481482,1,1,1,2
2018-09-29 16:34:37,0.0009143518518518518,1,5,5,10
2018-09-29 02:04:26,0.11368055555555556,2,9,0,9
2018-09-28 15:02:53,0.1287962962962963,1,1,1,2
2018-09-28 11:35:45,0.262037037037037,1,1,1,2
2018-09-28 11:33:11,0.26079861111111113,1,1,1,2
2018-09-28 11:34:32,0.2619675925925926,1,3,3,6
2018-09-28 11:32:41,0.2609722222222222,1,3,3,6
2018-10-04 14:05:38,6.578900462962963,1,12,12,24
2018-09-29 09:40:41,1.3940625,1,2,1,3
2018-09-28 01:34:25,0.053912037037037036,1,22,1,23
2018-09-28 00:11:14,0.010844907407407407,5,130,186,316
2018-10-04 15:36:12,6.732685185185185,1,47,1,48
2018-09-27 18:35:59,0.08513888888888889,1,56,0,56
2019-01-18 15:02:29,1.0680439814814815,1,4,4,8
2018-09-27 15:11:54,0.4116087962962963,1,1,1,2
2018-09-27 15:11:30,0.41149305555555554,1,1,1,2
2018-09-27 16:24:06,0.4622337962962963,1,5,5,10
2018-09-27 05:59:16,0.028668981481481483,1,1,1,2
2018-09-27 15:08:56,0.5315740740740741,1,102,102,204
2018-09-27 18:36:36,1.0513425925925926,2,177,152,329
2018-09-26 17:48:15,0.0431712962962963,1,2,32,34
2018-09-26 13:48:22,0.3358217592592593,1,4,4,8
2018-09-26 17:02:38,0.48913194444444447,1,11,11,22
2018-09-26 06:06:06,0.0333912037037037,1,1,1,2
2018-09-26 17:11:22,0.4956365740740741,1,10,6,16
2018-09-26 05:50:03,0.02269675925925926,1,1,1,2
2018-09-25 18:31:47,0.03119212962962963,1,1,1,2
2018-09-25 18:31:41,0.03140046296296296,1,3,3,6
2018-09-25 18:32:37,0.032233796296296295,1,4,4,8
2018-09-25 18:33:01,0.03287037037037037,1,6,7,13
2018-09-25 19:27:53,0.23135416666666667,1,3,3,6
2018-09-25 13:52:12,0.06201388888888889,1,11,11,22
2018-09-24 14:46:06,0.02966435185185185,1,161,27,188
2018-09-24 16:53:42,20.938368055555557,141,27808,24435,52243
2018-09-24 14:30:03,0.2873148148148148,2,14,1,15
2018-10-07 22:20:46,10.2690625,1,15,3,18
2018-09-24 14:15:50,0.34357638888888886,1,3,1,4
2018-09-23 18:40:37,0.18908564814814816,1,2,2,4
2018-09-23 18:41:25,0.26025462962962964,1,42,38,80
2018-09-24 03:44:02,1.4529976851851851,1,18,6,24
2018-09-24 03:45:59,1.1731944444444444,1,1,1,2
2018-09-23 18:42:13,0.9014930555555556,1,11,3,14
2018-09-27 15:11:07,4.782835648148148,1,3,2,5
2018-09-23 00:56:29,0.2091087962962963,1,1,1,2
2018-09-21 16:54:17,0.051412037037037034,1,5,3,8
2018-09-20 22:43:00,0.1968287037037037,2,4,4,8
2018-09-20 20:53:31,0.17622685185185186,1,1,1,2
2018-09-19 23:25:35,0.0007523148148148148,1,1,1,2
2018-09-28 00:23:46,8.07449074074074,6,62,64,126
2018-09-19 22:10:36,0.01337962962962963,1,33,1,34
2018-09-19 14:47:32,0.007627314814814815,1,16,1,17
2018-09-19 14:55:09,15.856041666666666,117,25911,22871,48782
2018-09-19 13:31:16,0.02921296296296296,2,14,2,16
2018-09-18 21:57:22,0.005405092592592592,1,6,3,9
2018-09-18 20:49:25,0.11539351851851852,2,2,2,4
2018-09-18 01:57:14,0.3005324074074074,1,9,2,11
2018-09-17 18:24:47,0.215625,1,5,1,6
2018-09-17 12:55:48,0.0859837962962963,2,2,2,4
2018-09-17 16:02:18,0.49269675925925926,2,6,6,12
2018-09-16 18:49:15,0.02488425925925926,1,11,5,16
2018-09-25 13:59:20,9.906053240740741,2,2332,954,3286
2018-09-18 14:45:59,2.594224537037037,11,840,389,1229
2018-09-15 20:30:02,0.24417824074074074,1,2,2,4
2018-09-15 05:17:15,0.04923611111111111,1,8,0,8
2018-09-13 22:53:10,0.03436342592592593,1,18,18,36
2018-09-13 22:58:43,10.191851851851851,85,22239,19426,41665
2018-09-13 13:18:48,0.07313657407407408,1,5,1,6
2018-09-13 13:27:30,0.14041666666666666,1,1,0,1
2018-09-13 18:31:12,0.3552430555555556,1,1,0,1
2018-09-27 22:37:22,14.978680555555556,2,2,1,3
2018-09-13 18:31:34,1.914085648148148,2,30,17,47
2018-09-13 18:32:00,2.1987152777777776,1,5,3,8
2018-09-14 15:42:23,3.639803240740741,5,220,402,622
2018-09-13 01:44:08,2.120578703703704,2,155,228,383
2018-09-12 23:50:42,2.1511342592592593,2,14,9,23
2018-09-10 16:26:29,0.059583333333333335,1,11,9,20
2018-09-10 00:01:03,0.011689814814814814,1,106,106,212
2018-09-09 23:31:43,0.0671412037037037,3,235,112,347
2019-07-21 16:08:03,315.66109953703705,1,17,21,38
2018-09-09 02:10:45,0.11189814814814815,2,62,9,71
2018-09-09 00:08:50,0.0711574074074074,1,5,0,5
2018-09-09 01:38:14,0.14806712962962962,6,17,15,32
2018-09-09 11:33:37,2.357152777777778,2,140,0,140
2018-09-06 23:18:46,0.12783564814814816,1,2,2,4
2018-09-07 03:42:17,1.3576273148148148,1,7,0,7
2018-09-08 21:54:29,3.1069328703703705,1,4,1,5
2018-09-14 15:42:45,9.066527777777777,1,3,3,6
2018-09-07 03:42:54,1.950960648148148,1,1,0,1
2018-09-07 03:43:10,2.3187037037037035,1,4,1,5
2018-09-10 16:26:48,6.937094907407407,1,1,1,2
2020-01-10 21:58:17,494.22747685185186,7,1584,1576,3160
2018-09-04 23:50:06,1.4127083333333332,4,140,138,278
2018-09-09 00:10:59,5.943530092592592,1,17,0,17
2018-09-02 22:10:29,0.008981481481481481,1,1,0,1
2018-09-02 20:31:54,0.016666666666666666,2,5,0,5
2018-09-02 20:31:35,0.16619212962962962,23,5514,5195,10709
2018-09-02 20:14:49,0.015729166666666666,1,15,4,19
2018-09-02 17:10:33,0.05271990740740741,1,4,0,4
2018-09-02 16:20:26,0.5903819444444445,15,2776,2342,5118
2018-09-02 13:51:07,0.01846064814814815,1,7,3,10
2018-09-02 11:21:55,0.012858796296296297,2,71,33,104
2018-09-25 03:09:35,22.8340625,1,72,45,117
2018-09-02 11:23:39,0.07380787037037037,1,108,0,108
2018-09-02 01:14:46,1.6450462962962964,32,16454,14394,30848
2018-09-02 00:05:33,0.02351851851851852,1,1,1,2
2018-09-01 22:11:58,0.04017361111111111,1,36,2,38
2018-09-01 17:41:22,0.012916666666666667,1,13,39,52
2018-09-01 17:42:03,0.04537037037037037,1,9,0,9
2018-09-01 14:09:24,0.4577893518518519,1,4,4,8
2018-10-30 05:33:02,59.13608796296296,2,2,2,4
2018-08-31 18:33:02,0.10905092592592593,1,2,2,4
2019-01-04 12:10:44,125.90950231481482,4,63,5,68
2018-08-31 14:22:04,0.01857638888888889,1,31,31,62
2018-08-31 13:17:32,0.015300925925925926,1,1,0,1
2018-08-31 13:17:00,0.014537037037037038,1,26,3,29
2018-08-31 13:15:22,0.14,1,1,0,1
2018-08-31 13:12:07,0.16128472222222223,1,4,4,8
2018-08-31 09:16:19,0.2941666666666667,1,2,0,2
2018-08-31 02:28:29,3.6003125,71,18292,17507,35799
2018-09-01 01:35:38,0.979849537037037,1,2,1,3
2018-08-31 02:22:53,0.031145833333333334,1,3,3,6
2018-08-31 01:43:03,0.10201388888888889,1,52,50,102
2018-09-01 01:36:37,2.2291666666666665,2,3,3,6
2018-08-30 21:53:31,1.1637037037037037,1,22,1,23
2018-08-31 01:46:14,1.3545601851851852,2,15,8,23
2018-08-29 13:39:35,0.055405092592592596,1,1,1,2
2018-08-28 23:10:04,0.10322916666666666,1,0,0,0
2018-08-29 19:13:50,1.0477199074074075,1,13,2,15
2018-08-30 21:14:02,2.131666666666667,4,77,64,141
2018-08-29 16:35:09,0.9806134259259259,3,9,7,16
2018-08-28 23:19:58,0.3154166666666667,2,12,7,19
2018-08-28 23:21:24,0.6053587962962963,2,6,0,6
2018-08-28 03:39:44,0.17996527777777777,2,61,4,65
2018-08-28 23:20:12,1.0480555555555555,1,1,1,2
2018-09-25 03:08:56,28.564560185185186,2,76,20,96
2018-08-27 11:03:32,3.7088194444444444,23,9238,11704,20942
2018-08-28 23:20:56,1.6302662037037037,2,192,192,384
2018-08-27 11:05:27,0.11349537037037037,1,4,4,8
2018-08-27 17:07:48,0.7577893518518518,1,2,2,4
2018-08-26 19:30:17,0.0115625,1,61,21,82
2018-08-26 19:30:54,0.06304398148148148,1,21,16,37
2018-08-26 18:22:17,0.023506944444444445,1,122,14,136
2018-08-26 18:02:46,0.016412037037037037,1,2,0,2
2018-08-26 18:02:33,0.029513888888888888,1,2,0,2
2018-08-26 18:21:03,0.08018518518518518,4,86,23,109
2018-08-26 15:19:48,0.019525462962962963,1,2,39,41
2018-08-26 15:53:26,0.05545138888888889,1,25,8,33
2018-08-26 17:22:47,0.029456018518518517,3,26,24,50
2018-08-26 12:29:58,0.012141203703703704,1,1,1,2
2018-08-26 12:34:00,0.41496527777777775,1,1,1,2
2019-02-02 18:01:18,160.79482638888888,3,34145,13162,47307
2018-08-25 23:19:14,0.030474537037037036,3,9,6,15
2018-08-25 22:33:57,0.020358796296296295,2,4,2,6
2018-08-25 22:13:23,0.011342592592592593,4,1,2,3
2018-08-25 22:18:40,0.04496527777777778,1,2,2,4
2018-08-26 09:54:26,0.5707291666666666,1,6,0,6
2018-08-25 20:47:00,0.02803240740740741,1,3,1,4
2018-08-25 20:55:26,0.04461805555555556,1,18,15,33
2018-08-26 14:53:20,0.8210416666666667,1,1,1,2
2018-08-26 14:53:07,0.8348726851851852,1,106,5,111
2018-08-25 19:24:21,0.19831018518518517,1,2,1,3
2018-08-25 11:26:18,0.078125,1,10,0,10
2018-08-25 11:27:09,0.1240162037037037,1,9,9,18
2018-08-25 11:27:35,0.14081018518518518,1,15,1,16
2018-08-29 09:05:22,4.125578703703703,2,1973,357,2330
2018-08-25 11:27:56,3.565324074074074,39,11175,18538,29713
2018-08-25 01:03:36,0.03050925925925926,1,1,1,2
2018-08-26 14:39:38,1.6323726851851852,3,736,147,883
2018-08-24 21:55:41,0.059988425925925924,2,9,3,12
2018-08-24 19:47:00,0.035833333333333335,2,2,2,4
2018-08-25 11:28:08,0.7292361111111111,1,9,9,18
2018-08-25 20:35:30,1.1179166666666667,1,1,1,2
2018-08-25 11:25:40,0.7551967592592592,1,68,11,79
2018-08-24 16:17:11,0.03917824074074074,1,3,3,6
2018-08-23 19:51:57,0.014155092592592592,1,1,1,2
2018-08-24 02:33:28,0.3015277777777778,1,30,2,32
2018-08-23 18:43:28,0.016412037037037037,1,6,0,6
2018-08-23 19:44:27,0.1289699074074074,2,13,11,24
2018-08-23 17:11:41,0.03212962962962963,1,2,2,4
2018-08-23 19:21:16,0.12965277777777778,1,5,5,10
2018-08-23 17:20:50,0.08087962962962963,1,88,0,88
2018-08-23 15:26:23,0.020497685185185185,1,19,81,100
2018-08-23 16:29:00,0.07711805555555555,1,2,2,4
2018-08-23 18:56:57,0.18274305555555556,2,30,9,39
2018-08-23 14:39:23,0.012905092592592593,1,2,2,4
2018-08-23 12:17:36,0.5738541666666667,2,52,4,56
2018-08-23 10:06:02,0.10217592592592592,1,4,2,6
2018-08-22 22:28:24,0.04334490740740741,1,12,2,14
2018-08-22 22:27:58,0.06329861111111111,1,2,2,4
2018-08-22 18:55:51,0.017199074074074075,1,1,1,2
2018-08-22 18:55:14,0.9057291666666667,2,122,9,131
2018-08-22 17:42:47,0.31925925925925924,1,12,8,20
2018-08-23 21:30:58,1.9033564814814814,1,3,3,6
2018-08-22 00:44:57,0.03858796296296296,1,1,1,2
2018-08-22 09:53:42,0.464537037037037,3,99,36,135
2018-08-22 17:33:11,2.096238425925926,1,21,3,24
2018-08-23 10:43:03,2.5783217592592593,15,1934,646,2580
2018-08-21 16:38:28,9.121863425925927,90,25706,23325,49031
2018-09-02 14:13:07,11.086597222222222,2,2,2,4
2018-08-21 15:53:02,0.28435185185185186,2,5,13,18
2018-08-21 10:25:51,0.44991898148148146,1,19,19,38
2018-08-21 00:49:52,0.05331018518518518,1,4,2,6
2018-08-21 18:11:35,0.778599537037037,1,25,1,26
2018-08-23 21:26:30,2.933726851851852,3,9,11,20
2018-08-20 21:58:58,0.10627314814814814,2,4,5,9
2018-08-20 20:42:03,0.05703703703703704,1,3,3,6
2018-08-20 16:46:05,0.12085648148148148,1,81,7,88
2018-08-20 11:32:43,0.25474537037037037,1,1,1,2
2018-08-20 01:44:17,0.06755787037037037,1,6,0,6
2018-08-20 11:28:05,0.4502083333333333,1,18,3,21
2018-08-19 17:16:41,0.01659722222222222,1,1,1,2
2018-08-19 16:44:20,0.014918981481481481,1,2,1,3
2018-08-19 15:11:13,0.09337962962962963,2,34,6,40
2018-08-19 15:05:36,0.23684027777777777,1,7,1,8
2018-08-19 13:51:58,0.27399305555555553,1,4,0,4
2018-08-19 13:48:30,0.4338194444444444,1,18,0,18
2018-08-19 01:28:43,0.06287037037037037,1,24,1,25
2018-08-19 01:50:35,0.1959027777777778,1,8,1,9
2018-08-19 00:01:50,0.13136574074074073,1,1,1,2
2018-08-18 22:58:54,0.12210648148148148,1,34,12,46
2018-08-18 23:17:45,0.14553240740740742,1,3,1,4
2018-08-19 01:17:02,0.23586805555555557,1,15,11,26
2018-08-18 17:40:35,0.08098379629629629,1,18,0,18
2018-08-18 17:42:14,0.0830324074074074,1,1,1,2
2018-08-18 10:50:33,0.12365740740740741,1,7,7,14
2018-08-18 01:44:51,0.19686342592592593,1,10,7,17
2018-08-18 01:03:24,0.36539351851851853,1,29,6,35
2018-08-17 16:00:02,0.021157407407407406,2,1552,8,1560
2018-08-17 14:24:57,0.08418981481481481,2,53,0,53
2018-08-17 12:08:18,0.016145833333333335,1,2,2,4
2018-08-17 12:07:39,0.028668981481481483,1,3,1,4
2018-08-19 01:20:38,1.8848726851851851,2,31,31,62
2018-08-18 02:05:43,1.2548611111111112,2,8,8,16
2018-08-16 18:02:52,0.13622685185185185,1,5,0,5
2018-08-16 18:05:27,0.15238425925925925,1,6,1,7
2018-08-24 16:16:54,8.743796296296296,2,16,5,21
2018-08-18 19:06:13,2.728009259259259,1,4,0,4
2018-08-15 21:38:32,0.09173611111111112,1,0,3,3
2018-08-15 18:23:13,0.020717592592592593,1,4,0,4
2018-08-16 12:21:52,0.8241898148148148,1,2,2,4
2018-09-27 15:04:33,43.79105324074074,6,125,71,196
2018-08-18 01:03:12,3.2203587962962965,5,354,202,556
2018-08-14 19:51:17,0.2995833333333333,3,17,3,20
2018-08-18 10:48:28,3.6827662037037037,1,15,4,19
2018-08-14 19:56:18,0.08998842592592593,2,36,17,53
2018-08-14 18:24:37,0.03795138888888889,1,2,2,4
2018-08-14 18:24:48,0.040289351851851854,1,28,6,34
2018-08-15 17:33:37,1.1490972222222222,2,12,6,18
2018-08-19 13:52:38,5.981041666666667,4,294,105,399
2018-08-12 21:11:41,0.043055555555555555,1,3,3,6
2018-08-13 11:40:02,0.6769097222222222,1,41,0,41
2018-08-15 17:29:53,2.943865740740741,1,29,3,32
2018-08-12 16:16:26,0.14548611111111112,1,57,7,64
2018-08-11 20:02:56,0.030694444444444444,1,9,0,9
2018-08-11 19:59:24,12.6971875,87,24669,22236,46905
2018-08-11 16:00:42,0.014652777777777778,1,9,0,9
2018-08-11 05:52:05,0.057650462962962966,1,1,1,2
2018-08-11 05:51:31,12.10837962962963,79,23269,20315,43584
2018-08-10 21:39:53,0.03306712962962963,1,8,5,13
2018-08-10 04:43:03,0.30668981481481483,1,78,5,83
2018-08-11 09:53:10,1.559386574074074,1,1,1,2
2018-08-09 20:37:49,0.035381944444444445,1,0,3,3
2018-08-10 22:52:36,1.2451851851851852,2,102,1,103
2018-08-15 16:12:45,7.0070601851851855,1,6,1,7
2018-08-09 13:24:30,0.11456018518518518,1,5,0,5
2018-08-09 06:50:43,0.3751041666666667,5,137,38,175
2018-08-09 07:56:53,0.5454976851851852,1,298,6,304
2018-08-09 10:58:21,1.0366203703703705,1,397,385,782
2018-08-12 10:25:23,4.331030092592592,2,50,54,104
2018-08-07 16:02:35,0.23803240740740741,1,3,3,6
2018-08-06 13:16:03,0.7390856481481481,1,9,0,9
2018-08-15 17:38:56,10.187951388888889,4,22,28,50
2018-08-08 19:12:46,3.3589699074074075,1,0,7,7
2018-08-05 10:22:23,0.0067476851851851856,1,1,1,2
2018-08-02 22:09:25,0.03902777777777778,1,83,71,154
2018-08-11 09:52:53,2.685509259259259,1,10,2,12
2018-08-02 13:08:29,0.07616898148148148,1,1,1,2
2018-08-01 15:57:03,0.020555555555555556,1,1,1,2
2018-07-31 16:59:35,0.025902777777777778,2,14,4,18
2018-07-31 12:38:32,0.014583333333333334,1,1,1,2
2018-08-14 17:19:33,14.685069444444444,3,146,36,182
2018-07-30 20:22:55,0.022858796296296297,1,4,10,14
2018-07-30 20:29:52,0.13162037037037036,1,3,2,5
2018-07-30 17:33:06,0.02347222222222222,1,32,22,54
2018-07-30 23:14:34,0.3043287037037037,2,50,36,86
2018-07-30 01:43:35,4.817835648148148,22,8863,5936,14799
2018-07-29 14:52:07,0.17296296296296296,1,111,79,190
2018-07-31 00:54:25,2.2083796296296296,1,19,11,30
2018-07-28 21:14:56,0.07388888888888889,1,3,3,6
2018-07-28 21:15:17,0.08184027777777778,1,1,1,2
2018-07-30 17:33:37,1.9265625,2,2,2,4
2018-07-28 21:52:21,0.11599537037037037,1,39,1,40
2018-07-29 00:57:14,0.24619212962962964,1,89,136,225
2018-07-28 18:09:59,0.02417824074074074,3,6,7,13
2018-07-28 17:20:46,1.107175925925926,1,2,1,3
2018-07-28 01:33:00,0.2065972222222222,1,20,23,43
2018-07-26 02:49:29,0.03408564814814815,1,1,1,2
2018-07-25 23:42:34,0.05627314814814815,1,1,1,2
2018-07-26 02:49:46,0.26166666666666666,1,1,0,1
2018-07-26 02:50:50,0.30582175925925925,1,7,3,10
2018-07-25 16:49:48,0.2594212962962963,1,2,0,2
2018-07-28 17:25:33,9.776099537037037,1,1382,1417,2799
2018-07-26 02:51:26,1.3284027777777778,3,56,3,59
2018-07-24 18:47:14,9.785625,72,16710,14306,31016
2018-07-18 06:38:36,3.2796296296296297,45,8894,8647,17541
2018-07-17 19:44:12,0.035925925925925924,1,1,1,2
2018-07-17 16:54:08,0.020983796296296296,1,4,0,4
2018-07-17 13:29:34,0.3432060185185185,1,4,23,27
2018-07-16 22:15:17,0.17988425925925927,1,1,0,1
2018-07-16 16:43:23,0.008113425925925927,1,1,1,2
2018-07-16 17:21:27,0.04269675925925926,1,37,0,37
2018-07-16 16:35:43,0.031261574074074074,1,5,3,8
2018-07-16 13:17:44,0.008113425925925927,1,1,1,2
2018-07-16 10:23:28,0.04601851851851852,1,29,1,30
2018-07-15 23:11:54,0.010983796296296297,1,279,8,287
2018-07-15 12:56:00,0.0861574074074074,1,1,1,2
2018-07-15 03:29:18,0.03636574074074074,1,1,1,2
2018-07-14 23:01:02,0.007210648148148148,1,10,10,20
2018-07-14 21:28:30,0.06378472222222223,1,1,1,2
2018-07-14 13:12:28,0.15332175925925925,1,11,14,25
2018-07-14 09:27:27,0.016261574074074074,1,3,0,3
2018-07-14 01:54:12,1.9621296296296296,34,7816,7711,15527
2018-07-14 01:44:24,0.0956712962962963,1,2,0,2
2018-07-14 01:56:34,0.1282060185185185,1,4,2,6
2018-07-14 01:56:53,0.13917824074074073,1,8,8,16
2018-07-14 02:07:48,0.1517476851851852,1,4,3,7
2018-07-14 02:05:36,0.16105324074074073,1,14,5,19
2018-07-14 01:59:32,0.1806712962962963,1,3,3,6
2018-07-12 15:58:27,0.33775462962962965,2,5,1,6
2018-07-13 00:16:07,1.3409837962962963,4,311,10,321
2018-07-11 05:01:43,0.053912037037037036,2,9,5,14
2018-07-10 23:14:39,5.402152777777777,87,12557,11758,24315
2018-07-10 22:56:55,0.0265625,1,2,0,2
2018-07-10 01:01:51,0.10704861111111111,1,14,2,16
2018-07-07 18:45:04,0.013344907407407408,1,1,1,2
2018-07-07 20:20:14,0.12142361111111111,2,65,48,113
2018-07-07 19:09:54,0.09929398148148148,1,8,2,10
2018-07-07 17:31:19,0.0580787037037037,2,19,5,24
2018-07-07 16:51:45,0.03262731481481482,1,3,2,5
2018-07-09 00:22:09,1.4325694444444443,2,61,11,72
2018-07-07 01:53:01,0.14658564814814815,1,30,3,33
2018-07-06 11:19:19,1.8217824074074074,1,1,1,2
2018-07-06 11:16:32,0.24320601851851853,1,2,2,4
2018-07-06 00:15:57,0.01957175925925926,1,15,1,16
2018-07-07 16:51:57,1.722164351851852,1,2,6,8
2018-07-06 00:15:45,0.1567939814814815,3,6,5,11
2018-07-05 18:57:51,0.02855324074074074,1,3,1,4
2018-07-05 16:43:38,0.018541666666666668,1,5,1,6
2018-07-05 18:57:36,0.19827546296296297,1,10,0,10
2018-07-05 18:57:25,0.2044212962962963,1,2,0,2
2018-07-05 13:20:16,0.015960648148148147,1,0,0,0
2018-07-05 12:50:17,8.959791666666666,123,21605,16199,37804
2018-07-05 10:19:39,0.016087962962962964,1,11,0,11
2018-07-04 15:35:35,0.044502314814814814,1,2,9,11
2018-07-04 13:34:28,0.19016203703703705,1,12,8,20
2018-07-04 00:58:45,0.10306712962962963,1,4,0,4
2018-07-03 23:49:58,0.24672453703703703,1,1,1,2
2018-07-04 15:35:58,0.9842592592592593,1,1,1,2
2018-07-04 15:35:03,1.0955555555555556,1,15,0,15
2018-07-03 17:47:10,0.18949074074074074,1,26,1,27
2018-07-03 14:12:06,0.10526620370370371,1,16,0,16
2018-07-03 03:00:45,0.014988425925925926,1,1,1,2
2018-07-03 17:50:19,0.7530324074074074,1,12,12,24
2018-07-03 00:17:18,0.025243055555555557,1,1,1,2
2018-07-02 23:48:10,0.01037037037037037,1,21,0,21
2018-07-05 16:31:36,2.8798726851851852,6,312,122,434
2018-07-03 07:09:22,0.6163194444444444,1,2,2,4
2018-07-04 15:36:33,2.0302546296296295,1,22,2,24
2018-07-01 02:16:14,0.055844907407407406,1,2,2,4
2018-07-01 02:12:35,0.20726851851851852,2,21,6,27
2018-07-02 23:47:57,2.184710648148148,3,169,137,306
2018-06-30 11:11:39,0.30333333333333334,1,2,2,4
2018-06-30 00:42:01,0.11390046296296297,1,36,53,89
2018-07-05 23:58:08,6.552164351851852,1,2841,2661,5502
2018-06-29 13:34:37,0.594212962962963,10,577,119,696
2018-06-29 13:36:03,3.9519560185185183,1,1,5,6
2018-06-27 01:10:54,0.2169212962962963,1,8,8,16
2018-06-26 18:33:30,0.03170138888888889,1,1,0,1
2018-06-26 18:34:02,0.036585648148148145,1,2,1,3
2018-06-25 11:31:48,7.266446759259259,52,9076,8496,17572
2018-06-25 11:30:25,0.15082175925925925,1,4,2,6
2018-06-25 02:43:23,6.051898148148148,1,8,1,9
2018-06-24 22:12:16,0.01070601851851852,1,1,1,2
2018-06-24 11:33:07,0.026909722222222224,1,3,2,5
2018-06-24 10:55:56,0.13354166666666667,1,38,0,38
2018-06-26 18:35:11,2.999699074074074,1,1,1,2
2018-06-26 18:34:13,4.001203703703704,1,22,0,22
2018-06-21 21:05:01,0.011226851851851852,1,4,2,6
2018-06-21 21:07:40,0.1352199074074074,1,8,6,14
2018-06-21 01:41:50,0.007071759259259259,1,1,1,2
2018-06-21 01:40:24,0.007766203703703704,1,43,0,43
2018-06-20 18:55:18,0.6291435185185185,2,9,11,20
2018-06-20 13:22:07,0.05082175925925926,2,2,3,5
2018-06-20 13:22:37,0.7378935185185185,1,2,2,4
2018-06-19 02:11:46,0.009259259259259259,1,1,1,2
2018-06-19 00:25:29,0.423599537037037,21,4749,4693,9442
2018-06-18 22:19:18,0.013425925925925926,1,1,1,2
2018-06-18 21:58:14,0.004641203703703704,1,1,1,2
2019-02-02 18:37:16,229.07322916666666,1,1,4,5
2018-06-18 15:27:06,0.007106481481481482,1,3,1,4
2018-06-18 20:43:02,0.2452777777777778,2,15,4,19
2018-06-18 13:41:40,1.983136574074074,27,12748,12171,24919
2018-06-18 13:33:12,0.030833333333333334,1,4,4,8
2018-06-18 01:45:20,0.006261574074074074,1,22,0,22
2018-06-17 19:08:23,0.04030092592592593,2,8,1,9
2018-06-17 16:49:35,0.012476851851851852,1,8,4,12
2018-06-17 16:57:32,0.031828703703703706,3,21,5,26
2018-06-17 16:10:59,0.022569444444444444,1,1,1,2
2018-06-17 11:47:57,0.020092592592592592,1,5,5,10
2018-06-17 11:54:04,0.6759606481481482,3,32,113,145
2018-06-16 16:47:20,0.009432870370370371,1,1,1,2
2018-06-16 09:47:43,0.043958333333333335,2,38,29,67
2018-06-16 10:57:25,0.17234953703703704,1,10,5,15
2018-06-16 10:56:45,0.23054398148148147,1,55,37,92
2018-06-16 09:24:55,0.26839120370370373,5,9,3,12
2018-06-16 10:56:29,15.609293981481482,75,21313,19494,40807
2018-06-16 01:05:46,0.012199074074074074,1,2,2,4
2018-06-15 17:49:32,0.00974537037037037,1,1,3,4
2018-06-15 18:21:48,0.03574074074074074,3,3,3,6
2018-06-15 17:46:26,0.02087962962962963,1,0,9,9
2018-06-15 16:00:04,0.0849537037037037,1,3,0,3
2018-06-15 13:51:52,0.011331018518518518,1,0,1,1
2018-06-15 16:00:24,0.10445601851851852,2,108,18,126
2018-06-15 13:51:37,0.09189814814814815,1,7,1,8
2018-06-15 09:15:15,1.122789351851852,11,184,192,376
2018-06-14 01:49:17,0.0284375,1,36,9,45
2018-06-14 06:03:08,0.2629861111111111,1,1,1,2
2018-06-14 06:03:52,0.4223263888888889,1,5,4,9
2018-06-13 01:28:40,0.009398148148148149,1,36,9,45
2018-06-12 12:24:46,0.03136574074074074,1,219,5,224
2018-06-13 12:44:51,1.1261458333333334,4,114,27,141
2018-07-14 23:19:10,34.44467592592593,2,4,2,6
2018-06-10 14:53:50,9.911574074074075,35,14469,13412,27881
2018-06-10 14:54:23,0.029560185185185186,1,12,1,13
2018-06-10 14:12:48,0.1945601851851852,1,2,2,4
2018-06-10 14:13:31,0.36518518518518517,1,13,1,14
2018-06-09 22:38:18,0.09472222222222222,2,47,7,54
2018-06-09 20:20:57,0.043159722222222224,1,3,3,6
2018-06-09 19:10:53,0.0021875,1,2,2,4
2018-06-09 15:07:24,0.07403935185185186,3,10,10,20
2018-06-09 20:21:38,0.31340277777777775,2,13,0,13
2018-06-09 19:11:15,0.25265046296296295,2,2,2,4
2018-06-09 20:46:54,0.38738425925925923,5,76,55,131
2018-06-09 11:33:05,0.017511574074074075,1,18,1,19
2018-06-09 20:47:51,0.752175925925926,1,67,2,69
2018-06-08 11:28:05,0.17131944444444444,4,42,12,54
2018-06-08 02:50:53,7.4095254629629625,26,9078,8914,17992
2018-06-07 22:14:06,0.016377314814814813,3,13,3,16
2018-06-07 20:40:56,0.013784722222222223,1,6,0,6
2018-06-07 04:37:44,0.017858796296296296,1,10,6,16
2018-06-06 18:49:40,0.0225,1,5,1,6
2018-06-06 18:49:53,0.026956018518518518,1,5,5,10
2018-06-06 18:50:08,0.0341087962962963,1,5,4,9
2018-06-06 19:13:31,0.2453125,1,5,1,6
2018-06-07 17:40:24,1.2118981481481481,9,78,36,114
2018-06-06 01:23:22,0.012037037037037037,1,30,0,30
2018-06-05 18:28:30,3.388796296296296,9,1843,1621,3464
2018-06-05 18:11:04,0.012025462962962963,1,150,118,268
2018-06-04 22:17:39,0.15210648148148148,3,74,12,86
2018-06-04 20:20:13,0.12332175925925926,4,11,5,16
2018-06-04 16:58:37,0.11758101851851852,1,27,7,34
2018-06-04 11:42:54,0.014490740740740742,1,1,1,2
2018-06-04 11:09:53,0.025891203703703704,1,7,0,7
2018-06-04 11:09:37,0.049756944444444444,1,1,1,2
2018-06-04 11:24:20,0.06806712962962963,1,1,0,1
2018-06-04 11:13:32,0.3312731481481481,1,7,0,7
2018-06-04 03:15:51,0.026875,1,17,13,30
2018-06-04 02:39:43,0.019305555555555555,1,7,13,20
2018-06-04 02:19:17,0.011631944444444445,1,5,2,7
2018-06-04 02:21:15,0.03166666666666667,1,1,1,2
2018-06-04 01:35:56,0.7000694444444444,2,54,5,59
2018-06-04 01:00:37,0.012002314814814815,1,1,1,2
2018-06-04 00:18:18,1.3038425925925925,14,2,226,228
2018-06-02 09:52:17,0.023680555555555555,1,79,0,79
2018-06-02 01:03:09,1.465300925925926,26,8749,8652,17401
2018-06-01 17:19:31,0.01570601851851852,1,2,3,5
2018-06-01 17:18:38,0.04869212962962963,2,127,11,138
2018-06-01 17:19:45,0.6386921296296296,1,13,12,25
2018-06-01 12:03:20,0.2857175925925926,6,149,43,192
2018-06-01 12:02:50,0.3060185185185185,1,12,11,23
2018-06-01 12:22:43,0.33131944444444444,1,104,41,145
2018-05-31 15:22:34,0.0023263888888888887,2,4,2,6
2018-05-31 14:47:29,0.006574074074074074,1,2,2,4
2018-05-31 14:46:03,0.007245370370370371,1,5,1,6
2018-05-31 15:09:10,0.032094907407407405,3,23,21,44
2018-05-31 11:00:40,43.03957175925926,52,13264,10720,23984
2018-05-31 00:30:37,0.02732638888888889,1,1,1,2
2018-05-31 02:15:39,0.3319097222222222,2,420,191,611
2018-05-30 19:09:31,0.08516203703703704,2,59,18,77
2018-05-30 16:42:07,0.009108796296296297,1,2,1,3
2018-05-30 16:41:47,0.22002314814814813,4,207,118,325
2018-05-30 07:39:53,0.15229166666666666,1,11,7,18
2018-05-29 20:55:34,0.16284722222222223,1,17,6,23
2018-05-29 15:42:30,0.08335648148148148,1,14,13,27
2018-05-29 14:25:06,0.04559027777777778,1,3,1,4
2018-05-29 11:34:02,0.0862962962962963,1,1,1,2
2018-05-29 11:33:21,0.3277777777777778,1,22,3,25
2018-05-29 00:01:05,0.05554398148148148,1,11,3,14
2018-05-28 23:39:02,0.0487037037037037,1,1,1,2
2018-05-29 00:01:25,0.06924768518518519,1,69,56,125
2018-05-30 00:51:26,1.3041550925925927,1,86,3,89
2018-05-28 17:13:20,0.09643518518518518,1,36,2,38
2018-05-28 17:12:53,0.12631944444444446,1,5,0,5
2018-05-28 17:14:25,0.17253472222222221,1,1,1,2
2018-05-28 13:56:59,0.07931712962962963,1,17,0,17
2018-05-28 03:21:04,0.0444212962962963,1,5,2,7
2018-05-28 00:42:07,0.011666666666666667,1,9,12,21
2018-05-30 00:50:24,2.052210648148148,1,126,7,133
2018-05-27 19:45:31,0.22677083333333334,5,314,14,328
2018-05-27 02:55:20,0.08324074074074074,1,16,4,20
2018-05-27 02:58:09,0.09376157407407408,1,26,0,26
2018-05-26 13:29:33,0.045625,1,4,0,4
2018-05-26 08:53:54,0.07850694444444445,1,2,3,5
2018-05-26 08:53:45,0.12574074074074074,3,67,15,82
2018-05-26 02:45:59,7.576944444444444,87,12598,12453,25051
2018-05-25 23:08:32,0.09907407407407408,1,2,0,2
2018-05-25 23:09:30,0.2297685185185185,1,5,0,5
2018-05-25 16:36:27,2.9568287037037035,3,313,341,654
2018-05-25 14:48:17,0.16394675925925925,1,1,1,2
2018-05-28 09:04:08,3.5529050925925927,16,254,217,471
2018-05-25 01:03:22,0.36248842592592595,1,1,1,2
2018-05-25 12:26:46,1.8980671296296296,1,1,1,2
2018-05-25 12:27:14,1.887025462962963,3,11,7,18
2018-05-25 16:36:47,2.498171296296296,1,22,26,48
2018-05-23 04:32:11,0.022453703703703705,1,9,4,13
2018-05-23 13:20:16,0.7818981481481482,2,12,8,20
2018-05-22 17:38:38,0.003935185185185185,1,0,1,1
2018-05-22 17:32:03,0.008703703703703703,1,1,11,12
2018-05-22 16:12:46,0.05315972222222222,1,2,1,3
2018-05-22 12:44:33,0.0121875,2,114,67,181
2018-05-22 12:45:11,0.026226851851851852,1,96,0,96
2018-05-22 12:44:53,0.03927083333333333,1,1,1,2
2018-05-22 09:06:54,0.05049768518518519,1,1,0,1
2018-05-22 11:24:55,0.19140046296296295,1,1,0,1
2018-05-22 11:26:07,0.20521990740740742,1,84,12,96
2018-05-21 21:12:36,0.021886574074074076,1,3,2,5
2018-05-22 13:26:43,1.0116550925925927,6,20,12,32
2018-05-21 15:49:11,0.021701388888888888,1,20,9,29
2018-05-21 15:33:20,0.027905092592592592,1,5,1,6
2018-05-21 14:26:01,0.009131944444444444,2,3,3,6
2018-05-21 14:04:02,0.005983796296296296,1,5,4,9
2018-05-21 14:01:17,0.017743055555555557,1,3,3,6
2018-05-21 14:00:57,0.018541666666666668,1,2,1,3
2018-05-21 11:40:49,0.17121527777777779,52,363,90,453
2018-05-21 10:43:05,0.3922569444444444,1,8,2,10
2018-05-21 01:35:38,0.01929398148148148,2,9,6,15
2018-07-14 23:18:10,55.03520833333334,1,7,2,9
2018-05-20 18:26:33,0.024074074074074074,3,28,25,53
2018-05-20 11:09:29,0.34565972222222224,1,1,1,2
2018-05-19 23:03:25,0.03771990740740741,1,5,2,7
2018-05-19 22:55:57,0.03695601851851852,1,5,2,7
2018-05-19 19:42:22,24.410972222222224,50,13556,12513,26069
2018-05-19 18:46:18,0.029074074074074075,2,24,13,37
2018-05-19 17:36:23,0.010219907407407407,1,1,1,2
2018-05-19 19:05:08,0.07288194444444444,2,76,4,80
2018-05-19 17:22:12,0.007372685185185185,1,8,6,14
2018-05-19 16:37:34,0.12871527777777778,1,10,2,12
2018-05-19 14:10:56,0.046435185185185184,1,9,1,10
2018-05-19 12:47:45,0.30452546296296296,1,2,2,4
2018-05-19 10:16:53,0.30135416666666665,1,1,0,1
2018-05-19 00:20:44,0.11621527777777778,1,9,3,12
2018-05-18 22:23:20,0.04085648148148148,2,12,3,15
2018-05-19 00:51:30,0.25472222222222224,1,5,0,5
2018-05-18 13:30:46,0.06791666666666667,1,1,1,2
2018-05-18 13:56:58,0.17525462962962962,1,5,1,6
2018-05-18 00:26:52,0.04497685185185185,5,66,17,83
2018-05-17 23:47:23,0.20417824074074073,3,9,8,17
2018-08-22 11:20:51,97.01515046296296,1,2,12,14
2018-05-18 09:33:57,1.3286111111111112,1,35,16,51
2018-05-17 02:03:28,0.018136574074074076,1,1,3,4
2018-05-17 02:26:52,0.03466435185185185,1,42,0,42
2018-05-17 11:00:56,0.3951851851851852,1,1,0,1
2018-05-18 00:32:36,0.963125,1,43,19,62
2018-05-19 12:46:48,2.5702546296296296,15,616,993,1609
2018-05-16 14:52:20,4.8626504629629625,1,3,3,6
2018-05-16 14:24:17,0.03328703703703704,1,15,26,41
2018-05-16 14:21:49,0.04631944444444445,1,6,6,12
2018-05-16 14:25:12,0.17092592592592593,5,352,75,427
2018-05-16 10:29:46,0.0627199074074074,1,12,0,12
2018-05-16 10:30:15,0.09532407407407407,1,7,9,16
2018-05-31 13:16:31,15.664131944444444,3,24,36,60
2018-05-16 12:47:30,0.6913773148148148,2,2,2,4
2018-05-15 19:42:32,0.05372685185185185,1,2,1,3
2018-05-16 14:18:33,0.8709606481481481,6,22,16,38
2018-05-15 18:15:08,0.03445601851851852,1,2,1,3
2018-05-15 18:14:31,0.036689814814814814,1,10,5,15
2018-05-15 14:03:35,0.015243055555555555,1,6,6,12
2018-05-16 02:59:45,0.6773842592592593,2,5,9,14
2018-05-15 12:24:51,0.055081018518518515,1,2,2,4
2018-05-15 12:25:08,4.636840277777778,55,15660,14975,30635
2018-05-15 16:20:40,0.2951388888888889,1,8,4,12
2018-05-28 22:43:48,13.771863425925925,1,30,3,33
2018-05-14 20:56:46,0.02877314814814815,1,1,1,2
2018-05-14 17:56:17,0.008101851851851851,1,16,3,19
2018-05-14 17:58:12,0.02861111111111111,1,23,21,44
2018-05-14 15:45:37,0.011597222222222222,1,6,3,9
2018-05-14 10:50:46,0.1827314814814815,1,14,2,16
2018-05-14 10:52:26,0.3789699074074074,1,3,1,4
2018-05-14 10:51:54,0.4,1,1,1,2
2018-05-13 19:45:19,0.02528935185185185,1,2,0,2
2018-05-13 19:07:32,0.025532407407407406,2,5,1,6
2018-05-13 18:26:31,0.028113425925925927,1,13,10,23
2018-05-13 11:48:15,0.011030092592592593,1,68,11,79
2018-05-13 09:32:47,0.20104166666666667,1,9,1,10
2018-07-13 23:47:10,61.84965277777778,1,2,0,2
2018-05-13 11:48:33,0.8809027777777778,1,3,1,4
2018-05-12 14:48:33,0.07305555555555555,1,13,8,21
2018-05-12 13:30:06,0.011261574074074075,1,33,127,160
2018-05-12 10:08:13,0.014537037037037038,1,3,3,6
2018-05-12 15:44:16,0.9474305555555556,3,63,28,91
2018-07-13 23:46:28,63.51902777777778,1,4,4,8
2018-05-11 09:51:07,0.12537037037037038,1,1,0,1
2018-05-11 09:49:13,0.4442013888888889,1,258,81,339
2018-06-04 12:49:11,25.00412037037037,2,5,1,6
2018-05-11 11:14:34,0.9666666666666667,2,75,4,79
2018-05-11 11:14:51,1.065775462962963,1,3,0,3
2018-05-10 12:48:27,4.023425925925926,107,11426,10613,22039
2018-05-10 12:38:41,0.30506944444444445,1,1,1,2
2018-05-10 12:38:20,0.35355324074074074,1,3,0,3
2018-05-10 12:36:13,0.4365625,1,6,5,11
2018-05-09 14:22:53,0.17034722222222223,1,70,23,93
2018-05-09 10:20:50,0.019050925925925926,1,10,8,18
2018-05-09 14:59:39,0.35130787037037037,1,2,2,4
2018-05-09 06:39:09,0.02232638888888889,1,1,1,2
2018-05-09 06:41:07,0.1316087962962963,1,89,23,112
2018-05-09 06:41:47,0.2495023148148148,1,33,0,33
2018-05-16 12:47:11,7.9135532407407405,3,5,5,10
2018-05-11 11:20:32,2.9845486111111112,1,4,4,8
2018-05-09 14:59:58,1.1539467592592592,2,10,8,18
2018-05-08 11:28:55,0.015856481481481482,1,2,0,2
2018-05-08 11:33:10,0.028125,1,26,3,29
2018-05-09 06:41:27,0.8335416666666666,1,43,0,43
2018-05-08 11:30:05,0.3635069444444444,1,10,1,11
2018-05-11 11:20:59,3.544421296296296,1,23,0,23
2018-05-08 01:37:00,0.16643518518518519,1,1,1,2
2018-05-08 11:35:34,0.8016087962962963,2,18,1,19
2018-05-07 12:49:14,0.023240740740740742,3,10,3,13
2018-06-04 02:46:15,27.75630787037037,1,1,6,7
2018-05-07 07:30:18,0.21195601851851853,1,2,2,4
2018-05-07 00:28:28,0.040671296296296296,3,4,1,5
2018-05-07 07:31:08,0.3775115740740741,3,49,7,56
2018-05-06 23:34:19,1.601875,9,46363,11549,57912
2018-05-07 07:30:54,0.38625,1,5,1,6
2018-05-07 07:30:39,0.39144675925925926,1,10,8,18
2018-05-06 20:26:40,0.026550925925925926,2,3,12,15
2018-05-06 11:19:57,2.9064699074074074,37,12430,10854,23284
2018-05-06 08:55:51,0.1884837962962963,2,49,15,64
2018-05-06 08:59:04,0.29410879629629627,3,251,4,255
2018-05-06 08:52:37,0.42516203703703703,1,7,3,10
2018-05-06 08:53:11,0.42258101851851854,1,4,4,8
2018-05-06 09:48:52,0.44581018518518517,1,43,27,70
2018-05-05 19:03:21,0.08289351851851852,1,6,6,12
2018-05-05 21:05:44,0.20293981481481482,1,10,2,12
2018-05-05 21:07:52,0.21472222222222223,1,2,2,4
2018-05-05 16:22:35,0.03633101851851852,2,8,0,8
2018-05-04 22:54:57,0.01943287037037037,1,1,1,2
2018-05-05 21:06:30,1.1608564814814815,5,77,446,523
2018-05-04 16:37:38,0.011574074074074073,1,2,1,3
2018-05-04 18:17:02,0.09318287037037037,1,32,28,60
2018-05-04 17:19:12,0.058680555555555555,1,50,12,62
2018-05-04 16:01:13,0.05255787037037037,1,4,0,4
2018-05-04 22:54:24,0.3561574074074074,2,4,4,8
2018-05-04 22:55:09,0.3586111111111111,1,47,49,96
2018-05-05 13:54:00,1.332476851851852,1,115,0,115
2018-05-04 04:58:09,0.12135416666666667,1,1,1,2
2018-05-05 19:11:20,1.7633101851851851,1,8,5,13
2018-05-04 11:26:26,0.4590856481481482,1,12,5,17
2018-05-04 11:22:24,0.46693287037037035,1,3,0,3
2018-05-03 20:32:05,0.03881944444444444,1,1,1,2
2018-05-06 18:38:17,3.058460648148148,3,16,16,32
2018-05-03 16:51:01,0.03365740740740741,1,1,1,2
2018-05-03 15:32:01,0.037453703703703704,1,4,0,4
2018-05-03 21:02:46,0.32060185185185186,3,30,14,44
2018-05-03 12:30:19,0.01255787037037037,1,0,0,0
2018-05-03 13:54:11,0.10168981481481482,2,307,1,308
2018-05-03 11:33:08,0.10328703703703704,2,7,7,14
2018-05-03 10:32:34,0.011261574074074075,4,2,2,4
2018-05-03 10:09:12,0.05449074074074074,1,11,2,13
2018-05-03 09:42:53,0.026724537037037036,1,2,2,4
2018-05-03 10:12:10,6.559652777777778,62,12703,11621,24324
2018-05-03 08:42:37,0.1282986111111111,1,95,0,95
2018-05-03 08:41:58,0.5527662037037037,1,74,20,94
2018-05-03 08:41:41,0.609837962962963,1,10,5,15
2018-05-02 20:28:47,2.316689814814815,1,57,18,75
2018-05-04 20:13:26,2.193483796296296,5,102,20,122
2018-05-02 20:10:57,0.1239699074074074,1,37,19,56
2018-05-03 08:42:19,0.7422453703703704,1,8,5,13
2018-05-02 14:08:17,0.07671296296296297,1,3,1,4
2018-05-02 14:14:52,0.12086805555555556,3,35,40,75
2018-05-03 10:08:55,1.0971527777777779,1,6,0,6
2018-05-02 12:13:53,0.18959490740740742,1,214,0,214
2018-05-02 10:40:25,1.344537037037037,4,48,29,77
2018-05-02 16:58:49,0.9109143518518519,6,787,474,1261
2018-05-01 12:02:05,0.058275462962962966,1,1,1,2
2018-04-30 20:49:33,0.11361111111111111,1,1,1,2
2018-05-02 13:45:24,1.8464699074074074,1,11,4,15
2018-04-30 11:14:50,0.9129976851851852,6,88,43,131
2018-04-30 07:12:55,0.2376736111111111,1,1,1,2
2018-04-30 07:13:15,0.27989583333333334,1,3,1,4
2018-05-02 13:57:37,2.565185185185185,1,7,1,8
2018-04-30 07:12:37,0.2927314814814815,1,5,0,5
2018-04-29 23:59:43,0.1643865740740741,2,18,14,32
2018-05-02 13:44:23,2.7438310185185184,1,5,0,5
2018-05-06 09:50:00,6.721307870370371,1,3,3,6
2018-04-28 09:20:31,0.255,1,2,2,4
2018-04-27 13:12:15,0.03474537037037037,1,4,0,4
2018-04-26 23:38:00,0.22652777777777777,2,27,14,41
2018-04-26 23:38:10,0.2356712962962963,2,49,11,60
2018-04-26 11:56:46,0.06375,1,2,0,2
2018-04-26 09:58:23,1.6572569444444445,24,11619,10647,22266
2018-04-25 22:36:53,1.252372685185185,4,1723,144,1867
2018-04-25 12:12:29,0.3449074074074074,1,76,76,152
2018-04-25 00:10:03,0.07872685185185185,4,232,11,243
2018-04-24 23:54:25,0.3062152777777778,2,2,2,4
2018-04-24 09:48:12,41.53826388888889,66,10995,8224,19219
2018-04-24 09:47:28,0.22101851851851853,1,1,1,2
2018-04-23 19:27:18,0.04797453703703704,1,22,2,24
2018-04-23 18:12:16,0.045439814814814815,1,2,0,2
2018-04-23 14:03:58,0.14070601851851852,1,1,1,2
2018-04-23 09:49:04,0.013368055555555555,1,13,11,24
2018-04-23 09:29:17,0.16813657407407406,20,173,179,352
2018-04-23 07:15:52,0.13896990740740742,1,120,95,215
2018-04-23 07:16:27,0.23126157407407408,1,40,15,55
2018-04-22 22:43:54,0.23195601851851852,1,11,4,15
2018-05-02 13:50:21,9.887326388888889,4,20,13,33
2018-04-23 07:16:39,0.7100462962962963,1,34,17,51
2018-04-22 13:42:01,0.019918981481481482,1,1,1,2
2018-04-22 12:29:41,0.055081018518518515,1,7,1,8
2018-04-22 09:41:39,0.010046296296296296,1,6,2,8
2018-04-22 22:43:37,0.9725115740740741,3,90,15,105
2018-04-22 09:49:17,0.48033564814814816,1,7,0,7
2018-04-21 21:37:08,0.02189814814814815,1,6,0,6
2018-04-21 19:56:40,0.0065625,1,2,2,4
2018-04-21 19:36:22,0.03809027777777778,1,4,5,9
2018-04-21 19:35:08,0.05564814814814815,1,176,176,352
2018-04-21 19:35:56,0.08289351851851852,1,187,140,327
2018-04-21 18:07:25,0.009131944444444444,1,1,1,2
2018-04-22 10:10:38,1.7106944444444445,1,0,1,1
2018-04-20 17:31:31,0.02982638888888889,1,12,0,12
2018-04-20 16:36:52,0.01628472222222222,1,6,0,6
2018-04-20 16:14:32,0.05900462962962963,1,6,2,8
2018-04-20 16:14:22,0.10564814814814814,3,26,14,40
2018-04-20 12:58:34,2.1481828703703703,3,187,80,267
2018-04-20 12:04:16,0.02454861111111111,1,5,13,18
2018-04-20 11:46:09,0.42063657407407407,1,169,60,229
2018-04-20 10:21:29,0.34802083333333333,1,11,0,11
2018-04-20 00:06:53,0.008055555555555555,1,5,4,9
2018-04-19 21:35:48,0.12126157407407408,2,7,2,9
2018-04-19 13:39:55,0.032789351851851854,1,11,12,23
2018-04-20 00:28:49,1.0231712962962962,8,491,360,851
2018-04-22 12:46:20,3.8029282407407408,2,1071,682,1753
2018-04-22 03:28:13,3.430335648148148,1,1,1,2
2018-04-18 22:53:32,0.25351851851851853,1,1,3,4
2018-04-19 00:36:32,0.3303009259259259,1,24,0,24
2018-04-18 15:14:22,0.009027777777777777,1,27,6,33
2018-04-18 14:50:20,0.08798611111111111,1,16,11,27
2018-04-18 11:15:58,0.08290509259259259,1,4,0,4
2018-04-18 05:28:26,0.797962962962963,6,78,15,93
2018-04-23 21:52:59,5.790775462962963,1,27,0,27
2018-04-18 01:34:00,0.05181712962962963,1,11,0,11
2018-04-17 11:49:10,0.0687037037037037,1,41,40,81
2018-04-17 11:50:34,0.2436574074074074,1,13,10,23
2018-04-17 02:37:52,0.024872685185185185,1,2,2,4
2018-04-17 11:52:09,0.45197916666666665,1,1,1,2
2018-04-17 11:51:01,0.5786689814814815,1,11,0,11
2018-04-17 11:51:15,0.5817939814814815,1,27,22,49
2018-05-04 19:14:35,17.905752314814816,1,64,13,77
2018-04-17 11:50:49,0.6208101851851852,1,1,1,2
2018-04-16 15:19:05,0.10015046296296297,1,3,3,6
2018-04-16 19:04:25,1.0809722222222222,4,15,23,38
2018-05-25 16:46:29,39.35715277777778,1,104,62,166
2018-04-16 09:34:35,0.019710648148148147,1,22,16,38
2018-04-23 17:27:36,18.22630787037037,1,146,22,168
2018-04-15 14:56:03,27.027951388888887,81,8412,5893,14305
2018-04-15 11:58:48,0.1511574074074074,2,2,2,4
2018-04-15 11:57:58,0.23113425925925926,1,2,2,4
2018-04-25 00:14:50,10.489849537037037,7,95,50,145
2018-04-15 05:12:42,0.6044907407407407,1,26,14,40
2018-04-17 12:58:12,3.0688425925925924,2,22,9,31
2018-04-18 14:52:16,4.917037037037037,12,1481,774,2255
2018-04-21 19:34:36,10.023067129629629,2,19,2,21
2019-11-13 22:02:11,582.0756481481482,12,735,24,759
2018-04-11 18:42:51,0.0447337962962963,1,17,5,22
2018-04-12 18:36:03,1.0649537037037038,1,32,1,33
2018-04-16 08:04:32,4.747997685185185,1,4,9,13
2018-04-11 10:35:10,0.07756944444444444,1,70,21,91
2018-04-12 23:20:05,2.341597222222222,1,24,13,37
2018-04-10 15:12:10,0.02730324074074074,1,39,38,77
2018-04-10 13:46:28,0.15864583333333335,1,29,1,30
2018-04-10 07:11:55,0.08846064814814815,1,3,2,5
2018-04-09 23:20:19,0.055914351851851854,1,4,0,4
2018-04-09 15:09:12,0.08877314814814814,4,48,9,57
2018-04-09 08:28:54,0.010543981481481482,1,78,0,78
2018-04-09 09:34:49,0.06458333333333334,1,0,0,0
2018-04-09 07:58:54,0.18434027777777778,1,4,12,16
2018-04-10 14:08:29,1.827002314814815,1,4,2,6
2018-04-08 16:25:09,0.08971064814814815,2,3,3,6
2018-04-10 07:16:07,1.840625,3,131,2,133
2018-04-08 12:26:59,0.13145833333333334,2,11,2,13
2018-04-08 07:57:16,0.18715277777777778,1,3,1,4
2018-04-07 19:36:04,0.02630787037037037,2,3,3,6
2018-04-07 19:33:02,0.0493287037037037,1,1,1,2
2018-04-07 12:53:12,0.02127314814814815,1,2,1,3
2018-04-08 11:32:39,1.2651851851851852,1,89,36,125
2018-04-17 21:25:55,10.77386574074074,3,10,10,20
2018-04-07 16:54:47,1.2450462962962963,2,28,10,38
2018-04-09 21:02:42,3.50125,1,1,1,2
2018-04-07 19:36:59,1.9802777777777778,1,16,5,21
2018-05-25 16:50:32,49.88622685185185,1,1,1,2
2018-04-13 11:11:26,8.370300925925926,9,1006,258,1264
2018-04-22 20:09:04,17.804375,1,0,10,10
2018-04-04 20:25:34,0.5351388888888889,1,49,15,64
2018-04-12 23:27:23,8.231180555555556,2,11,8,19
2018-04-08 11:40:23,3.8685069444444444,2,95,4,99
2018-04-04 18:13:44,2.089490740740741,2,24,2,26
2018-04-04 09:58:16,0.24121527777777776,1,75,98,173
2018-04-10 18:27:59,6.812511574074074,8,186,82,268
2018-04-03 19:09:15,0.11133101851851852,1,1,1,2
2018-04-11 19:40:39,8.28386574074074,3,75,8,83
2018-05-21 11:40:32,47.919699074074074,15,14994,5534,20528
2018-04-03 09:21:33,0.2707407407407407,3,57,21,78
2018-04-03 11:08:12,0.6028125,1,1,1,2
2018-04-03 11:07:32,0.4830671296296296,1,55,10,65
2018-04-02 12:51:03,0.05759259259259259,4,84,44,128
2018-04-02 11:43:31,13.894247685185185,47,15293,14133,29426
2018-04-02 10:49:07,0.030324074074074073,3,75,31,106
2018-04-02 10:11:38,0.03980324074074074,3,119,88,207
2018-04-15 12:00:33,13.13755787037037,4,3468,2238,5706
2018-04-02 20:04:15,0.6651967592592593,11,311,46,357
2018-04-02 11:44:20,0.38891203703703703,2,7,2,9
2018-04-02 11:45:07,0.3985648148148148,1,29,2,31
2018-04-02 00:10:54,0.06699074074074074,1,8,6,14
2018-04-02 17:19:52,0.7992592592592592,1,1,5,6
2018-04-02 00:09:51,0.08773148148148148,1,17,17,34
2018-04-01 20:19:43,0.08186342592592592,1,8,0,8
2018-04-01 12:57:27,0.02392361111111111,1,408,1,409
2018-04-01 08:31:38,0.03260416666666666,1,4,4,8
2018-04-03 23:11:27,2.9706597222222224,1,72,0,72
2018-03-31 12:09:39,0.33685185185185185,2,115,2,117
2018-03-31 11:16:39,0.05548611111111111,1,2,0,2
2018-03-31 11:17:26,16.24822916666667,1,34,3,37
2018-03-30 13:44:55,0.08369212962962963,2,8,2,10
2018-03-30 07:52:44,0.1190625,1,3,3,6
2018-03-30 01:04:05,0.032233796296296295,1,2,2,4
2018-04-01 21:43:09,2.9461226851851854,1,3,3,6
2018-03-29 17:08:35,0.18487268518518518,3,129,5,134
2018-03-29 12:57:03,0.22635416666666666,1,4,1,5
2018-03-29 10:59:13,0.20179398148148148,1,3,1,4
2018-03-28 22:52:25,0.15796296296296297,1,2,2,4
2018-03-28 18:40:52,9.205717592592592,1,98,75,173
2018-03-28 18:40:18,0.611574074074074,1,4,0,4
2018-10-25 16:13:20,211.95851851851853,1,10,2,12
2018-03-27 14:53:53,0.013425925925925926,1,1,1,2
2018-03-27 13:18:36,0.023194444444444445,1,2,2,4
2018-03-27 11:06:00,0.01318287037037037,1,2,2,4
2018-03-27 03:22:59,0.015821759259259258,1,33,0,33
2018-03-27 02:33:58,0.15958333333333333,1,21,3,24
2018-03-26 10:47:34,0.12758101851851852,1,4,0,4
2018-03-26 10:48:02,0.20574074074074075,1,5,1,6
2018-03-27 10:30:28,1.258935185185185,1,15,2,17
2018-03-26 11:59:22,0.34828703703703706,2,27,29,56
2018-03-26 11:59:45,0.7703240740740741,1,1,1,2
2018-03-25 14:33:07,0.1005324074074074,1,16,3,19
2018-03-27 10:32:30,2.17125,1,189,103,292
2018-03-26 12:02:11,1.9126851851851852,1,115,26,141
2018-03-24 12:36:45,0.010081018518518519,1,3,3,6
2018-03-24 11:49:55,0.04508101851851852,1,138,131,269
2018-03-24 09:54:19,0.1485300925925926,1,109,5,114
2018-03-24 21:07:24,0.7465625,1,82,114,196
2018-03-24 14:25:16,2.5625,1,191,259,450
2018-03-24 11:51:51,1.0896064814814814,1,4,4,8
2018-03-24 00:04:03,4.4085069444444445,13,4165,4107,8272
2018-03-24 11:50:15,1.518113425925926,3,3,2,5
2018-03-23 09:52:26,0.7659375,5,62,27,89
2018-03-22 10:30:23,0.03259259259259259,1,1,1,2
2018-03-22 09:45:49,0.012939814814814815,1,1,1,2
2018-03-22 08:33:15,0.5755671296296296,1,3,1,4
2018-03-22 10:31:18,0.6810879629629629,1,2,2,4
2018-03-21 16:43:29,0.05844907407407408,1,7,7,14
2018-03-21 09:26:16,0.15193287037037037,1,0,1,1
2018-03-20 18:41:51,0.09260416666666667,1,43,36,79
2018-03-21 09:26:53,0.7151388888888889,2,19,3,22
2018-03-20 15:36:20,0.042199074074074076,1,3,5,8
2018-03-20 13:57:47,0.06333333333333334,1,1,1,2
2018-03-20 11:40:13,0.6619097222222222,1,12,0,12
2018-03-19 19:19:36,0.042847222222222224,1,7,3,10
2018-03-19 19:07:48,0.07006944444444445,1,2,2,4
2018-03-19 19:09:26,0.10005787037037037,1,3,3,6
2018-03-19 19:12:21,0.14418981481481483,1,10,0,10
2018-03-19 19:08:56,4.091168981481482,3,30,24,54
2018-03-19 14:12:07,6.1400347222222225,31,7649,7131,14780
2018-03-24 12:06:27,5.2599074074074075,1,433,355,788
2018-03-19 00:51:20,0.2989699074074074,1,2,2,4
2018-03-18 19:32:45,0.11435185185185186,1,4,1,5
2018-03-18 19:33:07,0.16729166666666667,1,45,6,51
2018-03-18 15:57:05,0.060891203703703704,1,5,1,6
2018-03-18 14:14:38,0.26092592592592595,1,26,6,32
2018-03-20 08:06:09,2.272685185185185,6,29,13,42
2018-03-17 16:39:29,0.04454861111111111,1,1,1,2
2018-03-17 14:28:10,0.0002662037037037037,1,2,0,2
2018-03-24 11:52:46,6.938715277777778,1,21,15,36
2018-03-17 13:20:35,0.002800925925925926,5,15,21,36
2018-03-17 13:06:26,0.0045138888888888885,1,10,3,13
2018-03-17 11:35:14,0.026875,1,21,1,22
2018-03-24 11:52:27,8.162743055555556,1,178,116,294
2018-03-17 12:27:20,0.3279050925925926,1,1,1,2
2018-03-17 07:39:14,0.15351851851851853,1,3,3,6
2018-04-08 11:43:11,24.068217592592593,6,60,31,91
2018-03-17 11:35:36,2.3490972222222224,1,1,0,1
2018-03-17 12:27:51,3.709953703703704,1,1,1,2
2018-03-13 17:17:49,0.02068287037037037,1,4,4,8
2018-03-13 15:16:52,0.185,18,7233,6795,14028
2018-03-13 13:30:02,0.11215277777777778,1,18,0,18
2018-03-13 08:18:44,0.055914351851851854,1,83,41,124
2018-03-13 07:10:13,0.013113425925925926,1,83,41,124
2018-03-13 07:15:25,0.043506944444444445,1,10,1,11
2018-03-13 07:14:08,0.04664351851851852,1,18,2,20
2018-03-13 06:16:44,0.014560185185185185,1,13,9,22
2018-03-13 05:07:02,0.1692013888888889,1,1,1,2
2018-03-24 11:51:29,11.355902777777779,1,23,17,40
2018-03-13 05:06:14,0.08043981481481481,1,1,1,2
2018-03-12 20:41:27,0.22480324074074073,3,47,26,73
2018-03-12 15:21:49,0.06269675925925926,1,1,1,2
2018-03-17 11:37:59,5.078576388888889,1,21,15,36
2018-03-12 11:47:18,0.16524305555555555,1,7,3,10
2018-03-12 11:47:52,0.23600694444444445,1,9,5,14
2018-03-12 02:52:05,1.0608564814814814,1,24,24,48
2018-03-12 02:50:41,0.32108796296296294,1,3,3,6
2018-03-12 02:20:57,0.4079861111111111,1,1,1,2
2018-03-11 15:21:17,0.01778935185185185,1,84,2,86
2018-03-11 15:21:26,2.1619560185185187,18,3925,3850,7775
2018-03-11 13:55:50,0.013680555555555555,1,2,2,4
2018-03-11 14:12:34,0.05357638888888889,2,23,62,85
2018-03-11 08:52:59,0.46306712962962965,1,120,25,145
2018-03-10 16:56:31,0.013043981481481481,1,3,3,6
2018-03-10 16:44:26,0.05804398148148148,1,7,1,8
2018-03-11 13:55:39,0.9864120370370371,1,0,0,0
2018-03-10 10:49:05,0.05524305555555555,1,2,9,11
2018-03-10 10:42:28,0.07769675925925926,1,0,1,1
2018-03-10 10:42:42,0.21296296296296297,1,0,1,1
2018-03-10 10:43:20,0.4582175925925926,1,1,1,2
2018-03-09 10:52:18,0.01457175925925926,1,8,0,8
2018-03-09 10:32:55,0.011446759259259259,1,1,1,2
2018-03-09 10:33:06,0.015358796296296296,1,6,4,10
2018-03-09 09:38:14,1.0964583333333333,26,11763,10831,22594
2018-03-09 09:57:34,0.20475694444444445,1,36,36,72
2018-03-08 23:35:08,0.02207175925925926,1,37,16,53
2018-03-09 05:21:48,0.16311342592592593,1,12,12,24
2018-03-08 12:07:25,0.019872685185185184,1,7,0,7
2018-03-08 10:10:38,0.09383101851851852,2,42,18,60
2018-03-08 10:18:26,0.14373842592592592,1,10,3,13
2018-03-08 07:22:05,0.025798611111111112,1,20,12,32
2018-03-08 07:57:22,0.05787037037037037,1,45,8,53
2018-03-08 07:20:49,0.04710648148148148,1,1,0,1
2018-03-08 05:59:35,2.496724537037037,20,6391,6016,12407
2018-03-08 06:09:11,0.10233796296296296,1,2,2,4
2018-03-08 03:43:57,0.09071759259259259,1,130,4,134
2018-03-09 12:11:44,1.9137268518518518,4,962,512,1474
2018-03-08 00:22:47,0.45121527777777776,6,17,31,48
2018-03-08 03:54:27,0.7082638888888889,1,69,33,102
2018-03-08 05:59:42,0.8154976851851852,1,30,15,45
2018-03-07 11:02:06,0.03947916666666667,1,8,0,8
2018-03-07 11:01:54,0.10496527777777778,1,2,2,4
2018-03-07 07:59:27,0.03262731481481482,1,18,9,27
2018-03-07 07:28:53,0.021458333333333333,1,28,18,46
2018-03-07 06:12:02,0.0109375,1,1,1,2
2018-03-07 05:19:10,0.01633101851851852,1,7,2,9
2018-03-07 04:58:25,0.0825462962962963,1,2,2,4
2018-04-04 19:47:39,28.7271875,8,61,1378,1439
2018-03-07 02:54:47,0.0715625,1,4,4,8
2018-03-07 01:25:18,0.013506944444444445,1,3,3,6
2018-03-07 00:57:31,0.0017824074074074075,1,7,5,12
2018-03-07 00:39:41,0.5151736111111112,7,813,318,1131
2018-03-06 20:59:36,0.007083333333333333,1,110,16,126
2018-03-06 20:36:47,0.28197916666666667,1,3,5,8
2018-07-14 01:56:42,129.8936111111111,1,2709,1737,4446
2018-03-06 06:28:27,0.033449074074074076,1,4,4,8
2018-03-06 06:28:06,0.035694444444444445,1,5,7,12
2018-03-06 05:29:02,0.03673611111111111,1,6,2,8
2018-03-06 06:45:32,0.09701388888888889,1,93,70,163
2018-03-06 05:14:27,0.029363425925925925,1,6,11,17
2018-03-07 01:26:44,1.3584953703703704,3,345,199,544
2018-04-14 10:41:09,39.55971064814815,6,322,55,377
2018-03-05 23:08:35,0.07849537037037037,1,1,1,2
2018-03-05 18:28:57,0.1103587962962963,1,23,12,35
2018-03-05 15:27:51,3.4340972222222224,35,8911,7737,16648
2018-03-05 14:12:18,0.022685185185185187,1,160,36,196
2018-03-05 15:45:10,0.10288194444444444,1,3,1,4
2018-03-05 15:45:37,0.2894675925925926,1,2,0,2
2018-03-05 18:29:37,0.46038194444444447,1,11,7,18
2018-03-05 07:05:52,0.028958333333333332,1,4,0,4
2018-05-21 10:43:38,77.20372685185185,1,205,35,240
2018-03-30 10:38:01,25.554641203703703,5,271,17,288
2018-03-05 04:09:36,0.4505324074074074,3,33,0,33
2018-03-04 19:29:50,0.23076388888888888,1,1,7,8
2018-03-04 19:27:41,0.2725462962962963,1,0,4,4
2018-03-04 19:27:26,0.29912037037037037,1,95,7,102
2018-03-04 19:29:12,0.4144675925925926,1,60,11,71
2018-03-04 09:00:46,0.019988425925925927,1,3,5,8
2018-03-04 19:28:24,0.46207175925925925,1,7,2,9
2018-03-04 09:00:25,0.032685185185185185,1,1,1,2
2018-03-05 18:31:41,1.4402314814814814,1,16,18,34
2018-03-04 07:55:16,0.02582175925925926,1,7,0,7
2018-03-04 08:19:11,0.23443287037037036,8,402,56,458
2018-03-04 06:21:42,0.35997685185185185,1,36,2,38
2018-03-03 16:53:56,0.009918981481481482,1,43,9,52
2018-03-03 18:45:07,0.4908564814814815,1,3,1,4
2018-03-02 18:02:51,0.15219907407407407,1,2,2,4
2018-03-02 18:03:22,0.2962037037037037,1,1,0,1
2018-03-02 06:12:41,0.056053240740740744,2,39,8,47
2018-03-02 05:02:43,0.04027777777777778,2,6,3,9
2018-03-02 07:14:35,0.1493287037037037,1,10,0,10
2018-03-02 03:36:01,0.01758101851851852,1,9,1,10
2018-03-02 06:00:05,0.12789351851851852,3,33,11,44
2018-03-02 03:35:50,0.04449074074074074,1,8,6,14
2018-03-02 03:36:16,31.865659722222222,125,10244,7241,17485
2018-03-02 01:32:09,0.02396990740740741,1,5,5,10
2018-03-01 22:30:07,0.029583333333333333,1,4,2,6
2018-03-11 14:12:24,9.74119212962963,2,11,1,12
2018-03-01 22:48:18,0.3202083333333333,2,337,11,348
2018-03-04 08:21:35,265.9347569444444,1,27,50,77
2018-03-01 09:26:52,0.022893518518518518,1,5,0,5
2018-03-01 02:21:22,0.01810185185185185,1,20,4,24
2018-03-01 01:47:59,0.04769675925925926,1,13,17,30
2018-03-01 19:48:12,6.761597222222222,1,10,1,11
2018-03-01 01:48:08,0.19188657407407408,1,8,6,14
2018-03-01 01:48:45,0.09472222222222222,3,105,58,163
2018-02-28 05:55:07,0.03925925925925926,1,2,0,2
2018-02-28 05:54:55,0.15121527777777777,4,312,28,340
2018-02-27 04:48:11,0.015416666666666667,1,1,1,2
2018-02-26 21:01:50,0.05209490740740741,2,8,4,12
2018-02-26 15:20:47,0.12226851851851851,1,2,1,3
2018-02-26 15:19:48,0.2374074074074074,1,0,5,5
2018-02-26 15:18:42,0.7584606481481482,1,73,51,124
2018-02-25 23:24:55,0.12181712962962964,1,1,1,2
2018-02-26 00:31:45,0.1761574074074074,2,4,5,9
2018-02-28 18:04:54,3.0036111111111112,1,117,13,130
2018-02-24 16:27:04,0.17293981481481482,2,21,1,22
2018-02-27 00:52:28,3.3153935185185186,2,2,2,4
2018-02-26 16:43:46,3.19744212962963,4,621,355,976
2018-02-26 15:19:08,3.1386689814814814,3,264,137,401
2018-02-24 18:10:58,1.5653935185185186,1,5,6,11
2018-02-23 00:16:18,0.05712962962962963,2,48,6,54
2018-02-22 22:31:42,0.017361111111111112,1,14,0,14
2018-02-22 22:31:25,0.10975694444444445,1,10,2,12
2018-02-22 16:42:34,0.0003125,1,1,1,2
2018-02-22 02:04:28,0.007326388888888889,3,3,3,6
2018-02-22 01:47:17,0.027407407407407408,1,1,1,2
2018-02-21 23:28:19,0.0007291666666666667,1,3,3,6
2018-02-21 23:51:31,0.024652777777777777,1,1,1,2
2018-02-21 22:22:13,0.010763888888888889,1,24,2,26
2018-02-21 18:33:24,0.12215277777777778,1,3,3,6
2018-02-21 15:30:47,0.3645949074074074,1,2,0,2
2018-02-21 23:35:46,0.8567361111111111,6,366,89,455
2018-02-20 18:11:36,0.001990740740740741,1,1,1,2
2018-02-22 22:41:21,2.491712962962963,2,6,2,8
2018-02-20 15:50:13,0.22594907407407408,1,8,1,9
2018-02-21 02:40:13,1.0422106481481481,2,73,34,107
2018-02-20 16:25:02,8.65769675925926,3,20,29,49
2018-02-20 16:25:16,0.6825347222222222,1,1,0,1
2018-02-19 15:06:12,0.5742824074074074,1,18,6,24
2018-02-19 01:39:19,0.022337962962962962,1,24,22,46
2018-02-18 21:57:54,0.014953703703703703,1,1,1,2
2018-02-18 15:32:59,0.026585648148148146,1,1,0,1
2018-02-18 15:34:04,11.085462962962962,8,1482,328,1810
2018-02-18 15:32:17,0.13462962962962963,1,0,2,2
2018-02-26 02:31:29,7.851828703703704,8,73,37,110
2018-02-24 04:40:18,6.8639930555555555,1,45,7,52
2018-02-17 13:27:52,0.32307870370370373,1,1,1,2
2018-02-22 00:03:49,4.841145833333333,6,604,357,961
2018-02-17 13:28:49,0.6522337962962963,1,8,2,10
2018-02-16 16:10:01,0.1908101851851852,1,1,1,2
2018-02-18 02:14:47,1.8687847222222222,3,98,18,116
2018-02-16 06:22:21,0.0874537037037037,3,155,48,203
2018-02-15 22:05:12,0.03688657407407407,1,24,1,25
2018-02-16 03:40:54,0.8874652777777777,1,2,5,7
2018-02-15 03:40:43,0.05915509259259259,1,8,8,16
2018-02-16 18:15:56,1.9744444444444444,1,1,1,2
2018-02-16 18:53:38,2.000046296296296,1,1,1,2
2018-02-15 06:04:29,2.080277777777778,1,150,79,229
2018-02-13 22:55:46,0.059166666666666666,1,15,5,20
2018-02-11 22:49:18,0.040671296296296296,1,11,1,12
2018-02-11 21:59:45,0.022268518518518517,1,2,1,3
2018-02-21 22:21:32,10.837465277777778,8,426,59,485
2018-02-10 16:09:44,0.029976851851851852,2,12,12,24
2018-02-10 16:10:58,3.111087962962963,7,541,118,659
2018-02-10 02:31:39,2.5421180555555556,5,463,118,581
2018-02-09 14:29:49,0.20526620370370371,1,13,13,26
2018-02-11 17:40:58,5.578414351851852,4,483,91,574
2018-02-17 21:35:06,8.786655092592593,1,17,14,31
2018-02-08 23:26:57,0.1659375,1,38,26,64
2018-02-08 23:27:19,0.20065972222222223,1,4,4,8
2018-02-08 23:12:35,1.403877314814815,3,89,8,97
2018-02-08 14:33:23,0.31453703703703706,1,2,1,3
2018-02-08 04:00:46,0.08556712962962963,1,19,3,22
2018-02-07 23:17:53,0.4075578703703704,1,20,0,20
2018-02-07 15:35:45,1.1759259259259258,1,11,5,16
2018-02-05 01:44:14,0.06311342592592592,1,1,1,2
2018-02-04 11:32:41,0.1267361111111111,1,2,0,2
2018-02-04 11:31:47,0.1441087962962963,1,3,3,6
2018-02-04 11:32:11,0.16125,1,1,1,2
2018-02-04 04:42:14,260.52543981481483,14,88704,27698,116402
2018-02-09 22:04:47,5.974861111111111,9,318,93,411
2018-02-04 05:03:02,0.49310185185185185,2,2,1,3
2018-02-03 17:41:01,0.13453703703703704,1,1,1,2
2018-02-03 17:41:52,0.9179513888888889,1,2,11,13
2018-02-04 14:05:54,1.6320949074074074,2,408,37,445
2018-02-02 12:31:29,0.014351851851851852,1,1,1,2
2018-02-24 18:16:11,22.255092592592593,1,69,9,78
2018-02-02 10:58:00,0.035798611111111114,1,5,5,10
2018-02-02 09:10:19,0.12224537037037037,1,1,1,2
2018-02-01 16:17:18,0.2783449074074074,1,7,16,23
2018-02-01 16:54:22,0.3390856481481481,1,3,3,6
2018-01-31 22:33:54,0.10445601851851852,1,81,51,132
2018-01-31 20:52:59,0.04546296296296296,1,1,1,2
2018-02-02 09:32:22,3.249791666666667,1,19,45,64
2018-02-02 09:32:42,3.259351851851852,1,6,2,8
2018-01-29 00:11:00,0.05383101851851852,1,1,1,2
2018-01-28 23:22:21,0.021770833333333333,1,15,4,19
2018-01-29 00:06:40,0.06184027777777778,1,2,2,4
2018-01-28 13:48:10,5.767361111111111,120,26241,21717,47958
2018-02-03 17:44:23,6.404444444444445,1,18,0,18
2018-01-26 23:51:03,0.17857638888888888,3,14,11,25
2018-03-08 01:25:11,41.5706712962963,5,15,11,26
2018-01-25 03:23:09,0.0724074074074074,1,1,1,2
2018-01-25 03:23:30,0.07583333333333334,1,0,1,1
2018-01-24 13:37:47,0.033761574074074076,1,4,5,9
2018-01-24 12:29:32,0.045439814814814815,1,1,0,1
2018-01-24 12:29:47,0.07354166666666667,1,4,4,8
2018-01-24 12:29:04,0.8030555555555555,8,106,59,165
2018-04-17 13:23:47,83.33421296296297,2,19228,6854,26082
2018-01-24 03:03:51,0.03606481481481481,3,15,13,28
2018-01-23 19:52:31,0.10300925925925926,1,22,19,41
2018-01-23 13:31:32,0.19633101851851853,1,4,1,5
2018-01-23 13:30:43,0.3734722222222222,1,14,14,28
2018-01-23 13:30:29,0.3846527777777778,1,0,0,0
2018-01-24 01:57:14,0.9288773148148148,1,13,8,21
2018-01-23 04:06:30,0.042604166666666665,1,1,3,4
2018-01-22 13:24:23,0.048622685185185185,1,12,12,24
2018-01-22 13:25:10,0.05427083333333333,1,26,26,52
2018-03-24 11:50:42,61.95515046296296,1,14,5,19
2018-01-22 13:22:15,0.07856481481481481,1,1,1,2
2018-01-22 13:20:59,4.244965277777778,47,10628,9373,20001
2018-01-21 23:49:57,0.00866898148148148,1,19,0,19
2018-01-21 20:02:24,0.02908564814814815,4,529,264,793
2018-01-21 12:22:31,0.052939814814814815,1,1,1,2
2018-01-21 12:23:17,0.10952546296296296,1,1,1,2
2018-01-21 12:21:29,0.291875,1,13,1,14
2018-01-21 12:20:21,0.45872685185185186,1,50,5,55
2018-01-21 12:20:01,0.4915393518518518,1,1,1,2
2018-01-20 18:27:14,0.1287037037037037,2,2,2,4
2018-01-20 15:11:21,2.2911111111111113,8,664,864,1528
2018-01-20 02:49:07,0.09622685185185186,1,1,1,2
2018-01-20 00:32:37,0.1983449074074074,3,741,66,807
2018-01-19 20:48:00,0.06194444444444445,1,1,1,2
2018-01-20 00:32:22,0.2393287037037037,4,56,24,80
2018-01-19 18:11:20,0.0853587962962963,1,1,0,1
2018-01-19 18:11:36,0.0972800925925926,1,3,2,5
2018-01-19 14:49:48,0.05920138888888889,1,1,1,2
2018-01-19 12:49:25,0.010474537037037037,1,19,0,19
2018-02-04 05:00:11,16.383217592592594,5,124,13,137
2018-01-20 00:32:05,1.2140162037037037,2,51,657,708
2018-01-18 19:29:57,0.05215277777777778,2,16,1,17
2018-01-19 14:25:28,1.4712731481481482,3,9,10,19
2018-01-17 22:00:23,8.308935185185184,35,7131,6110,13241
2018-01-18 15:12:11,0.8419212962962963,2,17,8,25
2018-01-17 15:47:25,1.4480208333333333,7,466,27,493
2018-01-17 11:41:24,0.23479166666666668,2,6,5,11
2018-01-17 16:08:11,0.44114583333333335,4,429,18,447
2018-01-17 11:42:11,5.494699074074074,2,38,26,64
2018-01-17 15:57:16,3.312962962962963,1,409,386,795
2018-01-17 11:45:10,0.5393287037037037,1,1,1,2
2018-01-18 18:17:25,1.9414814814814816,4,261,632,893
2018-01-17 13:12:59,0.7354513888888888,1,5,7,12
2018-01-16 05:44:58,0.00787037037037037,1,1,1,2
2018-01-16 05:15:28,0.004884259259259259,1,3,0,3
2018-01-16 05:26:46,0.019918981481481482,1,9,7,16
2018-01-16 19:20:16,0.6073379629629629,3,432,27,459
2018-01-15 17:42:15,0.508425925925926,1,2,2,4
2018-01-15 17:55:10,0.5208217592592592,2,13,11,24
2018-01-16 02:29:12,1.2933101851851851,1,848,706,1554
2018-01-15 03:34:29,1.9725925925925927,1,36,10,46
2018-01-17 22:56:04,4.846423611111111,5,206,68,274
2018-01-15 05:50:29,3.2699652777777777,1,2,0,2
2018-01-12 01:44:28,0.10299768518518519,2,2,2,4
2018-01-15 05:51:01,41.00349537037037,13,12295,2697,14992
2018-01-15 05:51:24,3.8650231481481483,1,4,0,4
2018-01-15 05:51:46,4.23900462962963,1,1,1,2
2018-02-02 09:22:16,22.927407407407408,1,3,2,5
2018-01-09 18:34:59,0.08776620370370371,1,1,1,2
2018-01-09 18:35:12,0.13694444444444445,2,8,1,9
2018-01-09 16:07:55,0.0869675925925926,1,1,1,2
2018-01-09 11:30:29,30.7421875,83,10692,7308,18000
2018-01-09 13:59:20,0.20287037037037037,2,147,4,151
2018-01-08 23:47:44,0.06888888888888889,1,2,0,2
2018-02-02 09:20:00,24.603391203703705,1,15,1,16
2018-01-08 19:01:34,0.5609953703703704,1,21,13,34
2018-01-08 02:50:54,0.08548611111111111,1,1,1,2
2018-01-08 09:57:52,0.3858333333333333,1,31,138,169
2018-01-08 04:00:24,0.3148611111111111,4,68,30,98
2018-01-07 23:21:15,0.0895486111111111,1,2,2,4
2018-01-07 08:32:51,0.07546296296296297,5,64,9,73
2018-01-07 14:13:00,0.3469097222222222,1,2,2,4
2018-01-07 02:13:43,0.02883101851851852,1,7,7,14
2018-02-02 09:54:05,26.751516203703705,1,5,0,5
2018-01-09 14:00:20,1.3796412037037038,1,12,2,14
2018-01-07 14:19:24,1.621875,1,10,14,24
2018-01-05 22:04:35,0.041840277777777775,1,1,1,2
2018-01-15 03:33:06,10.463657407407407,3,23,13,36
2018-01-05 21:38:34,0.09649305555555555,1,3,3,6
2018-01-05 21:42:51,0.07023148148148148,1,2,0,2
2018-01-05 09:59:43,0.031180555555555555,12,63,8,71
2018-01-05 03:43:51,0.11060185185185185,1,3,1,4
2018-01-04 23:16:06,0.028287037037037038,1,33,30,63
2018-01-04 23:15:36,0.07202546296296296,1,42,14,56
2018-01-04 18:38:46,0.03795138888888889,1,6,4,10
2018-01-04 18:38:30,0.04752314814814815,1,4,2,6
2018-01-05 19:04:23,1.0884375,1,2,2,4
2018-01-04 14:36:56,0.03537037037037037,1,6,1,7
2018-01-04 14:15:29,0.028460648148148148,1,2,0,2
2018-01-04 13:39:39,0.18914351851851852,1,4,3,7
2018-01-04 01:56:01,0.22420138888888888,1,1,3,4
2018-01-04 01:56:23,0.24519675925925927,1,1,1,2
2018-01-04 13:40:50,0.7448611111111111,1,35,37,72
2018-01-04 00:21:38,0.2127199074074074,1,49,33,82
2018-01-04 03:56:05,0.3908101851851852,1,5,3,8
2018-01-03 20:05:55,0.11418981481481481,3,14,4,18
2018-01-03 13:45:25,0.044131944444444446,1,72,7,79
2018-01-03 12:00:40,0.15008101851851852,8,456,217,673
2018-01-04 04:00:51,0.8381018518518518,2,54,22,76
2018-01-04 15:40:26,1.4992824074074074,1,1,1,2
2018-01-03 03:39:15,0.07571759259259259,1,5,0,5
2018-01-03 02:54:08,0.28194444444444444,3,5,5,10
2018-01-02 23:38:21,0.06930555555555555,2,2,2,4
2018-01-02 23:38:02,0.07546296296296297,1,1,0,1
2018-01-02 18:35:25,0.0225,1,1,1,2
2018-04-17 21:35:46,9.362916666666667,2,9,1,10
2018-01-02 13:02:53,0.01902777777777778,1,1,1,2
2018-01-02 11:39:12,1.0209837962962962,1,1321,18,1339
2018-02-02 10:56:51,32.17021990740741,1,16,6,22
2018-01-03 19:51:33,4.132731481481481,2,12,12,24
2017-12-31 08:28:21,2.9175810185185185,2,1332,29,1361
2018-01-02 13:24:53,2.9106134259259258,1,8,1,9
2017-12-30 01:44:20,0.08126157407407407,1,8,0,8
2018-01-02 04:07:56,3.643587962962963,1,34,2,36
2018-01-04 01:56:55,5.805798611111111,1,8,10,18
2017-12-29 18:52:04,0.8763773148148148,5,150,14,164
2018-04-01 21:55:42,95.14831018518518,2,158,5,163
2017-12-28 15:20:35,0.15430555555555556,1,2,2,4
2018-01-03 03:57:58,6.406134259259259,2,8,1,9
2017-12-30 01:43:43,2.2794328703703703,1,25,15,40
2017-12-26 17:43:52,0.14449074074074075,1,3,1,4
2017-12-27 02:31:31,0.585625,1,19,22,41
2017-12-26 16:56:32,0.2587615740740741,1,9,2,11
2018-01-02 04:28:50,6.878159722222223,1,7,7,14
2018-01-02 12:50:54,7.231446759259259,1,15,15,30
2017-12-27 02:29:50,0.9060300925925926,1,15,3,18
2017-12-27 17:21:13,1.8477662037037037,2,10,2,12
2017-12-25 19:56:05,3.8155092592592594,4,415,247,662
2017-12-25 15:14:06,0.022743055555555555,1,2,2,4
2018-01-19 19:53:31,25.25380787037037,1,11,11,22
2017-12-25 14:02:08,0.03673611111111111,1,3,0,3
2017-12-24 08:18:46,19.106099537037036,8,6306,2021,8327
2017-12-23 23:53:04,0.40850694444444446,1,2,0,2
2017-12-24 15:14:34,2.481388888888889,2,80,7,87
2017-12-24 03:47:02,2.1425578703703705,2,18,16,34
2017-12-22 01:14:18,0.3417939814814815,1,4,1,5
2017-12-22 01:15:09,1.3903356481481481,1,15,9,24
2018-01-02 15:55:00,13.898483796296297,2,119,11,130
2018-01-02 12:38:13,14.129953703703704,3,4,5,9
2017-12-22 01:17:59,4.131435185185185,3,6,4,10
2017-12-17 02:26:43,0.34686342592592595,2,701,81,782
2017-12-20 02:45:51,3.502511574074074,3,161,68,229
2017-12-20 02:46:26,14.8753125,6,5242,1712,6954
2017-12-24 03:47:36,7.673657407407408,2,213,199,412
2017-12-20 07:19:59,3.8394097222222223,1,21,21,42
2017-12-15 20:38:25,0.027858796296296295,1,1,1,2
2018-05-19 12:45:58,154.86032407407407,1,0,7,7
2017-12-15 00:54:06,0.035416666666666666,1,1,1,2
2017-12-14 22:31:15,0.27425925925925926,1,1,1,2
2017-12-14 20:35:31,0.20087962962962963,1,7,4,11
2017-12-14 17:45:33,0.24600694444444443,8,919,916,1835
2017-12-14 18:33:29,1.1290972222222222,8,66,66,132
2017-12-13 22:36:30,0.04892361111111111,1,4,0,4
2017-12-13 21:58:21,0.057256944444444444,1,2,2,4
2017-12-13 19:33:04,0.009837962962962963,1,5,4,9
2017-12-13 18:17:04,0.02474537037037037,4,9,4,13
2017-12-13 21:58:32,0.24983796296296296,2,4,3,7
2017-12-13 17:01:56,0.05842592592592592,2,3,3,6
2017-12-13 17:28:13,0.05267361111111111,1,23,8,31
2017-12-13 17:00:43,0.0512962962962963,1,3,3,6
2017-12-13 15:37:16,4.011226851851852,35,6878,6496,13374
2017-12-13 13:27:37,0.005381944444444444,1,1,0,1
2017-12-13 12:42:17,0.009224537037037036,1,1,1,2
2017-12-13 11:17:38,0.027337962962962963,1,6,2,8
2017-12-13 14:52:41,0.4183101851851852,6,130,83,213
2017-12-13 11:15:11,0.4391435185185185,2,17,20,37
2017-12-13 12:28:32,0.5099768518518518,2,134,87,221
2017-12-13 11:15:28,0.47280092592592593,1,45,32,77
2017-12-13 06:42:22,0.3094675925925926,1,1,1,2
2017-12-13 11:14:04,0.49940972222222224,1,13,5,18
2017-12-13 03:12:39,0.1729513888888889,2,2,2,4
2017-12-13 01:12:42,0.09337962962962963,1,17,15,32
2017-12-13 01:40:33,0.12258101851851852,1,2,2,4
2017-12-12 19:48:26,0.01699074074074074,1,2,1,3
2017-12-12 18:57:22,7.549571759259259,3,4394,1113,5507
2017-12-12 14:13:47,1.2177314814814815,3,3,2,5
2017-12-12 16:38:43,0.23689814814814814,1,7,3,10
2017-12-12 14:10:12,0.1971875,1,0,0,0
2017-12-12 14:12:09,0.21158564814814815,1,1,0,1
2017-12-12 14:11:13,0.21890046296296295,2,2,2,4
2017-12-12 14:54:39,0.48640046296296297,1,1,0,1
2017-12-12 02:56:31,0.04925925925925926,1,4,0,4
2017-12-12 01:14:34,0.05516203703703704,1,3,0,3
2017-12-12 02:55:40,0.13293981481481482,1,44,0,44
2017-12-11 19:53:30,0.05112268518518519,1,2,2,4
2017-12-12 03:11:18,0.49688657407407405,1,10,3,13
2017-12-12 14:13:25,1.0175,8,103,60,163
2017-12-11 13:22:09,0.0346875,1,0,4,4
2017-12-12 19:19:34,1.929548611111111,1,3,1,4
2017-12-10 18:35:47,0.017060185185185185,2,2,2,4
2017-12-10 16:56:06,0.0603587962962963,1,1,1,2
2017-12-10 15:24:29,0.009652777777777777,1,1,1,2
2017-12-10 15:07:25,0.04189814814814815,5,21,17,38
2017-12-10 15:33:53,0.2894791666666667,1,36,7,43
2018-03-04 19:32:25,84.55412037037037,10,621,384,1005
2017-12-10 03:19:07,0.020324074074074074,1,2,1,3
2017-12-10 00:47:59,0.011145833333333334,2,21,21,42
2017-12-09 22:37:18,0.17396990740740742,1,13,0,13
2017-12-09 22:37:31,0.21533564814814815,1,0,15,15
2017-12-09 15:53:41,0.018206018518518517,1,1,1,2
2017-12-11 14:32:29,1.9700578703703704,1,4,4,8
2017-12-09 14:12:11,0.017604166666666667,1,2,0,2
2017-12-09 14:35:22,2.6331712962962963,140,13401,11626,25027
2017-12-09 13:19:08,0.06408564814814814,1,5,2,7
2017-12-13 11:43:54,4.044479166666667,2,7,4,11
2017-12-09 13:18:45,0.18854166666666666,2,55,28,83
2017-12-09 13:17:34,0.30559027777777775,4,70,28,98
2017-12-09 13:19:45,0.3899074074074074,4,20,17,37
2017-12-09 05:00:00,0.06347222222222222,1,1,1,2
2017-12-09 00:25:01,0.014525462962962962,1,1,1,2
2017-12-08 23:47:53,0.011423611111111112,1,37,31,68
2017-12-09 00:32:29,0.053981481481481484,1,15,42,57
2017-12-08 23:56:16,0.051099537037037034,1,12,7,19
2017-12-09 01:22:13,0.12565972222222221,1,24,4,28
2017-12-09 00:24:48,0.1310763888888889,1,1,1,2
2017-12-08 23:55:59,0.11699074074074074,1,105,32,137
2018-09-14 15:59:49,280.2513773148148,1,2387,2322,4709
2017-12-08 12:55:33,0.33774305555555556,1,32,211,243
2017-12-09 13:20:03,1.4615509259259258,3,57,29,86
2017-12-08 00:59:45,1.0667708333333332,98,10906,9639,20545
2017-12-07 23:03:25,0.018599537037037036,1,4,0,4
2017-12-07 20:35:19,0.10621527777777778,1,2,8,10
2017-12-13 16:37:24,5.911087962962963,2,252,279,531
2017-12-07 15:01:53,0.3811921296296296,5,181,52,233
2017-12-07 14:59:31,0.06673611111111111,1,4,4,8
2017-12-07 15:02:53,0.559537037037037,2,11,11,22
2017-12-07 03:53:43,0.047453703703703706,2,0,10,10
2017-12-07 02:37:32,0.11506944444444445,1,1,1,2
2017-12-06 22:08:23,0.026724537037037036,1,1,1,2
2017-12-07 06:28:14,0.49657407407407406,5,65,26,91
2017-12-06 18:48:48,0.07486111111111111,1,5,1,6
2017-12-06 20:04:36,0.1165162037037037,1,15,0,15
2017-12-06 16:53:26,0.08851851851851852,1,3,4,7
2017-12-06 11:18:27,0.029201388888888888,1,5,5,10
2017-12-06 10:42:51,0.026354166666666668,1,2,2,4
2017-12-06 10:42:31,0.03186342592592593,1,4,2,6
2018-04-12 12:45:18,128.43659722222222,1,330,262,592
2017-12-06 10:44:24,0.23063657407407406,1,6,2,8
2017-12-06 11:18:11,0.3746759259259259,1,9,7,16
2017-12-06 06:04:50,0.17037037037037037,2,45,49,94
2017-12-06 02:22:12,0.011956018518518519,1,21,9,30
2017-12-05 10:32:01,0.19863425925925926,1,1,0,1
2018-01-19 19:56:47,45.67349537037037,1,53,51,104
2017-12-06 15:10:55,1.4791550925925927,4,35,24,59
2017-12-05 22:20:28,0.7989814814814815,2,50,11,61
2017-12-04 11:52:14,0.019594907407407408,1,2,2,4
2017-12-09 01:31:38,5.399444444444445,1,74,7,81
2017-12-03 15:55:27,0.14123842592592592,15,47,40,87
2017-12-03 15:55:53,0.19086805555555555,16,516,412,928
2017-12-03 20:29:52,0.9557638888888889,3,109,1,110
2017-12-03 20:29:42,1.0100810185185185,1,3,1,4
2017-12-24 03:48:32,21.366099537037037,2,15,3,18
2017-12-02 14:09:57,0.40273148148148147,1,5,0,5
2017-12-01 18:19:30,0.01826388888888889,1,7,0,7
2017-12-01 23:42:20,0.28833333333333333,2,0,2,2
2017-12-01 15:40:03,0.2589236111111111,1,59,2,61
2017-12-01 11:26:57,0.12787037037037038,1,7,1,8
2017-12-01 11:26:20,0.14484953703703704,1,7,3,10
2017-12-06 10:41:57,5.217777777777778,1,32,32,64
2017-12-01 00:35:48,0.29061342592592593,1,17,17,34
2017-11-30 02:50:06,0.25144675925925924,5,30,18,48
2017-11-29 22:16:30,0.1928125,1,2,2,4
2017-11-29 11:51:25,0.035034722222222224,1,10,7,17
2017-12-05 15:46:04,6.335474537037037,9,946,474,1420
2017-11-30 03:06:21,1.0269097222222223,3,119,42,161
2017-11-29 06:41:22,0.608738425925926,1,10,1,11
2017-11-28 14:00:22,0.10408564814814815,2,22,1,23
2017-11-28 10:30:19,0.0721875,1,48,0,48
2017-11-28 14:41:02,0.35550925925925925,2,22,9,31
2017-11-28 13:31:24,0.3686111111111111,3,11,11,22
2017-11-28 13:32:28,0.4100462962962963,1,661,34,695
2017-12-06 15:13:33,8.66394675925926,1,2,2,4
2017-11-27 21:47:06,0.07371527777777778,1,90,1,91
2017-11-27 19:22:28,0.04113425925925926,1,32,6,38
2017-11-27 19:22:47,0.0581712962962963,1,14,14,28
2017-11-27 19:23:15,0.14146990740740742,3,28,2,30
2017-11-27 15:09:53,0.026122685185185186,1,1,1,2
2017-11-27 20:31:59,1.9542592592592594,2,105,0,105
2017-11-27 04:31:27,0.5732523148148149,1,1,1,2
2017-12-11 01:30:43,15.473715277777778,2,4,4,8
2017-11-25 17:38:40,0.404837962962963,1,2,2,4
2017-11-26 00:45:18,0.7902546296296297,1,13,19,32
2017-11-27 15:08:00,2.4273148148148147,8,576,142,718
2017-11-25 14:41:09,0.4151736111111111,1,6,6,12
2017-11-25 04:53:55,0.010347222222222223,1,1,1,2
2017-12-05 22:02:28,10.810555555555556,14,4322,816,5138
2017-11-25 02:39:58,0.08587962962962963,5,207,9,216
2017-11-24 17:41:07,0.09798611111111111,1,1,1,2
2017-11-24 13:41:04,0.05434027777777778,1,82,0,82
2017-11-24 12:14:32,0.22528935185185187,3,47,19,66
2017-11-24 12:13:17,0.1958101851851852,1,1,1,2
2017-11-25 14:22:59,1.316863425925926,16,8450,3149,11599
2017-11-23 20:38:18,0.014375,1,24,9,33
2017-11-30 02:35:54,0.38336805555555553,1,9,2,11
2017-11-25 00:36:09,1.881585648148148,1,1,0,1
2017-11-24 13:42:10,2.063113425925926,1,8,1,9
2017-11-25 14:41:46,3.983576388888889,1,41,14,55
2017-12-07 02:37:43,15.57048611111111,1,38,9,47
2017-11-21 14:17:28,0.14349537037037038,9,399,327,726
2018-01-03 17:08:58,43.304965277777775,2,134,31,165
2017-11-24 13:42:58,3.2362152777777777,1,63,0,63
2017-11-21 16:11:33,0.4704513888888889,1,4,0,4
2017-11-21 04:59:37,0.029409722222222223,1,205,0,205
2017-11-23 01:49:22,2.4827430555555554,1,4,0,4
2017-11-20 19:45:54,0.11287037037037037,1,3,0,3
2017-11-28 14:00:36,18.971828703703704,7,2776,425,3201
2017-11-24 01:05:54,4.2376504629629625,15,1133,415,1548
2017-11-19 14:33:15,0.2734722222222222,1,1,1,2
2017-11-19 14:32:48,0.2913541666666667,1,18,23,41
2017-11-19 03:16:15,0.056261574074074075,2,548,0,548
2017-11-24 23:35:38,6.097754629629629,1,166,1,167
2017-11-18 20:43:11,0.043645833333333335,1,1,0,1
2017-11-18 18:39:03,0.7034143518518519,5,246,13,259
2017-11-18 03:44:19,0.2762384259259259,1,1,1,2
2017-11-19 03:15:51,1.4346296296296297,1,0,26,26
2017-11-17 18:59:54,0.09961805555555556,1,3,3,6
2017-11-17 17:22:32,0.09878472222222222,1,3,2,5
2017-11-17 17:21:06,0.1410648148148148,1,1,1,2
2017-11-19 03:13:57,1.9617361111111111,2,23,8,31
2017-11-17 14:18:21,0.4429976851851852,1,6,14,20
2017-11-17 02:26:35,0.015821759259259258,1,7,1,8
2017-11-17 01:52:31,0.026354166666666668,1,48,48,96
2017-11-19 03:16:57,2.1034375,2,2,1,3
2017-11-17 01:06:27,0.031747685185185184,1,10,9,19
2017-11-17 00:22:39,0.02872685185185185,1,23,4,27
2017-11-18 05:35:11,1.6706712962962964,8,41,36,77
2017-11-16 12:51:39,2.0353587962962965,4,29,10,39
2017-11-16 11:13:04,0.19145833333333334,1,1,1,2
2017-11-19 03:15:33,2.9164814814814815,1,16,0,16
2017-11-16 02:07:28,0.018206018518518517,1,30,0,30
2017-11-19 03:15:18,3.092789351851852,1,25,2,27
2017-11-16 06:46:30,0.23521990740740742,1,21,2,23
2017-11-15 15:04:16,2.187349537037037,1,69,49,118
2017-11-15 15:05:21,0.3383333333333333,2,46,76,122
2017-11-15 15:04:41,0.40978009259259257,1,7,0,7
2017-11-15 02:57:09,0.06491898148148148,1,1,0,1
2017-11-17 23:16:49,2.9663194444444443,9,907,276,1183
2017-11-15 00:06:49,0.05318287037037037,1,5,0,5
2017-11-14 22:22:44,0.06310185185185185,1,1,1,2
2017-11-14 19:36:12,0.028125,1,3,3,6
2017-11-14 19:37:18,0.4632523148148148,1,35,6,41
2017-11-14 19:41:18,0.5391898148148148,1,33,51,84
2017-11-14 06:53:15,0.024930555555555556,1,7,0,7
2017-11-14 06:52:33,0.03417824074074074,1,1,1,2
2017-11-15 01:00:59,0.8178356481481481,2,129,14,143
2017-11-14 19:44:11,0.579837962962963,1,8,0,8
2017-11-14 02:08:05,0.033622685185185186,1,188,0,188
2017-11-14 02:07:39,0.2586574074074074,5,36,16,52
2017-11-13 16:28:55,0.144375,1,46,0,46
2017-11-13 02:49:54,0.013888888888888888,1,2,2,4
2017-11-15 15:26:53,2.5792824074074074,1,95,24,119
2017-11-14 20:12:58,1.8134606481481481,3,95,17,112
2017-11-13 00:54:48,0.023414351851851853,2,124,2,126
2017-11-12 07:23:32,0.018020833333333333,1,143,0,143
2017-11-12 07:51:48,0.15645833333333334,4,479,479,958
2017-11-11 21:31:21,0.045960648148148146,2,8,1,9
2017-11-12 03:51:07,0.3553587962962963,1,2,1,3
2017-11-10 15:56:02,0.12293981481481482,3,85,0,85
2017-11-10 01:58:33,0.04421296296296296,1,1,1,2
2017-11-14 19:44:43,5.169976851851852,12,126,104,230
2017-11-09 18:40:35,0.1017824074074074,1,1,1,2
2017-11-09 13:37:11,0.27791666666666665,3,113,0,113
2017-11-09 13:23:07,0.1458449074074074,1,7,0,7
2017-11-09 13:22:55,0.3236111111111111,1,13,0,13
2017-11-11 19:23:34,2.7121412037037036,6,546,98,644
2017-11-09 13:36:18,0.7019907407407407,2,123,92,215
2017-11-08 14:19:23,0.10961805555555555,1,1,1,2
2017-11-08 14:19:49,0.2578240740740741,3,10,2,12
2017-11-09 13:36:53,1.3722106481481482,3,13,24,37
2017-11-08 06:28:18,0.1025462962962963,1,29,0,29
2017-11-08 06:29:08,0.02525462962962963,1,77,0,77
2017-11-07 21:15:16,0.014537037037037038,1,1,1,2
2017-11-07 18:06:31,0.021597222222222223,1,1,1,2
2017-11-09 13:34:42,1.9014699074074075,2,25,3,28
2017-11-07 18:06:45,0.07575231481481481,1,168,39,207
2017-11-07 13:24:22,0.05556712962962963,1,1,1,2
2017-11-07 13:24:56,0.14711805555555554,2,24,5,29
2017-11-07 13:30:32,1.2796643518518518,1,71,50,121
2017-11-06 04:54:13,0.02079861111111111,1,36,13,49
2017-11-06 04:54:41,0.1675347222222222,1,27,0,27
2017-11-11 15:49:05,5.904386574074074,1,5,1,6
2017-11-07 13:47:40,11.118506944444444,2,5,10,15
2017-11-05 22:06:54,0.1977662037037037,1,14,13,27
2017-11-05 09:20:05,0.053668981481481484,1,28,0,28
2017-11-03 08:42:31,0.5820486111111111,5,18,13,31
2017-11-05 12:08:00,3.4696064814814815,1,22,25,47
2017-11-01 16:49:46,0.27064814814814814,1,1,8,9
2017-11-01 13:42:19,1.0804398148148149,1,25,25,50
2017-11-01 11:17:54,0.4899074074074074,1,13,5,18
2017-11-01 13:46:06,0.7623148148148148,1,2,1,3
2017-10-31 21:58:08,0.22523148148148148,1,8,15,23
2017-10-31 15:47:36,0.04822916666666666,1,1,1,2
2017-10-31 21:58:39,1.5102314814814815,1,98,19,117
2017-11-05 12:05:50,6.265590277777778,4,13,4,17
2017-10-31 11:22:33,1.345925925925926,26,136,197,333
2017-10-31 11:23:25,1.400451388888889,21,719,918,1637
2017-10-31 02:27:48,1.2313657407407408,2,44,60,104
2017-11-07 13:48:14,9.59605324074074,1,60,9,69
2017-10-28 17:08:38,0.013032407407407407,1,1,1,2
2017-11-07 18:08:15,10.40986111111111,2,8,5,13
2017-10-29 15:23:39,1.7723958333333334,1,2,2,4
2017-10-28 03:43:21,0.3355787037037037,1,4,0,4
2017-10-27 17:06:55,0.0209375,1,47,47,94
2017-10-29 15:24:16,1.9702430555555555,1,5,1,6
2017-10-27 17:08:07,0.6471180555555556,1,19,0,19
2017-10-27 17:08:30,0.055358796296296295,1,5,5,10
2017-11-07 13:31:58,11.107604166666667,1,4,9,13
2017-10-27 14:10:23,0.23319444444444445,1,49,35,84
2017-10-27 14:10:37,1.6384027777777779,1,8,4,12
2017-10-27 15:05:05,1.9863194444444445,1,0,0,0
2017-10-25 14:11:03,0.012280092592592592,1,4,0,4
2017-10-31 11:25:52,7.423622685185185,1,31,3,34
2017-10-29 15:11:33,4.460046296296296,2,13,7,20
2017-10-25 13:38:38,0.5398148148148149,1,168,168,336
2017-10-25 15:21:58,202.5308912037037,60,118405,182667,301072
2017-10-26 14:44:25,2.9610648148148146,1,1,1,2
2017-10-30 03:34:59,6.947025462962963,14,725,412,1137
2017-10-29 15:10:16,6.452847222222222,1,13,16,29
2017-10-27 15:04:45,7.948715277777778,1,27,52,79
2017-10-27 17:14:11,5.173368055555556,1,2,2,4
2017-10-21 23:34:40,0.1609375,1,5,5,10
2017-10-26 13:52:49,5.143298611111111,4,18,9,27
2017-10-26 13:48:36,5.888981481481482,1,21,11,32
2017-10-27 14:11:30,7.136851851851852,1,32,6,38
2017-11-24 13:43:54,35.490648148148146,2,2,3,5
2017-10-26 13:46:50,6.8984606481481485,1,0,1,1
2017-11-07 18:09:54,19.081145833333334,9,40,37,77
2017-10-19 16:27:56,0.013136574074074075,1,7,7,14
2017-11-07 13:49:32,19.132939814814815,7,667,443,1110
2017-10-19 11:51:38,0.06646990740740741,1,0,17,17
2017-10-27 14:54:21,8.315138888888889,1,1,1,2
2017-11-12 15:18:51,24.548125,1,76,76,152
2017-11-07 13:49:51,19.90412037037037,1,1,1,2
2017-10-18 15:13:51,0.0178125,1,5,1,6
2017-10-18 11:51:31,0.027256944444444445,1,4,4,8
2017-10-18 11:53:17,0.13162037037037036,1,2,2,4
2017-10-18 07:47:14,0.03751157407407407,1,4,4,8
2017-10-18 09:57:03,0.18409722222222222,1,1,1,2
2017-10-18 09:39:37,0.2666203703703704,1,9,1,10
2017-10-18 11:50:53,2.7085185185185185,24,4459,2276,6735
2017-10-17 21:15:41,0.05380787037037037,2,5,1,6
2017-10-17 20:17:03,0.06511574074074074,1,2,8,10
2017-10-17 19:49:40,0.04900462962962963,10,28,27,55
2017-10-17 18:05:22,0.044050925925925924,1,7,2,9
2017-10-17 18:07:45,0.05143518518518519,1,9,0,9
2017-10-17 16:32:26,0.03234953703703704,1,1,1,2
2017-10-17 18:38:16,0.13167824074074075,1,1,1,2
2017-10-17 11:03:13,0.012719907407407407,1,1,1,2
2017-10-17 11:03:29,0.03971064814814815,4,4,4,8
2017-10-17 09:45:38,0.1833101851851852,1,3,3,6
2017-10-17 09:46:00,0.19516203703703705,1,103,118,221
2017-10-17 09:45:07,0.3292476851851852,2,130,45,175
2017-10-17 09:47:05,0.38766203703703705,3,175,44,219
2017-10-17 10:02:48,0.4623148148148148,2,1520,186,1706
2017-10-16 23:00:24,0.021516203703703704,3,3,0,3
2017-10-16 19:08:01,0.02605324074074074,1,41,18,59
2017-10-16 18:29:50,0.011354166666666667,1,1,1,2
2017-10-16 18:44:31,0.2116550925925926,2,72,27,99
2017-10-16 13:58:24,0.05326388888888889,1,11,7,18
2017-10-16 13:59:31,0.0628587962962963,1,3,3,6
2017-10-16 12:09:51,0.05379629629629629,1,3,1,4
2017-10-16 12:09:27,0.06313657407407407,5,6,2,8
2017-10-16 09:12:10,0.07863425925925926,2,83,24,107
2017-10-16 07:30:10,0.05606481481481482,1,28,28,56
2017-10-16 07:33:09,0.149375,1,1266,682,1948
2017-10-16 07:33:50,0.19037037037037038,1,1,2,3
2017-10-16 07:31:48,0.19315972222222222,1,4,1,5
2017-10-16 14:08:52,0.5530092592592593,1,18,5,23
2017-10-16 01:03:37,0.021122685185185185,1,4,0,4
2017-10-17 04:41:37,1.4104166666666667,19,2356,1226,3582
2017-10-15 21:07:33,0.09368055555555556,2,8,6,14
2017-10-16 12:39:29,1.1109490740740742,2,27,19,46
2017-10-15 12:21:06,0.1240162037037037,1,2,2,4
2017-10-15 21:08:31,0.5793634259259259,2,31,15,46
2017-10-16 12:10:12,1.8114583333333334,2,31,10,41
2017-10-16 07:36:16,1.610775462962963,5,126,78,204
2017-10-14 12:28:19,0.055601851851851854,1,67,11,78
2017-10-14 12:38:57,0.116875,2,13,7,20
2017-10-14 10:00:23,0.007928240740740741,1,2,2,4
2017-10-14 12:40:11,0.5244560185185185,2,5,3,8
2017-10-14 12:30:20,0.6826967592592592,1,24,24,48
2017-11-15 00:53:34,32.222824074074076,1,15,1,16
2017-10-14 01:34:59,0.2909375,2,4,4,8
2017-10-14 12:42:09,0.8758217592592593,1,26,6,32
2017-10-13 16:03:57,0.02832175925925926,2,2,2,4
2017-10-13 14:53:44,0.13296296296296295,1,1,3,4
2017-10-13 10:58:14,0.01724537037037037,1,1,1,2
2017-10-13 14:44:44,0.20320601851851852,1,8,8,16
2017-10-13 14:44:17,0.2078935185185185,2,11,21,32
2017-10-13 14:44:03,0.21465277777777778,1,13,3,16
2017-10-13 14:44:30,0.24327546296296296,1,15,5,20
2017-10-13 09:00:11,0.02546296296296296,1,34,8,42
2017-10-13 07:35:08,0.12040509259259259,1,1,1,2
2017-10-13 00:52:09,0.1362847222222222,3,12,6,18
2017-10-12 21:16:44,0.0659375,4,110,36,146
2017-10-14 12:41:12,1.6788541666666668,1,1,0,1
2017-10-12 21:26:35,0.06875,1,1,1,2
2017-10-12 19:33:38,0.007847222222222222,1,73,5,78
2017-10-14 12:48:13,1.7997800925925926,1,90,68,158
2017-10-12 14:31:15,0.02537037037037037,1,27,27,54
2017-10-12 10:07:35,0.008576388888888889,1,8,0,8
2017-10-12 10:01:33,0.08427083333333334,1,3,1,4
2017-10-12 07:56:04,0.009895833333333333,1,4,0,4
2017-10-12 06:28:16,0.01570601851851852,1,8,0,8
2017-10-12 13:40:45,0.31899305555555557,1,1,1,2
2017-10-12 03:18:14,0.03388888888888889,2,17,0,17
2017-10-11 22:58:02,0.12716435185185185,3,70,7,77
2017-10-11 22:58:15,0.03309027777777778,1,0,0,0
2017-10-17 20:20:08,9.938287037037037,10,4864,1615,6479
2017-10-11 19:18:46,0.039189814814814816,1,22,14,36
2017-10-11 19:21:22,0.03533564814814815,1,11,11,22
2017-10-11 19:21:14,0.03841435185185185,1,9,0,9
2017-10-11 19:20:40,0.04099537037037037,1,4,1,5
2017-10-11 19:20:57,0.07226851851851852,1,2,2,4
2017-10-12 13:25:35,0.851400462962963,11,366,174,540
2017-10-11 17:20:56,0.11209490740740741,1,6,8,14
2017-10-11 14:31:08,0.014618055555555556,1,1,1,2
2017-10-14 12:40:36,153.82539351851852,43,65621,26718,92339
2017-10-11 17:21:45,0.13680555555555557,1,9,2,11
2017-10-11 17:11:15,0.14619212962962963,1,0,0,0
2017-10-11 17:22:22,0.1870601851851852,1,1,1,2
2017-10-11 13:07:10,0.023854166666666666,3,10,10,20
2017-10-11 13:04:37,0.039467592592592596,1,2,2,4
2017-10-11 12:19:05,0.01601851851851852,1,53,53,106
2017-10-11 09:25:16,0.27869212962962964,1,2,2,4
2017-10-10 23:33:30,0.01085648148148148,1,2,2,4
2017-10-10 23:01:18,0.012337962962962964,1,1,1,2
2017-10-10 22:52:26,0.07248842592592593,1,18,2,20
2017-10-10 18:47:14,0.010405092592592593,1,29,3,32
2017-10-10 16:44:52,0.6472337962962963,1,22,5,27
2018-02-02 09:18:56,65.40149305555556,30,302,155,457
2017-10-10 14:12:19,0.009189814814814816,1,17,1,18
2017-10-10 13:17:54,0.014166666666666666,1,3,1,4
2017-10-10 13:18:28,0.08891203703703704,1,1,2,3
2017-10-10 13:18:13,0.0987962962962963,1,16,1,17
2017-10-10 10:41:31,0.0011342592592592593,1,0,0,0
2017-10-10 11:12:17,0.358275462962963,3,20,9,29
2017-10-09 19:27:17,0.009594907407407408,1,0,0,0
2017-10-09 18:52:41,0.012835648148148148,1,2,2,4
2017-10-09 18:51:37,0.03746527777777778,1,6,2,8
2017-10-09 18:51:25,0.05028935185185185,1,2,2,4
2017-10-09 15:30:32,0.4219675925925926,1,49,19,68
2017-10-09 08:05:36,0.2230324074074074,1,1,1,2
2017-10-09 15:52:03,0.6206597222222222,1,2,1,3
2017-10-09 08:05:11,0.3904050925925926,1,1,1,2
2017-10-08 19:55:35,0.014872685185185185,1,2,4,6
2017-10-08 20:03:34,0.054733796296296294,1,1,1,2
2017-10-08 19:47:15,0.06446759259259259,4,98,25,123
2017-10-08 07:00:56,0.015219907407407408,1,10,1,11
2017-10-08 01:06:44,0.019664351851851853,1,1,1,2
2017-10-08 12:42:00,0.5066319444444445,1,7,2,9
2017-10-08 00:34:50,0.014131944444444445,1,19,17,36
2017-10-08 00:55:59,0.2841087962962963,1,16,11,27
2017-10-08 05:18:27,0.37777777777777777,4,28,10,38
2017-10-07 19:20:59,0.04224537037037037,1,42,27,69
2017-10-08 00:33:08,0.300625,1,14,3,17
2017-10-08 15:34:35,0.9461111111111111,1,83,43,126
2017-10-07 16:55:49,0.025266203703703704,1,8,0,8
2017-10-07 17:02:30,0.12215277777777778,1,66,22,88
2017-10-07 10:17:03,0.3835648148148148,1,221,88,309
2017-10-06 20:43:33,0.009085648148148148,1,17,0,17
2017-10-07 00:38:53,0.23252314814814815,1,17,7,24
2017-10-07 10:16:40,0.6435300925925926,1,7,1,8
2017-10-08 05:30:15,1.4631712962962964,5,296,14,310
2017-10-07 16:32:03,0.9616666666666667,1,30,0,30
2017-10-06 18:39:09,0.06864583333333334,2,4,3,7
2017-10-06 18:38:29,0.08354166666666667,1,1,1,2
2017-10-06 18:37:56,0.15681712962962963,1,2,2,4
2017-10-06 18:37:17,0.10836805555555555,1,2,2,4
2017-10-06 18:40:17,2.047673611111111,2,24,2,26
2017-10-07 05:17:00,0.5797337962962963,2,34,16,50
2017-10-07 15:43:43,1.0363657407407407,2,134,50,184
2017-10-06 11:29:54,0.025717592592592594,1,1,1,2
2017-10-06 14:40:42,0.2579513888888889,1,3,1,4
2017-10-07 18:26:44,1.4817592592592592,4,1517,392,1909
2017-10-06 10:03:14,0.1686689814814815,1,17,7,24
2017-10-07 18:00:36,1.6833796296296297,2,812,248,1060
2017-10-06 01:46:16,0.011724537037037037,1,8,4,12
2017-10-06 01:24:34,0.013888888888888888,1,4,4,8
2017-10-06 01:24:55,0.09236111111111112,1,1,1,2
2017-10-06 01:42:22,0.27414351851851854,2,125,120,245
2017-10-05 21:42:05,0.16395833333333334,1,330,15,345
2017-10-05 21:41:48,0.24383101851851852,1,9,5,14
2017-10-06 01:42:35,2.041053240740741,1,254,93,347
2017-10-04 20:49:36,0.1051736111111111,1,10,11,21
2017-10-04 18:03:42,0.0265625,1,123,33,156
2017-10-04 17:06:24,0.009675925925925926,1,2,2,4
2017-10-04 16:16:30,0.030104166666666668,1,8,7,15
2017-10-04 22:21:45,0.30703703703703705,2,4,4,8
2017-10-04 14:28:40,0.016134259259259258,1,1,1,2
2017-10-04 11:25:25,0.009918981481481482,1,2,0,2
2017-10-04 07:59:29,0.06539351851851852,1,1,1,2
2017-10-04 07:51:43,0.20590277777777777,1,1,1,2
2017-10-08 20:03:45,4.888668981481482,1,4,4,8
2017-10-03 22:33:57,0.4346759259259259,1,2,4,6
2017-10-03 22:39:33,0.03491898148148148,1,37,44,81
2017-10-03 23:01:45,0.07677083333333333,1,37,5,42
2017-10-03 19:15:42,0.013518518518518518,1,9,9,18
2017-10-03 18:43:58,0.06856481481481481,1,35,14,49
2017-10-03 21:21:19,0.2208564814814815,3,19,8,27
2017-10-03 18:54:39,0.12094907407407407,1,81,0,81
2017-10-03 23:22:34,0.33466435185185184,1,3,2,5
2017-10-03 11:10:59,0.07214120370370371,1,5,0,5
2017-10-03 11:10:07,0.07237268518518518,1,1,3,4
2017-10-03 11:10:26,0.13702546296296297,7,195,11,206
2017-10-03 11:11:23,0.24072916666666666,1,9,4,13
2017-10-03 00:53:19,2.443611111111111,1,60,39,99
2017-10-02 23:56:50,0.08084490740740741,1,9,9,18
2017-10-02 21:26:29,0.016168981481481482,3,61,5,66
2017-10-02 21:27:53,0.043611111111111114,1,2,2,4
2017-10-02 21:38:41,0.30170138888888887,2,81,196,277
2017-10-02 05:22:25,5.581006944444445,1,348,10,358
2017-10-02 01:02:09,1.795810185185185,1,1,1,2
2017-10-03 00:01:55,1.1373958333333334,2,8,2,10
2017-10-03 23:23:53,2.122546296296296,3,119,16,135
2017-10-02 16:24:06,0.8968171296296297,1,82,1,83
2017-10-01 23:23:33,0.23251157407407408,1,54,21,75
2017-10-01 17:09:46,0.06831018518518518,1,6,0,6
2017-10-05 23:08:00,4.437349537037037,5,1088,366,1454
2017-10-01 08:52:40,0.4323958333333333,1,45,26,71
2017-10-02 01:01:02,1.3419907407407408,3,68,31,99
2017-09-30 12:28:30,0.21283564814814815,1,2,1,3
2017-09-30 13:50:03,0.255625,1,3,2,5
2017-09-30 12:28:50,0.4805324074074074,1,21,16,37
2017-09-29 19:11:29,0.22599537037037037,1,163,46,209
2017-09-30 03:11:45,0.4780439814814815,2,34,22,56
2017-10-02 05:21:47,2.7621759259259258,2,6,3,9
2017-09-29 20:46:43,0.5970717592592593,2,34,34,68
2017-09-29 04:27:31,0.0090625,1,2,1,3
2017-10-01 10:20:00,2.4166319444444446,3,142,75,217
2017-09-29 00:30:01,0.07787037037037037,1,5,5,10
2017-09-29 01:03:03,0.11179398148148148,1,1,1,2
2017-09-30 22:35:49,2.115173611111111,3,1329,608,1937
2017-09-28 21:20:09,0.13113425925925926,1,1,1,2
2017-09-28 18:43:19,0.03958333333333333,2,44,45,89
2017-09-28 18:45:09,0.12153935185185186,1,111,77,188
2017-09-28 15:38:40,0.03127314814814815,1,41,41,82
2017-09-29 01:16:21,0.44175925925925924,1,137,1,138
2017-09-28 15:50:15,0.08496527777777778,1,19,1,20
2017-09-28 13:04:33,0.30212962962962964,1,5,5,10
2017-09-28 02:51:36,0.01587962962962963,2,13,5,18
2017-09-28 13:31:32,0.5679282407407408,3,313,280,593
2017-09-27 12:41:55,0.06708333333333333,1,67,23,90
2017-09-27 02:14:04,0.04050925925925926,1,5,1,6
2017-09-30 02:29:57,0.19516203703703705,2,724,425,1149
2017-09-29 01:16:44,2.293101851851852,1,18,21,39
2017-09-27 01:13:09,0.32459490740740743,1,5,5,10
2017-10-03 23:13:49,7.463078703703704,1,118,113,231
2017-09-30 20:05:43,4.365219907407408,1,60,3,63
2017-09-27 21:42:49,1.4527199074074073,1,4,5,9
2017-09-28 18:22:34,2.377511574074074,1,3,0,3
2017-10-04 13:16:11,6.152789351851852,9,3997,1435,5432
2017-09-26 05:19:25,0.009930555555555555,2,4,1,5
2017-09-26 09:55:33,0.2811574074074074,1,11,7,18
2017-09-25 22:29:30,0.02738425925925926,1,13,0,13
2017-09-27 22:26:33,1.2162152777777777,2,3,66,69
2017-09-25 23:06:28,0.09428240740740741,1,7,63,70
2017-09-25 23:06:14,0.1040625,1,5,3,8
2017-09-25 21:05:54,0.03871527777777778,1,13,11,24
2017-09-25 18:26:51,0.09802083333333333,1,1,3,4
2017-09-25 16:33:12,0.21758101851851852,1,114,2,116
2017-09-25 15:10:50,0.22480324074074073,1,1,1,2
2017-09-25 14:58:13,0.23578703703703704,1,11,2,13
2017-10-02 19:29:00,7.629409722222222,8,3560,1633,5193
2017-11-15 02:56:42,121.24037037037037,42,5382,2736,8118
2017-09-25 16:36:34,1.0775578703703703,1,95,13,108
2017-09-25 00:11:14,0.5179050925925925,1,7,0,7
2017-09-24 10:17:48,0.009074074074074075,1,4,4,8
2017-09-24 09:14:06,0.040740740740740744,1,3,3,6
2017-09-30 13:57:33,6.267199074074074,1,23,24,47
2017-09-24 09:18:33,3.2286689814814813,1,1,1,2
2017-09-24 09:15:11,0.21288194444444444,1,2,1,3
2017-09-24 03:58:07,0.06503472222222222,1,10,1,11
2017-09-24 13:31:04,0.46988425925925925,1,1,1,2
2017-09-24 02:09:33,0.02900462962962963,1,3,3,6
2017-09-25 02:04:04,1.0287962962962962,1,40,68,108
2017-09-23 22:33:18,0.037627314814814815,1,1,1,2
2017-09-23 22:33:27,0.05237268518518518,1,13,3,16
2017-09-23 23:25:07,0.07702546296296296,1,8,8,16
2017-09-23 22:40:11,0.08181712962962963,1,15,9,24
2017-09-24 09:19:43,0.5328125,2,17,5,22
2017-09-23 20:47:15,0.029930555555555554,1,10,10,20
2017-09-23 20:14:40,0.00920138888888889,1,4,4,8
2017-09-23 19:06:17,0.036377314814814814,2,3,3,6
2017-09-24 03:58:31,1.0106712962962963,2,75,14,89
2017-09-23 12:47:33,0.4685416666666667,10,232,219,451
2017-09-23 03:40:28,0.12949074074074074,1,91,2,93
2017-09-22 23:57:24,0.02869212962962963,1,43,12,55
2017-09-22 23:50:18,0.19194444444444445,1,9,3,12
2017-09-22 23:41:01,0.26208333333333333,4,3358,2197,5555
2017-09-22 17:33:18,0.053634259259259257,1,17,1,18
2017-09-22 17:32:58,0.09575231481481482,2,2,2,4
2017-09-22 15:50:30,0.050243055555555555,1,1,1,2
2017-10-04 07:52:12,18.79763888888889,2,13,4,17
2017-09-22 11:20:05,3.927488425925926,1,188,61,249
2017-09-22 04:44:40,0.019699074074074074,1,1,0,1
2017-09-22 02:59:02,0.16578703703703704,1,3,2,5
2017-09-22 02:58:34,0.39949074074074076,1,14,12,26
2017-09-21 12:30:22,0.09945601851851851,1,1,0,1
2017-09-21 01:47:16,0.025787037037037035,1,18,13,31
2017-09-20 17:41:36,0.019039351851851852,1,11,11,22
2017-09-20 16:56:29,0.02318287037037037,1,19,19,38
2017-09-20 17:07:23,0.03369212962962963,1,4,1,5
2017-09-20 17:08:21,0.10663194444444445,1,1,1,2
2017-09-20 14:09:58,0.11009259259259259,2,5,1,6
2017-09-20 13:26:23,0.03210648148148148,1,0,2,2
2017-09-20 13:00:55,0.2707407407407407,5,35,8,43
2017-09-20 17:58:44,0.5502662037037037,2,26,15,41
2017-09-20 12:53:49,23.657060185185184,4,116,81,197
2017-09-22 02:59:18,2.0706944444444444,2,298,258,556
2017-09-20 01:38:38,0.10998842592592592,1,1,0,1
2017-09-19 21:27:30,0.02753472222222222,1,29,37,66
2017-09-19 21:25:18,0.07054398148148149,1,17,0,17
2017-09-30 14:01:47,10.770833333333334,1,1,1,2
2017-09-19 19:44:19,0.023148148148148147,3,19,7,26
2017-09-19 15:55:48,0.15981481481481483,1,2,2,4
2017-09-19 15:00:30,0.01460648148148148,1,9,2,11
2017-09-19 14:03:45,0.06689814814814815,1,15,2,17
2017-09-19 16:08:09,0.1781712962962963,1,308,297,605
2017-09-20 12:57:59,1.2725578703703704,4,16,4,20
2017-09-19 03:06:14,0.030439814814814815,1,1,1,2
2017-09-19 03:06:28,0.04805555555555555,1,0,2,2
2017-09-19 03:05:48,0.07803240740740741,3,5,3,8
2017-09-19 01:27:09,0.013020833333333334,1,227,225,452
2017-09-19 01:52:39,0.032268518518518516,2,93,1,94
2017-09-18 21:29:16,0.04457175925925926,1,1,0,1
2017-09-18 18:30:12,0.02537037037037037,1,11,2,13
2017-09-18 19:25:40,0.0702662037037037,1,2,2,4
2017-09-19 04:53:17,0.5266666666666666,2,69,37,106
2017-09-18 22:47:49,1.870162037037037,9,1184,441,1625
2017-09-18 12:59:57,0.20547453703703702,1,1,1,2
2017-09-18 13:00:30,0.360775462962963,1,9,6,15
2017-09-18 02:55:24,0.04960648148148148,1,3,3,6
2017-09-18 02:52:35,0.2116898148148148,1,31,31,62
2017-09-19 00:42:41,1.2357175925925925,2,389,38,427
2017-09-17 13:23:45,0.04912037037037037,2,68,30,98
2017-09-17 13:21:58,0.0353587962962963,1,9,1,10
2017-09-17 11:51:35,0.038344907407407404,1,1,1,2
2017-09-17 09:58:20,0.0631712962962963,1,7,7,14
2017-09-17 09:54:24,0.15287037037037038,2,106,0,106
2017-09-17 09:59:24,0.2547685185185185,1,1,1,2
2017-09-17 03:29:44,0.013715277777777778,1,1,15,16
2017-09-17 09:16:44,0.30690972222222224,1,125,125,250
2017-09-16 19:33:52,0.013194444444444444,1,17,1,18
2017-09-16 16:18:00,0.027453703703703702,1,2,2,4
2017-09-16 16:48:38,0.10556712962962964,4,180,180,360
2017-09-16 13:00:37,0.1844212962962963,1,2,2,4
2017-09-16 13:00:02,0.18163194444444444,1,2,2,4
2017-09-16 13:01:15,1.1209259259259259,1,199,1,200
2017-09-16 16:39:12,0.35640046296296296,2,17,29,46
2017-09-16 12:59:41,0.33784722222222224,1,43,53,96
2017-09-15 22:32:44,0.26109953703703703,1,2,2,4
2017-09-19 14:36:24,4.292013888888889,11,85,42,127
2017-09-18 02:55:57,2.9368171296296297,3,52,50,102
2017-09-14 22:51:01,0.03113425925925926,1,3,3,6
2017-09-16 01:01:46,1.1364467592592593,2,61,6,67
2017-09-14 22:57:09,0.07876157407407407,1,36,1,37
2017-09-14 22:02:39,6.318240740740741,16,1395,780,2175
2017-09-14 20:26:38,0.1136574074074074,2,16,1,17
2017-09-19 14:37:07,5.077303240740741,1,61,12,73
2017-09-14 16:03:35,0.025486111111111112,1,9,2,11
2017-09-14 15:13:39,0.010590277777777778,1,15,9,24
2017-09-14 14:12:51,0.0768287037037037,1,2,0,2
2017-09-14 12:52:48,0.028761574074074075,4,16,13,29
2017-09-14 09:20:05,0.01929398148148148,1,9,9,18
2017-09-14 12:58:48,0.1789814814814815,3,14,11,25
2017-09-14 16:03:20,4.095532407407408,1,96,5,101
2017-09-14 07:32:15,0.02619212962962963,5,24,23,47
2017-09-14 13:12:44,0.2636689814814815,2,1,28,29
2017-09-14 03:25:19,0.025925925925925925,1,3,0,3
2017-09-14 02:03:01,0.0010763888888888889,1,1,0,1
2017-09-14 14:42:00,0.5462152777777778,1,3,1,4
2017-09-13 22:05:26,0.0225,2,3,4,7
2017-09-14 20:26:23,1.0041782407407407,2,32,23,55
2017-09-13 18:57:33,0.02443287037037037,1,3,0,3
2017-09-13 14:12:29,0.047002314814814816,7,447,414,861
2017-09-13 13:20:04,0.01587962962962963,1,2,0,2
2017-09-13 10:30:08,0.013402777777777777,1,50,1,51
2017-09-13 09:34:07,0.031157407407407408,1,1,1,2
2017-09-13 09:04:32,0.011631944444444445,1,2,0,2
2017-09-13 09:05:03,0.03287037037037037,1,4,2,6
2017-09-13 07:30:14,0.045127314814814815,1,1,0,1
2017-09-13 22:04:30,0.9173958333333333,4,140,45,185
2017-09-14 01:39:11,1.324548611111111,9,1107,260,1367
2017-09-12 21:06:10,0.15310185185185185,1,75,44,119
2017-09-13 08:24:34,0.6522916666666667,1,93,61,154
2017-09-12 21:10:40,0.4979513888888889,3,31,4,35
2017-09-13 12:22:17,1.1705902777777777,2,6,6,12
2017-09-12 03:39:39,0.19721064814814815,1,44,25,69
2017-09-11 22:57:19,0.030046296296296297,1,2,0,2
2017-09-11 22:16:04,0.008657407407407407,1,12,8,20
2017-09-11 22:16:19,0.02,1,2,2,4
2017-09-14 02:11:37,2.1927199074074073,2,24,9,33
2017-09-11 21:50:38,0.025324074074074075,1,37,21,58
2017-09-11 14:19:55,0.17516203703703703,1,4,4,8
2017-09-11 13:11:14,0.38829861111111114,1,12,1,13
2017-09-10 23:40:30,2.3861921296296296,13,1378,767,2145
2017-09-10 15:25:39,0.05033564814814815,1,3,0,3
2017-09-10 23:35:28,0.4193865740740741,2,30,3,33
2017-09-11 21:43:20,1.4695717592592592,2,786,428,1214
2017-09-10 13:09:07,0.006527777777777778,1,11,0,11
2017-09-10 11:34:15,0.034340277777777775,1,3,0,3
2017-09-11 21:03:14,1.4414930555555556,1,38,38,76
2017-09-10 08:26:01,0.35694444444444445,1,12,28,40
2017-09-10 06:48:12,0.29614583333333333,1,15,3,18
2017-09-10 07:58:39,0.4059143518518519,1,118,2,120
2017-09-09 19:31:48,0.020416666666666666,1,1,1,2
2017-09-09 16:22:57,0.00917824074074074,6,14,14,28
2017-09-09 15:36:28,0.04565972222222222,1,9,6,15
2017-09-09 13:09:50,0.009699074074074074,1,1,1,2
2017-09-09 12:16:11,0.014270833333333333,1,13,11,24
2017-09-09 11:42:48,0.02642361111111111,1,1,1,2
2017-09-09 11:41:46,0.41107638888888887,1,7,3,10
2017-09-09 00:02:30,0.15577546296296296,1,2,1,3
2017-09-09 00:26:42,0.2114351851851852,1,19,2,21
2017-09-08 19:43:35,0.05238425925925926,1,17,8,25
2017-09-09 00:26:58,0.2802777777777778,2,260,247,507
2017-09-09 00:02:44,0.36190972222222223,1,1,1,2
2017-09-08 16:20:03,0.05040509259259259,1,30,2,32
2017-09-09 14:23:45,0.998912037037037,1,76,10,86
2017-09-08 11:55:48,0.009722222222222222,2,2,0,2
2017-09-07 20:51:49,0.010266203703703704,1,10,8,18
2017-09-08 10:00:30,0.5805787037037037,1,1,1,2
2017-09-07 20:07:04,0.023333333333333334,10,14,12,26
2017-09-08 10:32:23,0.6542824074074074,2,22,5,27
2017-09-08 10:00:18,0.6705208333333333,1,39,8,47
2017-09-07 18:18:34,0.032025462962962964,1,2,2,4
2017-09-07 14:44:15,0.009444444444444445,1,3,0,3
2017-09-07 14:18:42,0.025625,1,8,22,30
2017-09-07 07:55:43,0.0134375,1,16,0,16
2017-09-07 01:55:07,0.16113425925925925,2,6,6,12
2017-09-06 20:32:49,0.01931712962962963,1,1,1,2
2017-09-06 18:57:53,0.00369212962962963,1,3,3,6
2017-09-06 23:55:03,0.2831712962962963,3,14,14,28
2017-09-06 15:31:54,0.030069444444444444,1,17,11,28
2017-09-06 15:29:57,0.044409722222222225,1,7,1,8
2017-09-06 14:25:20,0.04998842592592593,1,10,16,26
2017-09-06 11:55:48,0.021261574074074075,1,18,2,20
2017-09-07 07:58:12,1.7817129629629629,5,218,86,304
2017-09-06 10:13:01,0.2795949074074074,1,9,0,9
2017-09-06 17:01:29,0.9710069444444445,9,104,66,170
2017-09-05 18:56:21,0.06098379629629629,1,25,1,26
2017-09-06 15:32:16,1.2834953703703704,4,12,7,19
2017-09-05 10:13:26,0.42430555555555555,1,2,2,4
2017-09-04 17:54:12,0.01880787037037037,1,10,10,20
2017-09-05 10:31:25,0.7711921296296296,3,106,101,207
2017-09-05 18:55:26,1.1197106481481482,1,1,1,2
2017-09-30 14:25:15,26.220868055555556,1,1,1,2
2017-09-04 10:52:07,0.09430555555555556,1,4,4,8
2017-09-04 10:53:19,0.11847222222222223,2,31,8,39
2017-09-04 18:40:02,0.44730324074074074,1,100,7,107
2017-10-04 07:56:37,48.15094907407408,20,16659,7761,24420
2017-09-05 15:48:13,1.641412037037037,1,24,7,31
2017-09-04 00:14:13,0.008622685185185185,1,7,7,14
2017-09-04 16:26:33,0.697662037037037,1,40,8,48
2017-09-03 18:31:52,0.015173611111111112,1,1,0,1
2017-09-03 13:17:35,0.00880787037037037,1,309,1,310
2017-09-03 13:17:25,0.11989583333333333,1,23,23,46
2017-09-03 09:08:38,0.0903587962962963,6,28,10,38
2017-09-03 10:39:39,0.2795138888888889,1,1,1,2
2017-09-03 05:58:59,0.14443287037037036,1,9,2,11
2017-09-02 21:21:49,0.10987268518518518,1,81,81,162
2017-09-02 18:45:21,0.04162037037037037,1,46,43,89
2017-09-02 18:45:43,0.06049768518518518,1,20,0,20
2017-09-02 18:44:42,0.09800925925925925,3,38,12,50
2017-09-02 21:13:36,0.21671296296296297,1,13,10,23
2017-09-02 14:50:43,0.08148148148148149,2,2,2,4
2017-09-02 14:27:17,1.4550231481481481,2,2,9,11
2017-09-02 15:42:48,0.09287037037037037,2,13,0,13
2017-09-02 14:25:55,0.06399305555555555,1,3,3,6
2017-09-02 12:02:00,0.021979166666666668,1,1,1,2
2017-09-02 12:01:45,0.16133101851851853,2,17,8,25
2017-09-02 12:02:16,0.23875,1,9,0,9
2017-09-02 12:02:30,0.2451273148148148,1,1,1,2
2017-09-02 05:48:52,0.38984953703703706,1,3,3,6
2017-09-02 01:03:21,0.008148148148148147,1,1,0,1
2017-09-02 23:12:06,0.9834606481481482,1,3,3,6
2017-09-02 12:01:23,0.5248495370370371,1,41,17,58
2017-09-02 23:11:24,1.068298611111111,1,17,2,19
2017-09-02 13:49:29,103.10255787037038,3,74,30,104
2017-09-02 12:00:59,0.6227777777777778,1,154,0,154
2017-09-01 19:00:44,0.015381944444444445,1,1,1,2
2017-09-01 18:50:43,0.05268518518518518,1,2,2,4
2017-09-01 19:54:43,0.32753472222222224,1,14,2,16
2017-09-01 14:07:09,0.09346064814814815,1,5,2,7
2017-09-01 19:30:14,0.3247337962962963,2,130,0,130
2017-09-01 10:33:03,0.6536574074074074,1,5,1,6
2017-09-01 19:01:24,1.2572569444444444,2,1,5,6
2017-09-01 11:34:05,0.8146296296296296,1,11,1,12
2017-09-01 19:13:00,1.2671064814814814,1,7,14,21
2017-08-31 19:32:10,0.2813773148148148,1,1,5,6
2017-08-31 15:18:49,0.11458333333333333,2,49,5,54
2017-09-05 10:30:02,0.2377199074074074,1,7,1,8
2017-08-31 09:20:55,0.30679398148148146,1,3,3,6
2017-08-31 01:38:36,0.2364236111111111,2,202,18,220
2017-08-30 21:52:20,0.2604513888888889,1,6,8,14
2017-08-30 15:30:26,0.055625,1,16,3,19
2017-08-30 12:03:17,0.0986574074074074,2,11,8,19
2017-08-30 08:24:31,0.11090277777777778,1,1,1,2
2017-08-30 08:23:44,0.23375,1,101,55,156
2017-08-30 01:30:13,0.0006018518518518519,1,3,3,6
2017-09-01 19:26:02,2.8583564814814815,1,2,2,4
2017-08-30 03:04:21,0.2084837962962963,1,7,3,10
2017-08-30 22:02:59,1.0061574074074073,1,10,3,13
2017-08-29 15:06:19,0.028402777777777777,1,16,2,18
2017-08-29 14:11:28,0.059722222222222225,1,3,1,4
2017-08-31 13:44:01,2.371111111111111,2,2,2,4
2017-08-29 14:11:05,0.7754282407407408,1,57,20,77
2017-08-28 20:08:12,0.026261574074074073,1,26,2,28
2017-08-28 19:38:59,0.022604166666666668,1,9,2,11
2017-08-28 17:12:09,0.032928240740740744,1,9,1,10
2017-08-27 23:16:49,0.026712962962962963,1,11,0,11
2017-08-27 22:01:08,0.06331018518518519,2,12,2,14
2017-08-27 15:03:28,0.5383217592592593,1,7,2,9
2017-08-27 11:35:02,0.35239583333333335,1,1,1,2
2017-09-01 12:09:02,8.622800925925926,15,1845,757,2602
2017-08-27 21:59:51,0.940775462962963,5,12,8,20
2017-08-27 11:35:19,0.4555902777777778,1,119,8,127
2017-08-27 15:04:46,0.6334606481481482,1,16,5,21
2017-08-30 13:37:03,3.7807291666666667,3,58,2,60
2017-08-26 16:52:53,0.05244212962962963,1,41,1,42
2017-08-26 10:39:26,0.2779976851851852,1,1,1,2
2017-08-26 14:10:35,0.5654861111111111,1,21,6,27
2017-08-26 13:32:41,0.5493171296296296,1,21,2,23
2017-08-26 17:55:11,0.733761574074074,1,27,5,32
2017-08-26 11:45:36,0.7666087962962963,2,38,38,76
2017-08-25 18:02:44,0.07829861111111111,1,1,1,2
2017-08-26 12:23:21,0.8618287037037037,1,2,2,4
2017-08-28 20:23:45,5.310439814814814,1,379,323,702
2017-08-25 14:04:53,0.19748842592592591,3,11,5,16
2017-08-25 15:21:16,0.2776851851851852,1,1,0,1
2017-08-25 08:58:32,0.013703703703703704,1,7,2,9
2017-08-25 11:03:26,0.1347337962962963,2,2,2,4
2017-08-25 16:50:53,1.2833796296296296,5,35,11,46
2017-08-25 15:21:00,0.5316666666666666,1,4,2,6
2017-08-26 11:47:38,1.4005208333333334,4,376,37,413
2017-08-25 12:17:09,0.45591435185185186,1,4,4,8
2017-08-24 22:11:06,140.81501157407408,51,90918,172142,263060
2017-08-24 17:27:52,0.1083912037037037,1,4,2,6
2017-08-25 15:19:36,1.1903472222222222,2,450,516,966
2017-08-24 10:15:36,0.07888888888888888,1,2,5,7
2017-08-24 07:16:32,0.021388888888888888,4,78,70,148
2017-08-24 02:03:53,0.02096064814814815,1,2,2,4
2017-08-24 11:31:56,0.43574074074074076,1,20,3,23
2017-08-24 23:41:18,1.1919907407407409,2,493,29,522
2017-08-23 15:45:30,0.04681712962962963,1,15,1,16
2017-08-24 14:21:43,1.0576851851851852,3,118,11,129
2017-08-23 13:16:21,0.011006944444444444,2,71,13,84
2017-08-23 13:21:01,0.04857638888888889,1,15,0,15
2017-08-23 11:07:30,0.010636574074074074,1,1,1,2
2017-08-23 10:25:58,0.037037037037037035,1,2,2,4
2017-08-23 12:14:23,0.5208912037037037,4,28,8,36
2017-08-22 22:59:35,0.1264236111111111,1,102,92,194
2017-08-22 16:30:16,0.05761574074074074,3,67,24,91
2017-08-22 18:00:49,0.15171296296296297,2,4,4,8
2017-08-22 16:31:43,0.24305555555555555,1,1,1,2
2017-08-26 10:40:03,7.835243055555556,1,37,2,39
2017-08-21 15:59:34,0.025127314814814814,1,2,0,2
2017-08-21 20:56:34,0.24087962962962964,1,15,4,19
2017-08-21 15:32:42,0.055393518518518516,1,5,6,11
2017-08-21 10:42:17,0.018958333333333334,1,46,1,47
2017-08-20 22:41:09,0.040775462962962965,1,59,36,95
2017-08-20 22:57:28,0.13125,2,6,6,12
2017-08-20 12:49:12,0.040601851851851854,1,5,1,6
2017-08-21 13:04:35,1.3048148148148149,2,146,192,338
2017-08-20 15:12:06,0.3993287037037037,1,2,2,4
2017-08-22 20:54:19,2.897951388888889,3,52,30,82
2017-09-01 14:20:16,12.634444444444444,7,239,117,356
2017-08-20 11:27:15,0.7762037037037037,1,1,1,2
2017-08-20 14:53:47,1.5916087962962964,2,23,8,31
2017-08-19 00:23:48,0.0008217592592592593,1,2,24,26
2017-08-18 08:42:59,0.10471064814814815,1,2,3,5
2017-08-19 16:44:49,1.6035532407407407,1,20,37,57
2017-08-18 09:24:44,0.3204282407407407,1,2,0,2
2017-08-21 20:57:35,3.8205439814814817,1,60,7,67
2017-08-18 00:29:12,0.010462962962962962,1,1,1,2
2017-08-18 01:22:00,0.051550925925925924,1,4,1,5
2017-08-17 21:20:50,0.04871527777777778,2,4,48,52
2017-08-17 23:03:19,0.3134490740740741,1,32,8,40
2017-08-17 15:52:41,0.03782407407407407,2,49,1,50
2017-08-17 12:46:53,0.06392361111111111,1,3,3,6
2017-08-20 23:14:41,4.00181712962963,3,47,8,55
2017-08-17 20:15:38,0.9042708333333334,1,24,2,26
2017-08-16 20:14:24,0.1814814814814815,2,6,2,8
2017-08-16 21:19:38,0.25342592592592594,1,5,1,6
2017-08-16 14:48:45,0.15450231481481483,2,7,1,8
2017-08-16 08:21:35,0.05599537037037037,1,35,13,48
2017-08-16 15:12:58,0.5389467592592593,5,318,96,414
2017-08-15 12:14:12,0.3798958333333333,1,5,4,9
2017-08-14 19:37:21,0.08927083333333333,1,22,18,40
2017-08-20 18:45:44,6.146076388888889,1,1,1,2
2017-08-14 14:57:46,0.02952546296296296,1,103,6,109
2017-08-14 12:09:01,0.015324074074074073,1,31,15,46
2017-08-14 12:08:35,0.12940972222222222,2,31,12,43
2017-08-20 21:23:06,6.628414351851852,1,12,1,13
2017-08-14 09:27:25,0.27835648148148145,1,11,5,16
2017-08-14 02:50:57,0.01019675925925926,1,1,1,2
2017-08-17 19:35:01,3.7095833333333332,1,17,1,18
2017-08-14 02:16:43,0.07815972222222223,1,16,8,24
2017-08-24 17:28:50,10.776701388888888,2,11,3,14
2017-08-14 00:29:37,1.0495949074074074,1,92,57,149
2017-08-12 14:31:00,0.02605324074074074,1,3,3,6
2017-08-12 22:45:05,0.8580208333333333,1,24,4,28
2017-08-12 15:41:03,0.7091435185185185,1,31,0,31
2017-08-12 00:54:55,0.10403935185185186,1,1,2,3
2017-08-24 15:51:33,12.736446759259259,1,55,16,71
2017-08-11 23:33:31,0.2861226851851852,10,41,36,77
2017-08-10 20:15:26,0.11074074074074074,2,8,8,16
2017-08-10 12:52:40,88.83377314814815,40,39849,17171,57020
2017-08-10 11:41:12,0.39895833333333336,1,5,0,5
2017-08-10 20:33:12,0.8508912037037037,4,64,4,68
2017-09-02 16:52:57,24.086840277777778,1,0,8,8
2017-08-21 19:59:04,13.124270833333334,3,10,10,20
2017-08-12 22:44:41,3.874340277777778,18,794,122,916
2017-08-09 21:54:15,0.8793055555555556,1,100,25,125
2017-08-08 22:21:59,0.02642361111111111,1,11,0,11
2017-08-08 22:22:26,0.03965277777777778,2,11,2,13
2017-09-01 23:52:29,24.14724537037037,3,6662,1409,8071
2017-08-08 20:13:04,0.012418981481481482,1,1,1,2
2017-08-08 22:46:21,0.31136574074074075,1,11,10,21
2017-08-08 13:47:36,0.047546296296296295,1,1,0,1
2017-08-08 13:48:20,0.0947337962962963,1,14,14,28
2017-08-08 13:49:33,0.18178240740740742,1,3,4,7
2017-09-01 14:13:31,24.263796296296295,3,2360,1303,3663
2017-08-08 13:49:15,0.416875,1,2,2,4
2017-08-07 23:49:57,0.007835648148148149,8,2,2,4
2017-08-07 23:50:16,0.028182870370370372,1,8,7,15
2017-08-07 12:41:22,0.009224537037037036,1,2,2,4
2017-08-07 12:55:26,0.10165509259259259,1,2,0,2
2017-08-07 16:55:08,0.378599537037037,2,4,4,8
2017-08-07 16:55:37,0.41875,19,57,57,114
2017-08-29 12:16:21,22.25321759259259,1,20,8,28
2017-08-06 21:50:20,0.016481481481481482,1,8,8,16
2017-08-07 18:33:06,1.3756944444444446,2,13,6,19
2017-08-06 12:52:12,0.14203703703703704,1,1,1,2
2017-08-06 08:36:10,0.28778935185185184,1,4,2,6
2017-08-06 01:14:12,0.075,1,1,0,1
2017-08-05 23:10:54,0.28377314814814814,1,1,0,1
2017-08-05 18:33:42,0.15291666666666667,1,1,1,2
2017-08-05 13:29:53,0.0225,1,3,3,6
2017-08-07 17:44:55,2.369479166666667,4,97,38,135
2017-09-01 11:35:23,27.454618055555557,6,1269,656,1925
2017-08-05 02:24:59,1.0415625,1,105,57,162
2017-08-04 23:31:28,0.17721064814814816,1,2,0,2
2017-08-07 15:20:21,0.17586805555555557,1,1,1,2
2017-08-04 16:57:46,0.38233796296296296,1,20,9,29
2017-08-04 02:42:28,0.041666666666666664,1,3,1,4
2018-04-18 11:09:07,184.2961574074074,8,46917,15022,61939
2017-08-14 02:53:32,10.308912037037038,5,320,93,413
2017-08-03 15:45:45,0.2494675925925926,1,41,0,41
2017-08-03 15:46:50,0.2894212962962963,1,4,0,4
2017-08-02 19:05:18,0.26916666666666667,1,23,27,50
2017-08-02 12:54:34,0.06530092592592593,1,1,1,2
2017-08-04 13:43:29,2.2369560185185184,1,14,14,28
2017-08-03 16:04:36,1.392962962962963,1,17,5,22
2017-08-02 04:31:49,0.011967592592592592,1,8,8,16
2017-08-03 22:16:25,1.9396296296296296,1,1,1,2
2017-08-02 11:09:10,0.531261574074074,1,1,1,2
2017-08-02 11:09:37,0.8117245370370371,1,2,1,3
2017-08-01 15:12:31,0.011655092592592592,1,2,2,4
2017-08-02 02:49:26,0.5642013888888889,2,2,2,4
2017-08-01 13:00:42,0.03820601851851852,1,2,2,4
2017-08-03 15:49:54,2.169814814814815,2,7,4,11
2017-08-01 13:00:29,0.2869097222222222,1,1,1,2
2017-08-01 03:59:11,0.03359953703703704,1,2,2,4
2017-08-01 03:58:09,0.058263888888888886,1,5,4,9
2017-07-31 23:40:31,0.041122685185185186,2,1,11,12
2017-07-31 22:16:05,0.09944444444444445,1,3,1,4
2017-08-01 04:00:13,0.4345833333333333,2,3,2,5
2017-07-31 17:40:58,0.06009259259259259,2,254,35,289
2017-07-31 17:40:20,0.08768518518518519,1,2,0,2
2017-07-31 10:40:25,0.024270833333333332,1,2,2,4
2017-07-31 13:19:30,0.24716435185185184,1,1,1,2
2017-07-31 13:19:13,0.32689814814814816,1,9,8,17
2017-07-31 13:19:48,0.4292824074074074,1,1,1,2
2017-07-31 03:06:20,0.008680555555555556,1,2,4,6
2017-07-31 03:06:56,0.015023148148148148,1,18,7,25
2017-07-30 22:18:16,0.3779050925925926,4,90,18,108
2017-07-30 14:27:58,0.010578703703703703,1,5,1,6
2017-07-30 14:24:19,0.022407407407407407,1,9,2,11
2017-07-30 22:18:45,0.3784375,1,8,7,15
2017-07-30 12:14:41,0.02642361111111111,1,15,4,19
2017-07-30 10:56:04,0.06521990740740741,2,3,2,5
2017-07-30 14:27:51,0.3796527777777778,2,15,5,20
2017-10-04 08:22:53,66.16420138888888,4,24308,8978,33286
2017-07-29 23:05:27,0.006296296296296296,1,1,0,1
2017-07-29 19:20:34,0.09399305555555555,2,40,32,72
2017-07-29 19:20:53,0.0950462962962963,2,5,1,6
2017-07-29 16:46:41,0.0625462962962963,1,2,2,4
2017-07-29 14:54:28,0.005092592592592593,1,1,1,2
2017-08-07 18:32:04,9.176342592592592,4,83,57,140
2017-07-29 12:20:32,0.15609953703703705,9,14,16,30
2017-07-29 12:20:05,0.19342592592592592,1,2,2,4
2017-07-29 12:19:50,0.21726851851851853,1,3,1,4
2017-07-28 23:58:54,0.06505787037037038,7,18,10,28
2017-07-28 20:53:16,0.01525462962962963,1,1,1,2
2017-07-28 20:55:20,0.0787037037037037,2,3,3,6
2017-07-28 18:26:55,0.02355324074074074,1,1,1,2
2017-07-28 20:55:13,0.14604166666666665,2,36,4,40
2017-07-28 22:06:29,0.20001157407407408,2,80,7,87
2017-07-28 16:13:43,0.0103125,1,3,3,6
2017-07-28 15:09:38,0.06652777777777778,4,94,37,131
2017-07-28 13:30:07,0.02869212962962963,1,2,2,4
2017-07-28 13:30:53,0.03832175925925926,1,9,0,9
2017-07-28 15:21:15,0.1222337962962963,1,7,1,8
2017-07-28 15:21:29,0.11998842592592593,1,11,10,21
2017-07-28 11:34:07,0.025069444444444443,1,4,0,4
2017-07-28 11:33:40,0.07865740740740741,2,30,4,34
2017-07-28 11:32:42,0.08806712962962963,1,10,0,10
2017-07-28 11:34:44,0.14128472222222221,2,5,16,21
2017-07-28 08:53:44,0.014212962962962964,1,5,3,8
2017-07-28 11:32:05,0.3239236111111111,1,2,2,4
2017-07-28 11:34:55,0.35434027777777777,1,2,2,4
2017-07-28 03:14:01,0.013935185185185186,1,6,2,8
2017-07-28 03:16:12,0.025243055555555557,1,49,38,87
2017-07-28 02:37:45,0.0356712962962963,1,66,8,74
2017-07-28 02:37:31,0.15230324074074075,14,80,33,113
2017-07-27 23:16:31,112.86043981481481,48,83949,169677,253626
2017-07-27 21:01:50,0.017905092592592594,1,1,2,3
2017-07-27 22:54:49,0.29680555555555554,16,173,58,231
2017-07-27 22:55:15,0.4728703703703704,2,66,4,70
2017-07-27 13:16:08,0.07434027777777778,2,361,170,531
2017-07-27 13:11:59,0.08729166666666667,1,1,1,2
2017-07-27 14:20:48,0.18721064814814814,1,6,11,17
2017-07-27 20:30:28,0.45060185185185186,1,65,992,1057
2017-07-27 13:46:34,0.19586805555555556,1,1,1,2
2017-07-27 13:13:33,0.17340277777777777,1,4,5,9
2017-07-27 13:13:50,0.22643518518518518,1,2,2,4
2017-07-27 13:12:51,0.2512037037037037,1,3,1,4
2017-07-27 13:49:57,0.3114236111111111,1,1,1,2
2017-07-27 13:13:10,0.3855208333333333,1,1,1,2
2017-07-26 22:37:35,0.006111111111111111,1,5,5,10
2017-07-28 03:06:23,1.2214467592592593,1,46,1,47
2017-07-26 23:02:16,0.10422453703703703,2,6,1,7
2017-07-28 02:36:43,1.3878819444444443,1,2,0,2
2017-07-26 21:36:34,0.18487268518518518,1,6,1,7
2017-07-26 21:35:03,0.19013888888888889,1,4,4,8
2017-07-28 03:06:01,1.4370601851851852,3,56,25,81
2017-07-26 14:14:39,0.0011921296296296296,1,2,0,2
2017-07-26 13:03:24,0.01355324074074074,1,1,1,2
2017-07-26 11:46:54,0.14503472222222222,7,56,56,112
2017-07-26 12:57:51,0.2276388888888889,2,6,6,12
2017-07-26 11:45:50,0.2553587962962963,3,9,4,13
2017-07-26 11:47:42,0.2142361111111111,1,24,24,48
2017-07-26 07:09:16,0.03082175925925926,1,2,2,4
2017-07-26 00:01:27,0.068125,4,144,25,169
2017-07-26 00:00:37,0.08207175925925926,1,8,2,10
2017-07-25 21:56:05,0.00755787037037037,1,1,0,1
2017-07-25 19:31:57,0.045578703703703705,2,8,10,18
2017-07-25 18:38:39,0.048275462962962964,1,13,0,13
2017-07-25 17:12:58,0.06247685185185185,1,2,0,2
2017-07-25 14:20:26,0.3916203703703704,2,11,1,12
2017-07-25 13:57:40,0.37701388888888887,1,2,2,4
2017-07-25 13:39:49,0.0060185185185185185,1,2,2,4
2017-07-26 01:35:26,0.5471527777777778,1,8,1,9
2017-07-25 14:01:04,0.07814814814814815,1,1,3,4
2017-07-27 23:55:53,2.468240740740741,1,2,2,4
2017-07-25 13:59:44,0.26186342592592593,2,6,6,12
2017-07-25 03:01:47,0.035798611111111114,2,14,14,28
2017-07-25 00:13:06,0.014872685185185185,1,12,10,22
2017-07-24 23:14:01,0.010486111111111111,1,1,1,2
2017-07-25 00:12:50,0.06922453703703704,8,303,47,350
2017-07-24 23:05:36,0.012418981481481482,1,1,1,2
2017-07-24 23:05:44,0.01871527777777778,1,7,6,13
2017-07-24 23:05:52,0.027939814814814813,2,15,1,16
2017-07-24 17:55:00,0.003958333333333334,1,0,0,0
2017-07-24 17:54:39,0.037905092592592594,1,2,1,3
2017-10-03 15:11:23,70.99674768518518,5,73,27,100
2017-07-24 18:05:29,0.10560185185185185,2,130,58,188
2017-07-24 15:56:50,0.04839120370370371,2,17,5,22
2017-07-24 15:15:35,0.021435185185185186,2,6,1,7
2017-07-24 14:52:48,0.04056712962962963,1,1,2,3
2017-07-24 15:15:15,0.031087962962962963,3,22,180,202
2017-07-24 14:17:55,0.06520833333333333,2,22,18,40
2017-07-24 12:30:11,0.0005324074074074074,1,3,3,6
2017-07-24 11:37:06,0.014143518518518519,1,1,1,2
2017-07-24 08:44:00,0.03550925925925926,1,5,0,5
2017-07-24 08:51:38,0.06230324074074074,1,1,0,1
2017-07-24 12:49:06,0.44212962962962965,1,2,54,56
2017-07-24 06:46:29,0.22600694444444444,1,1,1,2
2017-07-23 21:57:13,0.0071643518518518514,2,2,2,4
2017-07-23 21:32:54,0.00951388888888889,1,26,26,52
2017-07-24 12:26:55,0.9326273148148149,8,86,79,165
2017-07-23 21:04:45,0.002476851851851852,1,1,1,2
2017-07-23 21:04:26,0.012094907407407407,2,2,2,4
2017-07-24 13:09:08,0.7430902777777778,3,223,264,487
2017-07-23 21:27:24,0.06556712962962963,1,28,23,51
2017-07-26 17:03:56,3.0241666666666664,1,9,0,9
2017-07-24 14:21:09,0.9768287037037037,1,8,5,13
2017-07-23 18:28:32,0.15105324074074075,1,4,0,4
2017-07-23 18:28:18,0.1554976851851852,1,67,5,72
2017-07-23 18:28:06,0.17530092592592592,1,19,4,23
2017-07-23 14:57:32,0.10793981481481481,1,2,2,4
2017-07-23 12:50:27,0.013506944444444445,1,1,1,2
2017-07-23 12:50:10,0.019479166666666665,1,1,1,2
2017-07-23 12:03:35,0.04186342592592593,1,11,8,19
2017-07-23 10:46:10,0.08701388888888889,1,2,2,4
2017-07-23 09:09:42,0.2937268518518519,1,1,1,2
2017-07-23 00:40:40,0.019016203703703705,2,17,11,28
2017-07-22 20:27:07,0.016215277777777776,1,5,3,8
2017-07-22 23:15:04,0.18538194444444445,1,8,0,8
2017-07-22 23:14:57,0.19650462962962964,1,70,20,90
2017-07-23 10:46:40,2.2449652777777778,5,171,32,203
2017-07-22 14:36:36,0.017291666666666667,1,2,1,3
2017-07-22 14:36:54,0.021238425925925924,1,10,4,14
2017-07-27 20:31:59,5.995775462962963,8,301,65,366
2017-07-22 12:11:47,10.489918981481482,4,9843,4327,14170
2017-07-21 23:09:10,0.45056712962962964,1,6,2,8
2017-07-21 12:22:30,0.021215277777777777,1,1,1,2
2017-07-21 12:22:06,0.04915509259259259,1,0,2,2
2017-07-21 10:47:16,0.25961805555555556,1,18,0,18
2017-07-21 03:28:52,0.04010416666666667,1,21,1,22
2017-07-21 10:45:14,0.3817361111111111,1,1,1,2
2017-07-21 11:40:49,0.8655324074074074,1,8,7,15
2017-07-20 21:07:13,0.0625462962962963,1,19,1,20
2017-07-21 02:27:40,0.33747685185185183,2,67,7,74
2017-07-20 23:38:25,0.2811111111111111,6,123,12,135
2017-07-26 22:38:20,6.845543981481481,4,23,19,42
2017-07-19 22:20:54,0.012268518518518519,1,4,0,4
2017-07-19 20:38:27,0.042673611111111114,1,8,7,15
2017-07-19 18:26:51,0.04541666666666667,1,5,2,7
2017-07-19 23:59:07,0.3594212962962963,2,40,39,79
2017-07-19 17:38:51,0.0721875,1,2,2,4
2017-07-19 15:06:47,0.25333333333333335,1,27,2,29
2017-07-19 20:37:52,0.2594560185185185,1,10,7,17
2017-07-19 14:02:04,0.01986111111111111,1,1,1,2
2017-07-19 11:35:23,0.017997685185185186,1,1,1,2
2017-07-19 10:25:06,0.010416666666666666,1,5,5,10
2017-07-19 10:00:06,0.009282407407407408,1,6,6,12
2017-07-19 08:49:37,0.01625,1,2,0,2
2017-07-19 07:43:11,0.017233796296296296,1,2,2,4
2017-07-19 07:43:47,0.08804398148148149,1,1,1,2
2017-07-22 18:28:40,4.519699074074074,13,2122,822,2944
2017-07-19 02:59:05,0.011851851851851851,1,25,0,25
2017-07-19 12:44:05,0.5491666666666667,4,145,62,207
2017-07-18 23:37:27,0.10545138888888889,1,193,192,385
2017-07-18 20:49:25,0.06056712962962963,1,15,15,30
2017-07-18 18:03:07,0.04159722222222222,1,21,3,24
2017-07-18 18:03:19,0.057847222222222223,1,2,1,3
2017-07-18 16:42:45,0.008414351851851852,1,45,10,55
2017-07-18 16:43:20,0.020370370370370372,1,2,2,4
2017-07-18 15:23:36,0.0021643518518518518,1,3,0,3
2017-07-18 15:14:43,0.26697916666666666,3,149,8,157
2017-07-18 13:20:39,0.3306365740740741,2,29,24,53
2017-07-18 13:24:58,0.34219907407407407,1,6,0,6
2017-07-18 13:22:10,0.38864583333333336,1,7,7,14
2017-07-18 13:21:30,0.4219675925925926,1,2,1,3
2017-07-18 13:19:49,0.4615162037037037,1,2,1,3
2017-07-17 22:31:44,0.0020486111111111113,1,2,1,3
2017-07-17 17:05:30,0.05665509259259259,1,1,1,2
2017-07-17 09:03:42,0.008136574074074074,1,1,2,3
2017-07-17 09:03:48,0.010833333333333334,1,1,1,2
2017-07-17 08:24:54,0.012847222222222222,2,2,2,4
2017-07-17 08:23:29,0.01653935185185185,1,2,4,6
2017-07-17 22:19:02,0.6122569444444445,2,216,58,274
2017-07-17 08:57:04,0.3203472222222222,1,162,0,162
2017-07-17 22:19:17,1.0919212962962963,2,28,1,29
2017-07-16 21:48:36,0.07554398148148148,1,1,0,1
2017-07-18 14:25:41,1.7848958333333333,1,19,17,36
2017-07-16 18:01:22,0.027824074074074074,2,11,4,15
2017-07-16 12:02:04,0.005208333333333333,1,2,2,4
2017-07-17 08:57:46,0.9660416666666667,1,2,2,4
2017-07-16 09:52:12,3.7717592592592593,2,8,3,11
2017-07-16 02:40:56,0.016087962962962964,1,2,0,2
2017-08-08 19:52:15,23.861921296296295,21,2121,490,2611
2017-07-17 00:37:27,1.0764351851851852,1,23,0,23
2017-07-16 08:28:56,0.42355324074074074,1,4,9,13
2017-07-15 15:24:35,69.97472222222223,2,8,5,13
2017-07-15 15:25:04,0.04777777777777778,1,16,1,17
2017-07-15 10:47:43,0.3347569444444444,1,1,1,2
2017-07-14 20:31:26,0.025590277777777778,2,10,6,16
2017-07-14 21:01:21,0.08652777777777777,3,33,10,43
2017-07-14 18:44:54,0.009780092592592592,1,6,6,12
2017-07-14 17:57:50,0.019988425925925927,1,6,6,12
2017-07-14 18:30:13,0.8189814814814815,8,52,33,85
2017-07-14 22:49:34,0.3607060185185185,1,48,19,67
2017-07-14 14:41:03,0.03690972222222222,1,30,0,30
2017-07-14 12:41:14,0.012141203703703704,1,1,1,2
2017-07-14 11:55:40,0.08469907407407408,2,12,12,24
2017-07-14 10:12:16,0.012893518518518518,1,5,5,10
2017-07-14 10:13:43,0.018969907407407408,2,11,2,13
2017-07-14 09:02:50,0.05668981481481482,1,21,2,23
2017-07-14 09:08:56,0.18943287037037038,1,39,28,67
2017-07-14 09:03:01,0.30747685185185186,1,125,0,125
2017-07-14 01:51:18,0.021909722222222223,1,4,2,6
2017-07-14 20:31:38,0.8058101851851852,1,11,3,14
2017-07-14 17:47:53,0.7452662037037037,1,69,71,140
2017-07-13 22:49:01,0.04416666666666667,4,25,15,40
2017-07-13 20:18:19,0.06063657407407407,1,21,11,32
2017-07-13 17:31:34,0.03841435185185185,1,23,3,26
2017-09-03 09:10:54,51.735856481481484,3,24082,9824,33906
2017-07-13 23:59:34,0.3530787037037037,1,74,3,77
2017-07-13 12:49:58,1.3533680555555556,1,1,1,2
2017-07-12 23:47:24,0.0665625,1,5,0,5
2017-07-12 18:51:45,0.05637731481481482,1,3,7,10
2017-07-12 13:53:51,0.05498842592592593,3,63,41,104
2017-07-12 12:49:17,0.06866898148148148,1,1,1,2
2017-07-12 13:55:17,0.2289699074074074,16,331,327,658
2017-07-12 12:50:07,0.4484722222222222,3,25,11,36
2017-07-18 14:39:47,10.142696759259259,2,720,651,1371
2017-07-12 01:24:05,0.05408564814814815,1,151,161,312
2017-07-13 01:12:25,1.0886458333333333,2,37,19,56
2017-07-11 22:39:15,0.10844907407407407,1,28,0,28
2017-07-18 16:43:00,0.032719907407407406,1,19,4,23
2017-07-11 17:56:45,0.048518518518518516,1,1,1,2
2017-07-11 16:19:17,0.029849537037037036,1,188,205,393
2017-07-11 15:25:50,0.01394675925925926,1,31,9,40
2017-07-11 15:08:27,0.037627314814814815,1,3,0,3
2017-07-11 13:15:43,0.07402777777777778,1,7,6,13
2017-07-11 11:37:05,3.0158217592592593,1,205,188,393
2017-07-11 09:55:49,0.01721064814814815,1,0,2,2
2017-07-10 23:00:02,0.0165625,1,14,2,16
2017-07-10 23:00:14,0.15736111111111112,1,141,141,282
2017-07-14 18:41:50,3.9647916666666667,14,394,105,499
2017-07-10 17:41:56,0.01920138888888889,1,2,2,4
2017-07-10 17:42:38,0.020046296296296295,2,7,1,8
2017-07-10 16:04:43,0.0640162037037037,1,1,0,1
2017-07-10 16:04:24,0.06710648148148148,1,14,1,15
2017-07-10 16:04:06,0.06583333333333333,1,6,6,12
2017-07-10 14:32:18,0.023020833333333334,3,8,6,14
2017-07-10 16:46:47,0.18054398148148149,1,0,1,1
2017-07-10 11:59:30,0.03173611111111111,1,3,0,3
2017-07-10 12:04:06,0.14438657407407407,1,4,1,5
2017-07-10 12:00:32,0.46144675925925926,1,29,0,29
2017-07-11 12:36:28,4.181435185185185,3,32,9,41
2017-07-10 12:02:18,0.3291087962962963,1,221,62,283
2017-07-10 02:49:48,0.0011921296296296296,1,1,1,2
2017-07-10 02:37:10,0.009131944444444444,1,1,1,2
2017-07-10 16:05:07,0.7321875,4,39,8,47
2017-07-09 16:49:08,0.0384375,2,7,5,12
2017-07-09 12:52:03,8.947395833333333,1,11,0,11
2017-07-09 11:04:31,0.01664351851851852,1,2,0,2
2017-07-09 10:16:09,0.053391203703703705,1,18,90,108
2017-07-09 10:17:00,0.0830324074074074,1,1,1,2
2017-07-09 00:52:37,0.0026967592592592594,1,10,6,16
2017-07-11 13:28:00,4.909953703703704,24,1713,1065,2778
2017-07-18 14:38:23,9.902789351851851,4,547,58,605
2017-07-08 16:34:56,0.010405092592592593,1,2,10,12
2017-07-08 16:35:08,0.028449074074074075,1,4,3,7
2017-07-08 15:17:03,0.027094907407407408,2,86,26,112
2017-07-08 15:22:24,0.3197453703703704,1,4,8,12
2017-07-08 15:21:59,0.3263773148148148,1,30,5,35
2017-07-08 15:20:54,0.36604166666666665,1,4,2,6
2017-07-08 12:50:46,0.371875,1,1,1,2
2017-07-08 12:51:05,0.4572800925925926,2,121,94,215
2017-07-09 15:34:06,1.5941666666666667,1,8,0,8
2017-07-07 23:27:23,0.17122685185185185,9,173,151,324
2017-07-09 13:02:26,1.6105439814814815,2,150,82,232
2017-07-07 18:01:18,0.03564814814814815,1,11,11,22
2017-07-07 18:01:01,0.04645833333333333,1,1,0,1
2017-07-07 15:35:47,0.024953703703703704,1,1,0,1
2017-07-07 14:56:52,0.011064814814814816,2,8,7,15
2017-07-07 14:19:28,0.06174768518518518,1,1,1,2
2017-07-07 12:12:16,0.1824074074074074,1,3,0,3
2017-07-07 12:12:46,0.2352662037037037,1,4,4,8
2017-07-07 02:31:41,0.028090277777777777,1,4,17,21
2017-07-07 21:25:15,1.0417476851851852,2,27,10,37
2017-07-07 02:02:07,0.28489583333333335,1,425,301,726
2017-07-06 19:10:12,0.024988425925925924,2,8,8,16
2017-07-06 19:31:04,0.17293981481481482,1,28,11,39
2017-07-06 13:25:27,0.15577546296296296,2,3,3,6
2017-07-06 13:27:03,0.46697916666666667,2,8,5,13
2017-07-05 21:58:04,0.024814814814814814,1,4,0,4
2017-07-08 20:44:31,3.258611111111111,8,1907,814,2721
2017-07-05 12:51:28,0.011412037037037037,1,5,3,8
2017-07-05 12:51:53,0.03636574074074074,1,2,2,4
2017-07-10 01:29:35,4.6556597222222225,3,23,10,33
2017-08-08 20:18:13,9.177222222222222,1,15,1,16
2017-07-05 12:54:21,0.81875,1,33,1,34
2017-07-04 21:34:01,0.05519675925925926,2,77,4,81
2017-07-04 15:09:18,0.7931018518518519,13,1037,331,1368
2017-07-04 14:48:22,0.7785648148148148,12,958,310,1268
2017-07-04 14:11:23,0.7528819444444445,11,787,80,867
2017-07-04 13:19:25,0.3421412037037037,1,232,229,461
2017-07-04 13:19:54,0.43846064814814817,1,3,7,10
2017-07-03 09:03:00,0.11394675925925926,1,1,1,2
2017-07-03 11:17:28,0.1890625,1,2,3,5
2017-07-03 09:02:37,0.6553240740740741,1,71,37,108
2017-07-03 09:04:36,0.29833333333333334,1,10,5,15
2017-07-03 09:03:37,2.182511574074074,1,8,2,10
2017-07-09 15:33:21,8.978958333333333,2,4,1,5
2017-07-06 19:30:37,7.53306712962963,2,14,4,18
2017-07-02 23:30:22,87.87005787037037,46,73182,164932,238114
2017-07-02 13:55:51,0.011469907407407408,1,1,1,2
2017-07-02 16:36:35,0.3423148148148148,11,146,38,184
2017-07-06 20:39:56,7.628530092592593,14,97,42,139
2017-07-06 19:26:08,4.942418981481482,1,2,0,2
2017-07-01 19:18:39,0.13094907407407408,1,1,1,2
2017-07-06 22:46:45,5.878946759259259,1,52,1,53
2017-07-06 22:48:10,6.17181712962963,2,34,12,46
2017-06-30 15:29:23,0.3868402777777778,2,84,10,94
2017-06-30 11:38:36,0.08391203703703703,1,2,1,3
2017-06-30 11:39:43,0.07528935185185186,1,6,1,7
2017-06-30 11:40:01,0.09497685185185185,1,3,6,9
2017-07-06 19:26:22,6.491504629629629,1,13,0,13
2017-06-30 11:40:43,0.16502314814814814,1,2,0,2
2017-06-30 11:40:15,0.19891203703703703,1,2,54,56
2017-07-03 09:56:59,3.191539351851852,3,116,147,263
2017-06-30 03:37:41,0.03011574074074074,1,8,0,8
2017-06-30 03:37:18,0.09541666666666666,1,1,0,1
2017-06-30 11:43:34,0.6866898148148148,1,19,0,19
2017-06-30 11:42:04,0.8958217592592592,19,29,29,58
2017-07-07 23:57:22,10.222233796296296,1,30,20,50
2017-06-30 11:43:27,0.7538888888888889,2,4,4,8
2017-06-29 11:03:04,0.05991898148148148,1,20,20,40
2017-06-29 11:04:08,0.4455439814814815,1,4,0,4
2017-06-28 23:25:32,0.02763888888888889,1,4,9,13
2017-06-28 23:17:26,0.029953703703703705,1,14,3,17
2017-06-28 15:43:48,0.02179398148148148,1,1,3,4
2017-06-28 14:45:22,0.005451388888888889,1,47,1,48
2017-06-28 12:50:24,0.015810185185185184,1,19,10,29
2017-06-28 12:07:53,0.14945601851851853,1,3,0,3
2017-06-27 21:14:03,0.009398148148148149,1,2,2,4
2017-06-27 21:10:43,0.024120370370370372,1,6,4,10
2017-06-27 20:21:36,0.006898148148148148,1,6,4,10
2017-06-27 20:14:32,0.006273148148148148,1,2,2,4
2017-06-27 16:43:54,0.0077777777777777776,1,1,1,2
2017-06-27 11:41:03,0.10965277777777778,1,32,32,64
2017-06-27 11:46:12,0.19871527777777778,26,359,278,637
2017-06-27 11:43:54,0.41435185185185186,1,113,33,146
2017-06-27 16:07:21,0.7644212962962963,1,98,125,223
2017-06-27 11:46:37,0.6719907407407407,2,23,8,31
2017-06-26 17:39:58,0.9940509259259259,1,2,1,3
2017-06-26 15:18:45,0.039560185185185184,2,47,6,53
2017-06-26 15:10:54,0.04594907407407407,1,8,8,16
2017-06-26 11:15:24,0.02119212962962963,1,14,0,14
2017-06-26 11:04:37,0.1893287037037037,1,4,4,8
2017-06-26 02:49:40,0.02820601851851852,1,12,27,39
2017-06-26 22:04:01,0.930300925925926,1,45,13,58
2017-06-25 23:45:50,0.02246527777777778,1,1,1,2
2017-06-25 21:29:23,0.025694444444444443,1,4,4,8
2017-06-25 20:13:03,0.2249537037037037,2,2,2,4
2017-06-25 21:51:33,1.310474537037037,7,282,200,482
2017-06-25 14:02:56,0.00986111111111111,1,1,1,2
2017-06-25 10:49:54,0.018425925925925925,1,4,1,5
2017-06-25 10:52:43,0.13143518518518518,1,1,1,2
2017-06-25 21:51:46,0.97,4,389,214,603
2017-06-24 21:17:40,0.02607638888888889,1,3,2,5
2017-06-24 21:18:32,0.1135300925925926,1,1,0,1
2017-06-24 21:18:11,0.20172453703703705,1,6,87,93
2017-06-25 14:54:31,1.0208680555555556,4,202,85,287
2017-06-24 12:03:52,0.023993055555555556,1,1,1,2
2017-06-24 10:24:02,0.022222222222222223,1,5,0,5
2017-06-25 23:46:15,1.7157407407407408,1,1,1,2
2017-06-23 21:13:27,0.022083333333333333,1,1,1,2
2017-06-23 17:40:52,0.0018865740740740742,1,122,18,140
2017-06-23 16:21:34,0.015127314814814816,1,2,1,3
2017-06-23 17:22:02,0.061099537037037036,2,2,2,4
2017-06-23 15:44:56,1.7525347222222223,1,54,5,59
2017-06-23 15:01:54,0.0006018518518518519,1,4,0,4
2017-06-25 16:13:32,2.0884375,3,17,5,22
2017-06-23 11:55:06,0.09994212962962963,1,20,19,39
2017-06-23 14:05:05,0.33275462962962965,2,488,297,785
2017-06-22 21:28:58,77.78575231481481,44,70855,163567,234422
2017-06-22 21:28:53,0.11901620370370371,1,1,1,2
2017-06-22 16:35:27,0.1827314814814815,1,3,0,3
2017-06-22 11:39:13,0.07831018518518519,2,9,9,18
2017-06-23 15:46:00,1.5296180555555556,1,15,2,17
2017-06-22 00:38:51,0.23363425925925926,2,5,13,18
2017-06-21 04:47:37,1.209050925925926,1,4,1,5
2017-07-07 22:06:03,16.940185185185186,21,966,397,1363
2017-06-20 23:37:16,0.0008217592592592593,1,0,15,15
2017-06-20 23:33:15,0.0006828703703703704,12,1,4,5
2017-06-20 18:44:33,0.12851851851851853,2,3,4,7
2017-06-20 18:40:57,0.13922453703703705,1,4,1,5
2017-06-20 16:45:09,0.12025462962962963,1,6,6,12
2017-06-20 16:34:27,0.30256944444444445,1,1,1,2
2017-06-20 02:12:51,0.10157407407407408,1,4,1,5
2017-06-20 18:40:46,0.6974074074074074,1,13,1,14
2017-06-19 16:27:07,0.06393518518518519,1,4,8,12
2017-06-19 23:34:11,0.3740277777777778,1,1,1,2
2017-06-19 12:01:31,0.030740740740740742,1,1,0,1
2017-06-20 18:37:10,1.3570949074074075,1,8,0,8
2017-06-19 13:12:32,0.14690972222222223,1,28,3,31
2017-06-19 09:29:57,0.014375,1,17,0,17
2017-06-19 13:12:41,0.18255787037037038,1,1,0,1
2017-06-19 08:28:36,0.012372685185185184,1,1,1,2
2017-06-18 23:51:04,1.0297685185185186,1,25,24,49
2017-07-15 01:01:40,26.370601851851852,15,576,858,1434
2017-06-19 08:29:18,36.65087962962963,29,22398,9641,32039
2017-06-20 18:41:24,2.534895833333333,1,32,12,44
2017-06-18 23:38:50,0.8073263888888889,1,24,4,28
2017-06-19 09:30:28,1.2293865740740741,1,39,11,50
2017-06-19 09:31:15,1.2519328703703703,2,3,2,5
2017-06-19 09:31:28,1.2482291666666667,1,19,3,22
2017-06-19 09:31:37,1.2650810185185186,1,25,0,25
2017-06-18 23:50:56,0.9483101851851852,2,3,3,6
2017-06-18 00:57:42,0.13917824074074073,1,4,4,8
2017-06-18 00:59:30,0.9872453703703704,1,15,4,19
2017-06-20 18:41:41,4.677951388888889,1,9,3,12
2017-06-17 18:21:25,0.33868055555555554,4,19,8,27
2017-06-18 00:59:49,0.8025,1,17,0,17
2017-06-19 09:32:28,2.3135879629629628,1,3,1,4
2017-06-22 16:34:28,7.4275,4,383,79,462
2017-06-17 18:26:05,0.825925925925926,2,29,2,31
2017-06-16 20:38:27,0.325,1,1,1,2
2018-02-02 09:45:44,231.11233796296295,4,75453,25480,100933
2017-06-16 23:14:42,0.8260763888888889,1,34,4,38
2017-06-15 23:46:12,0.013287037037037036,1,4,4,8
2017-06-15 12:10:41,0.12806712962962963,1,10,3,13
2017-06-27 12:22:37,58.781087962962964,2,4,4,8
2017-06-20 17:43:09,5.484502314814815,2,35,7,42
2017-06-16 23:15:01,1.753599537037037,1,60,0,60
2017-07-06 22:12:13,21.712002314814814,1,6,2,8
2017-06-15 00:00:09,0.005231481481481481,1,22,4,26
2017-06-15 00:00:24,0.10377314814814814,1,6,2,8
2017-06-14 21:07:07,0.005462962962962963,1,2,7,9
2017-06-14 19:59:52,0.024398148148148148,1,14,7,21
2017-06-14 20:00:09,0.05258101851851852,1,11,0,11
2017-06-14 18:30:13,0.007592592592592593,1,4,4,8
2017-06-14 18:08:01,0.009131944444444444,1,11,0,11
2017-06-14 16:59:03,0.002789351851851852,1,8,4,12
2017-06-14 11:42:01,0.07543981481481482,1,1,1,2
2017-06-14 14:16:00,0.4782986111111111,1,9,8,17
2017-06-14 16:01:36,0.6843634259259259,6,229,36,265
2017-06-13 18:46:22,0.014282407407407407,1,32,8,40
2017-06-23 17:36:55,10.323483796296296,3,923,595,1518
2017-06-18 00:57:10,4.74537037037037,2,937,225,1162
2017-06-14 16:01:27,1.610636574074074,4,184,8,192
2017-06-12 21:55:33,0.0012847222222222223,2,2,2,4
2017-06-13 01:55:29,0.22446759259259258,1,2,41,43
2017-06-12 22:39:31,0.09458333333333334,1,1,1,2
2017-06-12 22:51:49,0.11460648148148148,1,2,1,3
2017-06-14 11:37:03,1.7124421296296297,4,32,12,44
2017-06-12 18:02:17,0.06561342592592592,3,33,31,64
2017-06-13 01:55:36,0.40162037037037035,1,1,1,2
2017-06-12 10:53:20,67.34434027777777,41,68949,162957,231906
2017-06-12 10:41:19,0.22681712962962963,1,17,0,17
2017-06-12 10:26:23,0.2568402777777778,4,85,128,213
2017-06-12 08:58:03,0.23776620370370372,1,6,1,7
2017-06-12 08:54:03,0.30385416666666665,14,270,234,504
2017-06-12 01:11:12,0.00869212962962963,1,2,4,6
2017-06-11 20:53:13,0.017604166666666667,1,1,1,2
2017-06-24 00:43:27,0.03709490740740741,1,17,8,25
2017-06-11 15:47:29,0.021319444444444443,1,1,1,2
2017-06-11 10:04:35,0.02912037037037037,2,62,10,72
2017-06-11 08:43:01,0.11811342592592593,1,1,0,1
2017-06-11 08:42:43,0.21975694444444444,1,11,13,24
2017-06-11 08:42:00,0.3294212962962963,1,69,25,94
2017-06-11 15:01:32,0.6238078703703703,1,5,5,10
2017-06-11 00:29:09,0.03454861111111111,1,35,1,36
2017-06-10 18:26:51,0.021944444444444444,8,15,15,30
2017-06-11 15:07:36,1.0920486111111112,7,229,606,835
2017-06-10 15:26:02,0.04240740740740741,1,2,2,4
2017-06-10 13:06:50,0.0709375,1,26,5,31
2017-06-10 07:39:27,0.5490856481481482,1,341,198,539
2017-06-20 18:40:03,11.231168981481481,8,434,378,812
2017-06-09 21:08:09,0.028761574074074075,5,8,7,15
2017-06-11 15:13:43,1.8566666666666667,2,84,43,127
2017-06-09 17:15:56,0.01412037037037037,1,1,0,1
2017-06-09 17:46:25,0.04708333333333333,1,8,5,13
2017-06-09 17:46:02,0.05696759259259259,1,23,22,45
2017-06-09 17:46:34,0.06863425925925926,1,1,1,2
2017-06-09 16:09:37,0.046782407407407404,2,21,16,37
2017-06-09 14:22:29,0.02792824074074074,1,2,2,4
2017-06-09 13:08:07,0.24484953703703705,1,9,10,19
2017-06-09 13:07:03,0.264525462962963,1,1,1,2
2017-06-09 13:05:26,0.2973032407407407,1,1,1,2
2017-06-09 13:06:39,0.44979166666666665,2,22,16,38
2017-06-09 01:14:16,0.010405092592592593,1,4,0,4
2017-06-09 18:12:40,1.9686921296296296,9,350,141,491
2017-06-08 17:10:49,0.025358796296296296,1,4,8,12
2017-06-23 15:53:10,15.011909722222223,4,71,13,84
2017-06-15 09:04:23,6.744548611111111,1,6,6,12
2017-06-08 13:07:40,0.01087962962962963,1,8,0,8
2017-06-08 12:58:22,0.025798611111111112,2,350,316,666
2017-06-08 12:33:28,0.02172453703703704,2,2,2,4
2017-06-08 11:23:41,0.06465277777777778,1,1,0,1
2017-06-08 11:24:28,0.3109375,1,33,14,47
2017-06-08 11:23:57,0.3678587962962963,1,6,0,6
2017-06-07 22:52:57,0.018622685185185187,1,14,0,14
2017-06-25 19:43:27,17.986412037037038,1,6,0,6
2017-06-07 18:05:54,0.012604166666666666,1,2,8,10
2017-06-07 18:08:35,0.050763888888888886,1,9,1,10
2017-06-07 18:09:26,0.0954050925925926,3,74,41,115
2017-06-07 16:59:29,0.0956712962962963,1,7,7,14
2017-06-07 15:23:27,0.03724537037037037,7,165,60,225
2017-06-07 13:57:59,0.13435185185185186,1,1,5,6
2017-06-07 13:57:31,0.14118055555555556,1,1,1,2
2017-06-07 10:28:16,0.007465277777777778,1,8,7,15
2017-06-07 08:15:35,0.004074074074074074,1,2,2,4
2017-06-07 07:57:48,0.024189814814814813,1,1,1,2
2017-06-06 18:43:02,0.04494212962962963,1,2,2,4
2017-06-23 16:50:54,17.017002314814814,3,117,2,119
2017-06-07 18:16:53,1.1488773148148148,4,50,6,56
2017-06-06 14:44:49,0.022256944444444444,1,2,2,4
2017-06-06 14:07:07,0.07118055555555555,1,26,18,44
2017-06-06 11:19:06,0.10386574074074074,1,57,57,114
2017-06-06 11:20:08,0.16571759259259258,9,67,45,112
2017-06-06 11:19:30,0.20037037037037037,1,1,1,2
2017-06-08 11:40:12,2.2909375,1,7,2,9
2017-06-06 11:31:58,0.29875,1,188,82,270
2017-06-06 02:07:35,0.002511574074074074,1,6,6,12
2017-06-06 01:56:37,0.012962962962962963,3,70,63,133
2017-06-06 01:55:57,0.024293981481481482,1,2,2,4
2017-06-05 22:09:14,0.0862037037037037,2,10,16,26
2017-06-06 01:59:14,0.2908912037037037,3,4,1,5
2017-06-06 17:30:17,0.9439467592592593,1,45,17,62
2017-06-08 13:22:02,2.8159722222222223,2,23,6,29
2017-06-05 17:18:26,0.10883101851851852,1,7,3,10
2017-06-05 16:18:57,0.07936342592592592,1,4,2,6
2017-06-05 15:02:42,0.01337962962962963,1,180,0,180
2017-06-05 15:10:40,0.02380787037037037,1,5,1,6
2017-06-05 13:20:46,0.015034722222222222,1,27,9,36
2017-06-05 12:13:20,0.020856481481481483,1,18,4,22
2017-06-05 08:03:01,0.17997685185185186,1,0,1,1
2017-06-05 08:03:39,0.20098379629629629,1,1,1,2
2017-06-05 10:09:30,0.4031712962962963,2,63,1,64
2017-06-05 08:08:08,0.24903935185185186,1,49,1,50
2017-06-05 08:08:31,0.23927083333333332,1,2,0,2
2017-06-05 01:24:18,0.015821759259259258,1,36,0,36
2017-06-05 00:43:03,0.007430555555555556,1,23,23,46
2017-06-04 23:02:20,0.009918981481481482,1,2,2,4
2017-06-04 23:03:45,56.02153935185185,3,37,8,45
2017-06-06 14:56:11,2.0109837962962964,11,1502,1362,2864
2017-06-06 17:29:43,2.057303240740741,3,31,22,53
2017-06-05 11:24:01,0.8447569444444445,2,79,1,80
2017-06-04 15:13:22,0.012094907407407407,8,120,125,245
2017-06-04 15:13:38,0.19501157407407407,1,37,4,41
2017-06-04 15:07:40,0.054155092592592595,1,99,31,130
2017-06-04 14:26:08,0.010775462962962962,1,501,547,1048
2017-06-04 23:31:11,0.4107638888888889,6,1023,729,1752
2017-06-05 14:37:44,1.0686689814814814,5,576,135,711
2017-06-04 13:18:42,0.006527777777777778,1,2,2,4
2017-06-04 12:51:07,0.03805555555555556,1,1,1,2
2017-06-04 12:52:26,0.05541666666666667,1,1,1,2
2017-06-04 12:52:03,0.06474537037037037,1,3,2,5
2017-06-04 12:51:36,0.0828125,2,85,2,87
2017-06-04 12:56:32,0.25283564814814813,1,8,0,8
2017-06-04 12:56:11,0.20684027777777778,1,0,8,8
2017-06-04 14:14:26,0.3045949074074074,2,193,32,225
2017-06-04 12:59:53,0.3654050925925926,1,9,0,9
2017-06-04 12:59:40,0.29314814814814816,2,153,1,154
2017-06-04 13:00:09,0.36072916666666666,1,23,0,23
2017-06-04 12:58:58,0.3919328703703704,2,200,109,309
2017-06-04 12:57:02,0.9642476851851852,1,79,0,79
2017-06-04 13:00:16,0.40708333333333335,1,1,1,2
2017-06-04 02:25:19,0.020902777777777777,1,1,1,2
2017-06-03 23:22:38,0.015833333333333335,1,2,0,2
2017-06-03 22:11:15,0.4394212962962963,1,23,9,32
2017-06-03 13:13:12,0.0036805555555555554,1,2,0,2
2017-06-03 12:40:24,0.11474537037037037,1,8,9,17
2017-06-03 18:51:09,0.5369560185185185,3,2086,679,2765
2017-06-03 12:40:48,1.1983912037037037,1,0,8,8
2017-06-03 12:40:56,0.43150462962962965,1,5,5,10
2017-06-03 12:43:11,0.4881712962962963,1,4,2,6
2017-06-04 23:10:14,2.175763888888889,10,19,19,38
2017-06-02 18:11:13,0.021458333333333333,1,2,2,4
2017-06-02 16:09:29,0.01824074074074074,1,1,0,1
2017-06-03 12:42:48,0.9520949074074074,3,3,3,6
2017-06-05 08:09:15,2.8255902777777777,2,85,25,110
2017-06-02 14:19:11,0.07619212962962962,1,1,0,1
2017-06-02 14:18:55,0.71625,1,268,262,530
2017-06-02 01:49:57,0.08680555555555555,1,4,0,4
2017-09-30 20:05:24,121.0075,4,44686,19260,63946
2017-06-01 13:29:15,0.017546296296296296,4,54,9,63
2017-06-01 15:24:30,0.12049768518518518,2,41,47,88
2017-06-01 12:20:36,0.07434027777777778,1,23,3,26
2017-06-01 15:25:11,0.2441087962962963,1,19,16,35
2017-06-01 15:26:00,0.25903935185185184,1,34,6,40
2017-06-01 15:27:16,0.49947916666666664,1,55,47,102
2017-06-01 15:27:36,0.5157407407407407,1,3,40,43
2017-06-01 02:20:10,0.014884259259259259,1,9,1,10
2017-06-01 15:33:58,0.6102777777777778,1,4,1,5
2017-06-05 14:07:44,4.572962962962963,3,314,127,441
2017-05-31 18:28:45,0.1552662037037037,10,217,134,351
2017-05-31 18:27:18,1.0282523148148148,1,171,144,315
2017-05-31 18:27:35,1.0280555555555555,1,47,9,56
2017-05-31 16:46:58,0.12855324074074073,2,171,171,342
2017-05-31 15:09:18,0.08839120370370371,2,36,29,65
2017-05-31 13:11:34,0.32599537037037035,1,36,7,43
2017-05-31 13:10:27,0.33416666666666667,1,1,1,2
2017-05-31 13:30:27,0.4743287037037037,1,8,4,12
2017-05-31 15:09:29,0.5508564814814815,1,6,0,6
2017-05-31 18:30:39,1.029050925925926,1,57,7,64
2017-05-31 01:16:29,0.3093287037037037,1,14,1,15
2017-05-31 18:30:56,1.0278587962962964,1,54,13,67
2017-05-31 01:13:31,0.3075462962962963,1,18,8,26
2017-05-31 01:11:54,0.30650462962962965,1,18,1,19
2017-05-31 01:11:30,0.30831018518518516,1,35,3,38
2017-05-31 18:31:14,1.029236111111111,1,45,7,52
2017-05-31 18:32:12,1.0303587962962963,1,53,13,66
2017-05-31 18:34:51,1.0324652777777779,1,47,9,56
2017-05-31 00:14:27,0.10943287037037037,2,3,2,5
2017-05-30 21:09:03,0.003564814814814815,1,178,0,178
2017-05-30 20:14:32,0.048240740740740744,1,2,1,3
2017-05-31 00:14:52,17.30752314814815,26,11488,4786,16274
2017-05-30 20:56:31,0.09810185185185186,2,80,7,87
2017-05-31 19:36:25,1.07625,2,1501,700,2201
2017-05-30 20:30:06,0.11990740740740741,2,92,17,109
2017-05-30 20:28:59,0.11853009259259259,1,45,26,71
2017-05-31 00:15:10,0.27550925925925923,1,45,13,58
2017-05-30 16:39:28,0.017719907407407406,1,1,1,2
2017-05-31 18:38:17,1.1929976851851851,4,18,9,27
2017-05-30 17:06:01,0.07729166666666666,1,57,28,85
2017-05-31 18:38:45,1.1500810185185186,1,21,4,25
2017-05-31 18:39:36,1.1718171296296296,1,58,48,106
2017-05-30 14:11:45,0.01556712962962963,1,1,0,1
2017-05-30 13:12:12,0.23248842592592592,1,0,13,13
2017-05-30 13:13:05,0.2820138888888889,2,145,66,211
2017-05-30 10:29:49,0.3849652777777778,1,6,0,6
2017-05-30 13:28:56,0.5062615740740741,2,120,15,135
2017-05-30 13:03:35,0.4852199074074074,1,61,15,76
2017-05-30 10:32:34,0.38643518518518516,1,6,0,6
2017-05-30 10:32:10,0.3877083333333333,1,26,10,36
2017-05-30 01:04:44,0.0007175925925925926,1,1,1,2
2017-05-30 13:31:00,0.617824074074074,4,11,10,21
2017-05-30 13:16:15,0.7241666666666666,1,42,11,53
2017-05-31 15:07:26,1.8692939814814815,6,70,31,101
2017-05-30 13:11:15,0.8605671296296297,1,44,39,83
2017-05-29 15:49:54,0.022175925925925925,1,1,1,2
2017-05-29 16:02:32,0.12618055555555555,1,13,0,13
2017-05-29 16:02:45,0.14844907407407407,1,5,1,6
2017-05-29 16:03:03,0.15608796296296296,1,19,0,19
2017-05-29 16:03:15,0.18296296296296297,1,15,0,15
2017-05-29 16:03:37,0.1633564814814815,1,61,0,61
2017-05-29 16:20:53,0.20972222222222223,2,50,41,91
2017-05-29 15:52:03,0.287662037037037,1,1,1,2
2017-05-29 16:17:52,0.6140277777777777,1,100,79,179
2017-05-29 15:52:27,0.6912268518518518,1,1,1,2
2017-05-29 15:52:46,0.7204398148148148,1,15,9,24
2017-05-29 16:18:07,3.1077083333333335,7,14,13,27
2017-05-28 17:14:45,0.041296296296296296,1,8,6,14
2017-05-28 17:15:36,0.0677662037037037,1,6,4,10
2017-05-28 17:11:30,0.09467592592592593,1,1,1,2
2017-05-28 17:11:48,0.10072916666666666,1,1,1,2
2017-05-28 14:32:30,0.0005787037037037037,1,3,3,6
2017-05-29 16:04:00,1.2873263888888888,1,74,21,95
2017-05-29 16:04:38,1.2255324074074074,1,60,3,63
2017-05-29 16:05:01,1.3732291666666667,4,44,21,65
2017-05-29 16:05:21,1.279988425925926,1,15,9,24
2017-05-29 16:05:30,1.272164351851852,1,7,0,7
2017-05-28 14:25:46,0.34248842592592593,2,9,9,18
2017-05-28 14:25:55,7.274780092592593,7,1173,354,1527
2017-05-29 16:07:08,1.4826273148148148,1,56,26,82
2017-05-28 14:26:17,0.5246643518518519,1,1,0,1
2017-06-01 18:56:33,4.757291666666666,2,4928,2678,7606
2017-05-28 14:26:35,0.6374884259259259,1,22,5,27
2017-05-28 14:25:26,0.6411689814814815,6,70,50,120
2017-05-29 15:56:14,1.7698958333333332,1,46,10,56
2017-05-27 21:27:55,0.07148148148148148,1,1,1,2
2017-05-28 14:45:43,0.9164583333333334,1,3,1,4
2017-05-27 14:28:33,0.04790509259259259,4,13,7,20
2017-05-27 13:50:40,0.15721064814814814,9,79,69,148
2017-05-29 16:07:40,2.2290046296296295,1,31,9,40
2017-05-29 16:08:06,2.225601851851852,1,28,7,35
2017-05-29 16:08:27,2.1898958333333334,1,21,7,28
2017-09-30 21:06:10,126.42561342592593,2,59,10,69
2017-05-29 16:08:43,2.4636574074074074,1,8,1,9
2017-05-29 16:08:58,2.4546527777777776,1,4,1,5
2017-05-29 16:09:17,2.487696759259259,1,4,0,4
2017-06-25 19:42:55,29.555347222222224,1,88,15,103
2017-05-29 16:10:50,2.4373032407407407,1,13,0,13
2017-06-10 07:44:03,13.99883101851852,3,107,7,114
2017-05-29 16:11:17,2.46224537037037,1,7,1,8
2017-05-29 16:12:54,2.394953703703704,1,45,0,45
2017-05-29 16:13:11,2.4399421296296295,1,13,0,13
2017-05-29 16:14:17,2.3385300925925927,2,39,15,54
2017-05-29 16:12:35,2.522962962962963,1,16,5,21
2017-05-27 11:04:28,0.19133101851851853,1,2,2,4
2017-05-27 11:04:42,0.271712962962963,1,11,3,14
2017-05-29 16:01:37,2.615127314814815,1,16,1,17
2017-05-29 16:12:17,2.627650462962963,1,17,2,19
2017-05-26 22:54:00,0.017962962962962962,1,1,0,1
2017-05-26 22:53:49,0.08119212962962963,1,7,1,8
2017-05-26 22:53:39,0.10961805555555555,3,9,1,10
2017-05-26 22:53:26,0.11209490740740741,1,10,8,18
2017-05-26 22:55:08,0.27291666666666664,1,32,7,39
2017-05-26 17:59:46,22.87261574074074,11,13707,5832,19539
2017-05-26 16:22:24,0.028043981481481482,1,10,11,21
2017-05-26 16:22:30,0.03466435185185185,1,5,3,8
2017-05-27 14:55:09,0.9987037037037036,3,25,7,32
2017-05-26 14:34:09,0.04261574074074074,1,0,13,13
2017-05-26 14:35:26,0.24125,1,2,2,4
2017-06-25 19:42:37,30.393113425925925,2,11406,4909,16315
2017-05-26 12:13:27,0.09873842592592592,1,26,0,26
2017-06-28 23:43:11,33.59269675925926,2,11429,4905,16334
2017-05-26 12:09:13,0.2329050925925926,2,6,5,11
2017-05-26 12:05:53,0.29584490740740743,1,39,9,48
2017-05-26 12:07:49,0.28627314814814814,1,1,1,2
2017-05-26 12:10:38,0.2902662037037037,1,43,22,65
2017-05-26 01:25:42,0.019884259259259258,1,33,12,45
2017-05-25 19:14:40,0.017997685185185186,1,3,1,4
2017-05-25 19:14:57,0.031342592592592596,1,9,3,12
2017-05-25 19:15:14,0.03611111111111111,1,3,0,3
2017-05-25 16:59:19,0.0038541666666666668,1,5,0,5
2017-05-25 16:59:55,0.03765046296296296,1,2,0,2
2017-05-25 15:09:14,0.019085648148148147,1,16,12,28
2017-05-25 19:15:42,0.1941550925925926,1,4,0,4
2017-05-25 14:27:45,0.013229166666666667,1,4,0,4
2017-05-25 14:07:38,0.11350694444444444,1,51,9,60
2017-05-25 14:28:15,0.10938657407407408,1,1,1,2
2017-05-25 12:06:11,0.12405092592592593,2,20,20,40
2017-05-25 12:14:36,0.3186111111111111,5,7,12,19
2017-05-25 12:05:55,0.18719907407407407,1,1,1,2
2017-05-29 16:01:09,4.387175925925926,2,2,2,4
2017-05-25 12:15:13,0.2401736111111111,1,5,5,10
2017-05-25 12:09:56,0.2777777777777778,1,46,1,47
2017-05-25 12:09:26,0.28097222222222223,1,80,99,179
2017-05-29 15:59:19,4.452094907407408,1,11,6,17
2017-05-25 03:22:47,0.024224537037037037,1,27,6,33
2017-05-25 03:23:14,0.06905092592592593,1,3,3,6
2017-05-25 01:30:30,0.009837962962962963,1,4,4,8
2017-05-25 01:08:06,0.002662037037037037,1,1,1,2
2017-05-26 12:14:04,1.4846296296296295,1,36,2,38
2017-05-25 00:23:55,0.021435185185185186,1,1,1,2
2017-05-25 14:38:03,0.9579282407407408,1,4,0,4
2017-05-24 14:39:10,0.002951388888888889,1,1,1,2
2017-05-24 15:55:16,0.07222222222222222,1,15,37,52
2017-05-24 13:36:10,0.011319444444444444,1,8,0,8
2017-06-03 18:50:53,10.493298611111111,8,3326,2081,5407
2017-05-24 15:57:33,0.9033680555555555,1,4,0,4
2017-05-24 12:32:53,0.32689814814814816,1,12,0,12
2017-05-23 22:45:06,0.1013425925925926,1,1,1,2
2017-05-23 21:26:23,0.09359953703703704,1,8,8,16
2017-05-24 02:22:46,0.32135416666666666,1,10,4,14
2017-05-23 19:32:43,0.0419212962962963,1,22,0,22
2017-05-23 16:11:40,0.6352199074074074,1,291,90,381
2017-05-23 17:45:43,0.16458333333333333,2,233,27,260
2017-05-23 14:34:29,0.15586805555555555,1,74,4,78
2017-05-23 21:37:24,0.7686574074074074,1,55,3,58
2017-05-23 13:04:24,0.07181712962962963,2,80,13,93
2017-05-23 11:08:02,23.958761574074074,1,0,1,1
2017-05-23 11:10:42,0.1471875,1,36,14,50
2017-05-23 11:09:54,1.6633217592592593,1,38,38,76
2017-05-23 11:08:17,2.811423611111111,1,8,6,14
2017-06-01 18:56:56,9.691805555555556,1,28,2,30
2017-05-23 11:12:19,0.3496296296296296,1,41,6,47
2017-05-23 11:12:45,0.36212962962962963,1,2,2,4
2017-05-23 18:05:53,0.6907175925925926,1,1,1,2
2017-07-13 20:15:32,51.843599537037036,85,3991,2307,6298
2017-05-23 00:50:05,0.013587962962962963,1,3,3,6
2017-05-23 00:27:25,0.1413310185185185,1,0,1,1
2017-05-22 21:12:29,0.020787037037037038,1,30,1,31
2017-05-22 19:50:59,0.10347222222222222,1,51,12,63
2017-05-22 17:36:21,0.14386574074074074,3,39,2,41
2017-05-22 17:35:49,0.1423611111111111,2,433,83,516
2017-05-22 15:58:42,0.07827546296296296,1,1,0,1
2017-05-22 14:26:55,0.01810185185185185,1,45,45,90
2017-05-22 15:58:58,0.09708333333333333,1,271,1,272
2017-05-23 00:53:02,0.4690162037037037,2,38,9,47
2017-05-22 15:58:50,0.09883101851851851,1,13,6,19
2017-05-22 14:29:48,0.037696759259259256,1,13,6,19
2017-05-22 14:27:20,0.03710648148148148,1,40,3,43
2017-05-22 14:03:51,46.47664351851852,39,53831,156653,210484
2017-05-22 12:57:50,0.08349537037037037,1,4,1,5
2017-05-22 13:01:03,0.24868055555555554,3,29,23,52
2017-05-22 13:01:28,0.2518634259259259,1,9,4,13
2017-05-22 13:02:31,0.3542592592592593,1,1,1,2
2017-05-22 04:00:07,0.7233217592592592,1,25,1,26
2017-05-22 02:45:55,0.017280092592592593,1,32,28,60
2017-05-25 03:18:09,3.073159722222222,1,61,7,68
2017-05-21 19:38:09,0.011469907407407408,1,3,1,4
2017-05-21 19:13:11,0.021296296296296296,1,3,2,5
2017-06-03 23:39:39,13.19644675925926,7,800,199,999
2017-05-21 22:20:14,0.15282407407407408,6,97,33,130
2017-05-22 13:01:54,18.66576388888889,9,13693,5822,19515
2017-05-21 16:52:51,0.03965277777777778,1,11,11,22
2017-05-21 11:32:13,0.02962962962962963,1,12,10,22
2017-05-21 09:24:00,0.06511574074074074,2,38,29,67
2017-05-21 09:25:00,0.08594907407407408,1,1,3,4
2017-05-20 23:16:55,0.016805555555555556,1,3,0,3
2017-05-24 15:55:00,3.755196759259259,12,175,42,217
2017-05-20 21:30:21,0.0018865740740740742,1,3,3,6
2017-05-22 13:40:05,1.7225578703703703,1,41,1,42
2017-05-20 17:42:44,0.029965277777777778,1,26,3,29
2017-05-20 19:06:10,0.10143518518518518,1,21,3,24
2017-05-20 18:01:06,0.06122685185185185,1,30,14,44
2017-05-20 17:42:58,0.08291666666666667,1,53,4,57
2017-05-20 16:15:44,0.02533564814814815,1,42,42,84
2017-05-20 15:48:34,0.014537037037037038,1,9,8,17
2017-05-20 15:50:11,6.957048611111111,20,2206,882,3088
2017-05-20 17:42:28,0.10680555555555556,1,16,0,16
2017-05-20 15:32:44,0.025787037037037035,2,30,41,71
2017-05-20 15:01:14,0.0038773148148148148,1,2,2,4
2017-05-20 15:09:40,0.01425925925925926,1,7,8,15
2017-05-20 14:48:49,0.4834375,1,4,9,13
2017-05-20 14:56:31,0.014074074074074074,1,64,9,73
2017-05-22 13:42:11,1.9791203703703704,1,198,25,223
2017-05-20 12:58:13,0.08307870370370371,5,73,20,93
2017-05-20 13:13:51,0.36052083333333335,1,53,38,91
2017-05-20 11:38:27,0.1254976851851852,1,7,7,14
2017-05-20 11:38:33,0.1382175925925926,1,1,1,2
2017-05-20 11:38:13,0.33633101851851854,1,1,1,2
2017-05-20 11:39:04,0.37710648148148146,1,9,4,13
2017-05-20 13:12:29,0.4816435185185185,1,14,2,16
2017-05-19 23:26:47,0.052314814814814814,1,8,1,9
2017-05-19 22:27:13,0.008333333333333333,1,17,2,19
2017-05-19 21:32:38,0.01826388888888889,1,113,0,113
2017-05-19 21:33:43,0.06886574074074074,1,1,1,2
2017-05-19 19:19:42,0.0030671296296296297,1,1,1,2
2017-05-29 16:22:22,9.937094907407408,1,155,80,235
2017-05-19 18:55:16,0.09550925925925927,1,3,1,4
2017-05-20 15:31:47,1.0003125,7,1154,1005,2159
2017-05-19 14:54:48,0.0031018518518518517,1,0,19,19
2017-05-19 14:55:10,0.006446759259259259,1,28,1,29
2017-05-19 14:21:52,0.05609953703703704,3,57,10,67
2017-05-19 18:58:13,0.3116550925925926,11,110,83,193
2017-05-19 13:21:34,1.9394212962962962,1,6,66,72
2017-05-19 18:19:14,0.05769675925925926,1,27,1,28
2017-05-19 14:22:11,0.7289814814814815,13,27,27,54
2017-05-19 09:42:03,0.016412037037037037,1,8,8,16
2017-05-19 09:44:01,0.163125,1,4,2,6
2017-05-19 09:44:29,0.17722222222222223,1,15,21,36
2017-05-22 13:06:07,3.4166319444444446,3,180,229,409
2017-05-19 09:43:21,0.545625,1,8,4,12
2017-05-19 09:41:45,0.34225694444444443,1,98,100,198
2017-05-19 19:05:33,0.7559259259259259,7,485,92,577
2017-05-19 00:41:57,0.18556712962962962,1,1,1,2
2017-05-19 01:11:24,0.209375,1,13,9,22
2017-05-19 01:11:17,0.19875,1,1,1,2
2017-05-19 00:42:21,0.05216435185185185,3,25,8,33
2017-06-01 18:53:38,13.958194444444445,5,65,90,155
2017-05-19 23:28:25,1.1488541666666667,4,2163,760,2923
2017-05-18 17:14:04,0.03454861111111111,1,15,17,32
2017-05-18 17:14:58,0.0977662037037037,1,16,1,17
2017-05-19 09:42:55,0.950625,1,122,55,177
2017-05-18 13:43:11,0.15101851851851852,1,46,32,78
2017-05-18 10:48:42,0.03320601851851852,1,52,52,104
2017-05-18 10:48:35,0.05414351851851852,1,154,138,292
2017-05-18 11:57:58,0.21268518518518517,1,16,9,25
2017-05-18 01:05:30,0.053599537037037036,1,18,2,20
2017-05-17 22:38:18,0.17135416666666667,1,9,9,18
2017-05-17 22:38:02,0.2228125,1,14,5,19
2017-05-17 15:50:39,0.05994212962962963,1,18,12,30
2017-05-18 19:10:42,1.247025462962963,2,152,10,162
2017-05-17 13:36:35,0.17005787037037037,1,1,0,1
2017-05-17 13:36:57,0.2618171296296296,1,1,1,2
2017-05-17 13:38:16,0.32386574074074076,1,12,12,24
2017-05-17 00:54:41,0.03121527777777778,1,1,1,2
2017-05-16 22:54:24,0.011574074074074073,1,37,3,40
2017-05-16 22:41:16,0.03019675925925926,1,54,6,60
2017-05-16 22:24:46,0.2493287037037037,1,31,26,57
2017-05-16 22:25:11,3.2313541666666667,15,1671,562,2233
2017-05-16 16:14:23,0.057743055555555554,1,1,0,1
2017-05-16 10:12:38,0.026041666666666668,1,3,2,5
2017-05-16 10:10:10,0.013935185185185186,1,4,4,8
2017-05-16 10:12:30,0.10498842592592593,2,9,3,12
2017-05-16 10:06:39,0.05331018518518518,1,44,14,58
2017-05-16 01:35:18,0.012280092592592592,1,2,2,4
2017-05-15 20:36:45,0.05738425925925926,1,3,3,6
2017-05-15 20:36:38,0.06386574074074074,1,1,1,2
2017-05-15 19:20:56,0.03365740740740741,1,14,4,18
2017-05-15 22:12:07,0.1776851851851852,2,4,4,8
2017-05-15 16:05:28,0.06479166666666666,1,2,2,4
2017-05-16 00:54:18,0.3180324074074074,4,66,9,75
2017-05-29 16:23:28,14.458680555555556,35,1305,1332,2637
2017-05-14 23:23:59,0.06420138888888889,1,8,148,156
2017-05-14 15:38:29,0.016875,1,1,1,2
2017-05-15 22:41:09,1.3827314814814815,1,61,27,88
2017-05-14 14:30:14,0.09953703703703703,11,65,66,131
2017-05-14 10:57:55,0.018194444444444444,1,5,1,6
2017-05-14 10:57:13,0.2965625,1,1,0,1
2017-05-14 01:22:49,0.21663194444444445,2,3,20,23
2017-05-13 20:07:58,0.1045486111111111,1,1,1,2
2017-05-17 00:59:43,3.2723495370370372,5,10,25,35
2017-05-13 15:05:02,5.242847222222222,1,5,5,10
2017-05-13 13:56:12,0.01667824074074074,1,14,1,15
2017-05-14 10:58:51,0.942337962962963,1,1,1,2
2017-05-13 13:56:49,0.3267013888888889,2,14,14,28
2017-05-13 13:56:43,0.3975810185185185,1,1,1,2
2017-05-13 13:55:57,0.44581018518518517,1,54,41,95
2017-05-12 22:13:08,0.0125,1,43,45,88
2017-05-12 23:38:52,0.14299768518518519,1,13,1,14
2017-05-12 18:58:41,0.02621527777777778,1,1,1,2
2017-05-12 18:35:37,1.0182407407407408,2,147,25,172
2017-05-13 02:03:43,0.8865277777777778,2,26,33,59
2017-05-12 17:22:34,0.003703703703703704,1,1,7,8
2017-05-12 18:19:40,0.04739583333333333,3,3,3,6
2017-05-15 01:04:14,8.013599537037036,10,699,266,965
2017-05-12 17:09:21,5.6838194444444445,6,152,18,170
2017-05-12 15:46:37,0.0010300925925925926,1,1,1,2
2017-05-12 15:46:14,0.015868055555555555,1,1,1,2
2017-05-12 15:46:44,0.021643518518518517,1,83,39,122
2017-05-12 14:47:56,0.0042824074074074075,1,4,1,5
2017-05-12 14:47:49,0.006076388888888889,1,5,0,5
2017-05-12 12:46:22,0.006076388888888889,2,66,25,91
2017-05-12 12:44:10,0.04341435185185185,1,865,1155,2020
2017-05-12 12:43:06,0.08423611111111111,1,0,1,1
2017-05-12 12:32:14,0.09387731481481482,2,58,8,66
2017-05-12 12:32:36,0.19640046296296296,1,6,6,12
2017-05-12 12:32:48,0.2349652777777778,1,4,0,4
2017-05-12 20:04:42,1.6922453703703704,1,2,1,3
2017-05-12 12:33:55,2.416851851851852,1,5,0,5
2017-05-12 02:04:41,0.015775462962962963,1,13,176,189
2017-05-14 11:47:32,2.4432060185185187,2,27,76,103
2017-05-11 20:25:16,0.022604166666666668,1,26,0,26
2017-05-11 19:54:48,0.2733449074074074,1,7,0,7
2017-05-11 21:14:01,0.3360648148148148,1,6,4,10
2017-05-11 13:12:00,0.019780092592592592,1,1,1,2
2017-05-11 19:54:31,0.3094212962962963,2,3,3,6
2017-05-11 11:34:06,0.04887731481481482,1,5,1,6
2017-05-11 12:32:03,0.08577546296296296,1,8,4,12
2017-05-12 17:22:51,1.5048726851851852,1,13,7,20
2017-05-11 09:26:07,0.19609953703703703,1,75,31,106
2017-05-11 09:23:25,0.06760416666666667,1,1,1,2
2017-05-11 09:25:11,0.24332175925925925,1,57,1,58
2017-05-15 18:20:10,4.615590277777778,2,5,10,15
2017-05-11 09:27:02,0.2826851851851852,1,155,155,310
2017-05-11 00:57:30,0.005208333333333333,1,1,1,2
2017-05-11 00:22:41,0.004710648148148148,1,5,2,7
2017-05-10 23:45:42,0.011423611111111112,1,0,0,0
2017-05-14 10:59:41,3.484537037037037,2,9,11,20
2017-05-10 22:19:38,0.09246527777777777,2,159,17,176
2017-05-10 21:30:08,0.06972222222222223,1,6,1,7
2017-05-10 22:20:14,0.11116898148148148,2,2,2,4
2017-05-10 22:28:11,0.14179398148148148,3,89,50,139
2017-05-17 01:00:35,3.331875,1,55,10,65
2017-05-10 18:33:33,0.033622685185185186,1,2,1,3
2017-05-10 18:33:00,0.033310185185185186,1,3,2,5
2017-05-10 18:32:06,0.1479050925925926,3,80,7,87
2017-05-10 18:32:27,0.03231481481481482,1,2,2,4
2017-05-10 14:58:54,0.02175925925925926,1,21,1,22
2017-05-10 14:16:43,0.01224537037037037,1,1,0,1
2017-05-10 13:45:44,0.028877314814814814,1,49,2,51
2017-05-10 12:41:39,0.10958333333333334,1,1,1,2
2017-05-10 12:39:29,0.31429398148148147,1,1,1,2
2017-05-10 12:44:49,0.3612268518518518,1,95,8,103
2017-05-10 00:55:43,0.13041666666666665,1,67,15,82
2017-05-09 18:48:31,0.14293981481481483,2,123,5,128
2017-05-09 17:51:46,1.5985763888888889,1,1,6,7
2017-05-09 17:58:03,3.379375,1,23,15,38
2017-05-09 16:17:41,0.06247685185185185,1,9,0,9
2017-05-09 17:58:19,0.13697916666666668,2,68,6,74
2017-05-09 14:14:45,0.024016203703703703,1,10,10,20
2017-05-09 14:34:47,0.04103009259259259,2,2,1,3
2017-05-10 00:51:44,0.6011921296296296,1,17,5,22
2017-05-09 12:50:43,0.02724537037037037,2,54,57,111
2017-05-09 12:01:46,0.1622800925925926,4,424,232,656
2017-05-09 12:01:30,0.29907407407407405,1,4,1,5
2017-05-09 01:48:16,0.005659722222222222,1,1,0,1
2017-05-09 12:12:36,0.47052083333333333,1,6,6,12
2017-05-08 21:11:12,0.03967592592592593,9,76,12,88
2017-05-08 21:08:56,0.08986111111111111,1,8,4,12
2017-05-08 22:45:03,0.1791087962962963,3,52,10,62
2017-05-08 21:10:51,0.08222222222222222,1,5,6,11
2017-05-08 22:44:31,0.1227199074074074,2,96,21,117
2017-05-08 21:15:04,0.12436342592592593,6,50,0,50
2017-05-17 00:55:37,8.32136574074074,1,8,8,16
2017-05-08 16:55:43,0.1332523148148148,10,29,39,68
2017-05-08 16:24:56,0.075,3,26,26,52
2017-05-08 13:57:50,16.117118055555554,1,479,461,940
2017-05-08 14:49:54,0.11085648148148149,3,49,8,57
2017-05-08 13:52:51,0.10668981481481482,1,10,0,10
2017-05-08 13:58:39,0.13244212962962962,7,53,3,56
2017-05-08 13:03:17,0.11646990740740741,1,1,1,2
2017-05-08 13:56:01,3.812546296296296,4,268,2,270
2017-05-08 13:01:20,0.33631944444444445,1,0,0,0
2017-05-09 03:15:55,0.9745833333333334,1,5,7,12
2017-05-08 01:52:58,0.011712962962962963,1,1,1,2
2017-05-08 01:32:52,0.03616898148148148,2,34,8,42
2017-05-07 23:46:37,0.01017361111111111,1,183,217,400
2017-05-07 21:47:56,0.016030092592592592,1,2,2,4
2017-05-07 21:47:20,1.012199074074074,3,3398,1008,4406
2017-05-08 01:34:11,0.2511921296296296,1,2,2,4
2017-05-07 18:47:20,31.673506944444444,37,42873,151308,194181
2017-05-07 17:55:47,0.007210648148148148,1,219,219,438
2017-05-07 17:37:32,0.06084490740740741,4,13,13,26
2017-05-07 18:47:31,0.20576388888888889,5,503,124,627
2017-05-07 17:00:21,0.10679398148148148,1,13,2,15
2017-05-07 17:00:40,0.1253125,1,1,0,1
2017-05-07 14:40:58,0.06800925925925926,6,31,23,54
2017-05-07 13:20:35,5.018055555555556,1,72,70,142
2017-05-07 14:20:54,0.08708333333333333,6,1233,311,1544
2017-05-07 13:23:07,0.10822916666666667,3,33,48,81
2017-05-07 13:22:55,0.2129861111111111,2,66,20,86
2017-05-07 13:22:44,0.26383101851851853,2,17,16,33
2017-05-07 13:22:31,0.3539467592592593,2,9,8,17
2017-05-07 13:21:46,0.29680555555555554,2,24,6,30
2017-05-07 13:21:32,0.32840277777777777,2,5,7,12
2017-05-07 12:29:02,0.3827199074074074,2,4,6,10
2017-05-07 17:42:33,23.454027777777778,7,134,55,189
2017-05-07 12:44:29,0.4774305555555556,3,69,15,84
2017-05-07 01:09:58,0.0021064814814814813,1,2,2,4
2017-05-07 00:42:39,0.10322916666666666,1,52,5,57
2017-05-07 00:41:13,0.020752314814814814,2,16,9,25
2017-05-07 00:45:34,0.08045138888888889,4,175,14,189
2017-05-06 21:06:53,0.02445601851851852,2,40,2,42
2017-05-06 19:24:59,0.05799768518518519,1,2,16,18
2017-05-06 19:55:40,0.10530092592592592,2,17,16,33
2017-05-06 19:26:55,0.09678240740740741,3,103,96,199
2017-05-06 19:25:27,0.09144675925925926,1,3,2,5
2017-05-07 14:39:38,0.9392476851851852,1,243,0,243
2017-05-06 15:30:48,0.04106481481481482,3,14,12,26
2017-05-06 15:03:34,0.07143518518518518,3,13,8,21
2017-05-06 14:31:44,0.048900462962962965,1,1,1,2
2017-05-06 14:41:46,0.06229166666666667,1,3,3,6
2017-05-06 15:05:26,0.11121527777777777,1,4,0,4
2017-05-06 15:04:54,0.13145833333333334,2,139,51,190
2017-05-06 11:37:08,0.021840277777777778,4,19,19,38
2017-05-06 14:31:07,0.14579861111111111,1,70,31,101
2017-05-06 15:05:14,0.1867361111111111,5,96,62,158
2017-05-06 11:05:04,0.013877314814814815,2,26,13,39
2017-05-06 09:02:20,0.05030092592592592,1,6,0,6
2017-05-06 09:06:55,2.5025810185185184,3,211,0,211
2017-05-06 09:04:55,0.08684027777777778,1,1,1,2
2017-05-06 09:05:32,0.15990740740740741,1,14,39,53
2017-05-06 02:18:24,0.008333333333333333,1,26,4,30
2017-05-06 02:00:21,0.21875,2,53,16,69
2017-05-05 19:37:02,0.06225694444444444,1,89,67,156
2017-05-05 19:31:21,0.00869212962962963,1,2,1,3
2017-05-06 10:56:00,0.6650694444444445,1,1,0,1
2017-05-05 19:32:14,0.04019675925925926,1,3,3,6
2017-05-05 18:56:00,0.15731481481481482,5,135,22,157
2017-05-06 02:03:07,0.37604166666666666,1,5,5,10
2017-05-05 16:48:54,0.10767361111111111,4,121,83,204
2017-05-05 16:46:52,0.04915509259259259,1,7,8,15
2017-05-05 15:25:17,0.015648148148148147,1,40,40,80
2017-05-05 15:25:43,0.020555555555555556,1,3,2,5
2017-05-05 15:26:05,0.5762962962962963,4,213,19,232
2017-05-05 21:52:35,0.3893402777777778,1,3,0,3
2017-05-06 02:05:38,0.6529976851851852,7,568,192,760
2017-05-06 15:05:39,1.2962962962962963,4,25,27,52
2017-05-05 16:52:15,0.38862268518518517,4,4,6,10
2017-05-05 13:59:17,0.2586921296296296,1,1,1,2
2017-05-04 21:44:39,0.0673263888888889,1,50,8,58
2017-05-04 21:45:18,0.075625,2,58,63,121
2017-05-05 00:23:02,0.2247337962962963,6,159,36,195
2017-05-04 18:37:58,0.044537037037037035,1,1,7,8
2017-05-04 18:53:40,0.06359953703703704,1,6,6,12
2017-05-04 18:39:25,0.09670138888888889,1,6,1,7
2017-05-04 16:16:00,0.026064814814814815,1,2,2,4
2017-05-04 15:49:05,0.01849537037037037,1,2,1,3
2017-05-04 16:12:44,0.11847222222222223,4,116,96,212
2017-05-04 16:32:06,0.10603009259259259,3,198,157,355
2017-05-04 13:50:10,0.18435185185185185,1,2,2,4
2017-05-04 13:50:37,0.20320601851851852,1,4,0,4
2017-05-04 13:52:09,0.32155092592592593,1,23,7,30
2017-05-04 13:53:45,0.389224537037037,1,25,11,36
2017-05-04 21:41:35,0.9211111111111111,2,125,46,171
2017-05-03 23:28:11,1.1327777777777779,1,1,0,1
2017-05-03 23:42:04,0.054675925925925926,1,3,2,5
2017-05-08 01:35:25,4.173530092592593,3,207,90,297
2017-05-06 11:43:43,2.6089930555555556,5,365,117,482
2017-05-03 21:19:12,0.011111111111111112,1,165,0,165
2017-05-03 18:40:15,13.515254629629629,1,133,0,133
2017-08-22 16:33:58,112.88178240740741,26,65788,28661,94449
2017-05-03 21:36:02,0.24432870370370371,1,1,1,2
2017-05-03 21:36:19,0.26253472222222224,1,4,1,5
2017-05-03 19:28:30,0.20439814814814813,1,31,30,61
2017-05-03 14:59:32,0.046782407407407404,3,33,13,46
2017-05-03 14:59:52,0.05380787037037037,1,1,1,2
2017-05-03 12:02:15,0.012037037037037037,1,37,0,37
2017-05-04 13:56:06,1.135138888888889,3,759,270,1029
2017-05-03 09:39:31,0.027488425925925927,1,1,1,2
2017-05-03 12:23:18,0.14146990740740742,2,5,2,7
2017-05-03 09:39:14,0.03508101851851852,1,5,1,6
2017-05-04 02:39:50,0.7529398148148149,6,1444,336,1780
2017-05-03 09:31:22,0.069375,2,2,2,4
2017-05-03 10:20:38,0.20912037037037037,2,6440,2122,8562
2017-05-03 09:37:45,0.2024537037037037,2,4,1,5
2017-05-03 10:14:53,0.3679861111111111,1,0,1,1
2017-05-03 15:03:11,0.570787037037037,1,0,0,0
2017-05-03 00:28:48,0.0034375,1,1,1,2
2017-05-04 02:34:57,1.0928587962962963,4,6617,2295,8912
2017-05-03 15:02:18,0.6367592592592592,1,77,85,162
2017-05-03 21:18:14,0.9435069444444445,1,53,61,114
2017-05-03 09:40:09,0.5031481481481481,5,283,12,295
2017-05-02 21:04:41,0.0021759259259259258,1,23,0,23
2017-05-02 18:03:01,0.050520833333333334,1,14,1,15
2017-05-02 18:55:15,0.07971064814814814,2,13,1,14
2017-05-02 16:21:23,0.0639699074074074,2,21,4,25
2017-05-02 23:03:13,0.5638425925925926,1,2,0,2
2017-05-02 13:52:31,0.09015046296296296,1,4,1,5
2017-05-06 00:23:23,3.9247453703703705,4,82,6,88
2017-05-02 18:56:28,3.327164351851852,1,82,75,157
2017-05-03 12:03:17,1.4555092592592593,13,13922,4293,18215
2017-05-02 00:14:47,0.05381944444444445,5,366,12,378
2017-05-02 00:21:20,0.10141203703703704,1,2,2,4
2017-05-01 22:44:24,0.34141203703703704,9,151,34,185
2017-05-01 20:24:37,5.845300925925926,2,15,22,37
2017-05-02 00:15:15,0.27273148148148146,1,3,2,5
2017-05-02 18:05:21,1.0628472222222223,1,4,2,6
2017-05-02 18:08:44,1.1467245370370371,1,7,7,14
2017-05-13 15:13:18,0.02380787037037037,1,32,24,56
2017-05-01 16:13:11,0.10506944444444444,2,40,27,67
2017-05-10 02:47:25,9.075613425925926,5,14725,4393,19118
2017-05-01 16:14:27,0.15056712962962962,1,7,1,8
2017-05-02 18:08:22,1.2419791666666666,3,8,5,13
2017-05-01 14:20:57,0.1332986111111111,2,29,20,49
2017-05-02 18:18:43,1.4573148148148147,14,50,2,52
2017-05-04 21:48:49,4.00244212962963,2,9,9,18
2017-04-30 16:15:49,0.02263888888888889,2,12,5,17
2017-04-30 16:15:28,0.035486111111111114,1,2,0,2
2017-04-30 12:56:07,0.016886574074074075,3,21,12,33
2017-05-01 16:14:52,1.166724537037037,2,58,0,58
2017-04-30 12:58:33,0.05571759259259259,1,1,1,2
2017-04-30 12:50:50,0.05265046296296296,1,2,2,4
2017-04-30 12:51:12,0.0819212962962963,2,46,35,81
2017-04-30 15:35:15,0.2646875,6,125,14,139
2017-04-30 12:49:24,0.2585300925925926,1,12,43,55
2017-05-01 14:31:02,1.5897222222222223,6,19,16,35
2017-04-29 22:23:45,0.0707175925925926,6,17,14,31
2017-04-29 22:25:39,0.09049768518518518,4,108,7,115
2017-04-29 17:26:33,0.00038194444444444446,1,1,1,2
2017-04-29 22:28:42,0.2228587962962963,2,9,2,11
2017-05-03 00:04:17,3.8821180555555554,22,7777,2607,10384
2017-05-02 18:10:56,3.306423611111111,1,2,2,4
2017-04-29 08:50:11,0.074375,1,2,14,16
2017-04-29 12:35:17,0.26689814814814816,1,1,1,2
2017-04-29 12:29:13,0.3460185185185185,1,4,1,5
2017-04-29 13:23:27,0.4033101851851852,6,22,34,56
2017-04-30 12:51:32,1.7963194444444444,5,17,17,34
2017-05-04 13:55:14,5.609768518518519,1,3,13,16
2017-04-29 00:44:03,0.02943287037037037,1,13,0,13
2017-04-29 22:28:17,3.8707175925925927,1,90,11,101
2017-04-28 22:18:32,0.03707175925925926,1,93,29,122
2017-05-03 10:18:00,4.558738425925926,10,539,198,737
2017-04-28 22:21:36,0.12409722222222222,1,15,1,16
2017-04-28 15:54:03,0.0008796296296296296,1,26,23,49
2017-04-28 15:53:38,0.007546296296296297,1,1,1,2
2017-05-03 17:13:04,5.131377314814815,2,31,31,62
2017-04-28 14:45:25,0.016527777777777777,1,4,4,8
2017-04-28 14:44:57,0.029722222222222223,1,14,0,14
2017-05-02 19:07:12,4.235335648148149,2,69,7,76
2017-04-28 13:45:38,0.015555555555555555,1,2,1,3
2017-04-28 13:07:17,0.14104166666666668,1,1,1,2
2017-05-02 12:54:35,6.589340277777778,1,814,0,814
2017-04-28 13:07:49,0.26359953703703703,1,1,1,2
2017-04-28 13:08:24,0.34703703703703703,1,2,0,2
2017-04-28 13:10:59,0.4648263888888889,15,23,21,44
2017-04-28 13:11:37,22.44037037037037,35,30071,147637,177708
2017-04-28 13:10:41,0.7806481481481482,25,248,78,326
2017-04-28 13:11:21,0.5042129629629629,1,7,1,8
2017-04-28 13:12:38,0.5212731481481482,3,53,7,60
2017-04-28 13:11:54,0.5443402777777778,1,1,1,2
2017-04-28 14:45:42,0.6080324074074074,2,4,4,8
2017-04-27 23:59:19,0.008368055555555556,1,1,1,2
2017-04-27 23:58:46,0.015497685185185186,1,1,1,2
2017-04-29 22:27:50,1.9591435185185184,1,7,0,7
2017-04-27 23:21:27,0.006828703703703704,1,2,2,4
2017-04-27 23:21:39,0.041226851851851855,1,2,0,2
2017-04-27 22:16:44,0.0026967592592592594,2,17,1,18
2017-04-27 22:09:26,0.006793981481481482,1,2,2,4
2017-04-27 22:16:31,0.026689814814814816,1,2,2,4
2017-04-27 21:37:23,0.0009027777777777777,1,1,1,2
2017-04-27 20:32:39,0.04587962962962963,1,21,0,21
2017-04-30 13:12:15,2.7550578703703703,3,29802,144987,174789
2017-04-27 18:41:25,0.07612268518518518,2,8,1,9
2017-04-27 17:29:12,0.005393518518518519,1,1,1,2
2017-04-27 17:29:41,0.0290625,3,1,1,2
2017-04-27 16:04:29,0.013657407407407408,2,9,3,12
2017-04-27 15:54:34,0.023773148148148147,3,9,6,15
2017-04-27 15:00:03,0.02738425925925926,2,5,3,8
2017-04-27 15:07:16,0.0804050925925926,1,1,1,2
2017-04-27 13:22:19,0.027430555555555555,2,308,40,348
2017-04-27 15:06:47,0.10494212962962964,5,406,79,485
2017-04-27 13:17:56,0.06506944444444444,2,6,2,8
2017-04-27 10:02:41,0.12364583333333333,1,1,0,1
2017-04-27 10:02:56,0.1320486111111111,1,0,1,1
2017-04-29 22:27:31,2.7154050925925928,1,43,12,55
2017-05-03 09:43:37,6.14505787037037,10,130,48,178
2017-04-27 10:01:37,0.23635416666666667,1,11,6,17
2017-04-27 10:03:29,0.3027546296296296,1,53,22,75
2017-04-27 13:18:22,0.5149652777777778,1,19,0,19
2017-05-02 21:37:58,5.878043981481482,3,29,1,30
2017-05-04 02:36:37,7.085277777777778,1,6,4,10
2017-04-26 23:53:55,0.04535879629629629,1,4,1,5
2017-04-26 22:19:53,5.887789351851852,1,170,53,223
2017-04-26 20:32:24,0.06885416666666666,1,5,1,6
2017-04-26 20:33:55,9.60633101851852,5,87,8,95
2017-05-05 17:48:23,8.996099537037036,1,107,43,150
2017-04-26 17:33:11,0.00443287037037037,1,2,2,4
2017-04-26 16:48:44,0.007118055555555555,1,1,1,2
2017-04-26 18:09:02,0.16047453703703704,10,110,40,150
2017-04-26 16:47:23,0.11542824074074073,1,19,0,19
2017-04-26 13:45:47,0.02105324074074074,1,7,0,7
2017-04-26 13:45:58,0.017604166666666667,1,7,2,9
2017-04-26 13:46:15,4.561770833333333,1,366,78,444
2017-04-26 13:15:48,0.010752314814814815,1,8,4,12
2017-04-26 12:54:12,0.12568287037037038,1,4,3,7
2017-04-26 12:54:36,2.112048611111111,2,40,11,51
2017-04-26 13:45:27,0.37578703703703703,5,142,54,196
2017-04-26 12:55:15,1.7266898148148149,1,87,39,126
2017-04-26 02:40:28,0.00032407407407407406,1,23,16,39
2017-04-26 01:55:51,8.101851851851852e-05,1,1,1,2
2017-04-26 00:16:31,0.005914351851851852,1,0,0,0
2017-04-25 23:51:51,0.020439814814814813,1,5,0,5
2017-04-26 18:08:30,2.170162037037037,1,27,0,27
2017-04-25 18:35:20,0.033310185185185186,1,2,2,4
2017-04-25 18:14:35,0.05383101851851852,2,8,6,14
2017-04-26 01:48:13,0.3761921296296296,5,70,12,82
2017-04-25 21:26:47,0.19615740740740742,1,2,2,4
2017-04-25 21:26:53,0.20975694444444445,1,61,0,61
2017-04-25 21:26:33,0.24003472222222222,3,205,61,266
2017-04-25 15:37:52,0.017604166666666667,1,20,13,33
2017-04-25 14:44:49,0.08361111111111111,2,14,9,23
2017-04-25 13:03:52,0.06398148148148149,1,19,12,31
2017-04-25 09:17:53,0.010590277777777778,1,1,1,2
2017-04-25 13:15:37,0.2717013888888889,1,2,4,6
2017-04-26 01:47:44,0.9527083333333334,1,11,9,20
2017-04-25 13:16:09,0.40971064814814817,1,8,2,10
2017-04-25 02:44:44,0.02627314814814815,1,11,3,14
2017-05-11 01:47:38,16.018055555555556,2,18099,5013,23112
2017-04-25 13:04:50,0.5174074074074074,2,628,44,672
2017-04-25 02:45:28,0.1490277777777778,2,4,2,6
2017-05-02 21:37:27,9.170578703703704,1,58,0,58
2017-04-24 20:37:25,0.05324074074074074,1,117,6,123
2017-04-24 18:52:56,0.0003587962962962963,1,7,10,17
2017-04-25 13:06:07,0.8833564814814815,4,431,157,588
2017-04-24 18:19:34,0.09130787037037037,4,41,4,45
2017-04-24 18:19:52,0.09090277777777778,1,1,1,2
2017-04-24 18:20:17,0.12435185185185185,1,4,2,6
2017-04-24 20:39:16,0.20527777777777778,5,861,5,866
2017-04-24 15:30:30,0.023587962962962963,2,22,1,23
2017-04-24 15:31:02,0.07408564814814815,1,1,0,1
2017-04-24 13:10:15,0.06922453703703704,1,7,1,8
2017-04-25 13:06:25,1.1002199074074075,2,6,2,8
2017-06-02 20:21:36,39.56185185185185,1,4,0,4
2017-05-05 02:56:29,10.992662037037038,2,8,7,15
2017-04-24 02:10:33,0.005914351851851852,1,3,1,4
2017-05-18 23:14:30,11.937395833333333,17,2470,886,3356
2017-04-24 00:44:06,0.00912037037037037,1,6,8,14
2017-04-24 16:03:53,0.6646412037037037,1,136,1,137
2017-04-24 00:19:10,0.0384375,1,2,1,3
2017-04-24 00:18:41,0.04341435185185185,1,5,5,10
2017-04-23 20:15:10,0.00375,1,3,2,5
2017-04-25 00:47:31,1.2268287037037038,3,546,26,572
2017-04-23 19:34:34,0.04539351851851852,1,10,3,13
2017-04-23 17:08:32,0.10166666666666667,1,7,4,11
2017-04-23 17:09:00,0.09443287037037038,1,2,1,3
2017-05-01 15:42:13,8.625694444444445,5,76,14,90
2017-04-23 19:34:48,0.22746527777777778,1,1,0,1
2017-04-23 17:09:34,0.13568287037037038,1,9,0,9
2017-04-23 17:09:52,0.19420138888888888,5,31,9,40
2017-04-23 17:10:05,0.1734837962962963,1,6,6,12
2017-04-24 00:49:30,0.571412037037037,1,189,0,189
2017-04-23 12:19:55,4.167291666666666,1,1,1,2
2017-04-23 22:44:38,0.6621990740740741,7,47,7,54
2017-04-23 12:21:20,0.28107638888888886,1,4,15,19
2017-04-23 12:18:58,0.2801736111111111,1,27,13,40
2017-04-23 12:19:26,0.31734953703703705,1,1,1,2
2017-04-23 12:21:09,0.3274884259259259,1,1,0,1
2017-04-23 03:21:38,0.010428240740740741,1,1,1,2
2017-04-23 02:59:56,0.006585648148148148,1,2,0,2
2017-04-23 02:26:56,0.3226041666666667,9,996,686,1682
2017-04-27 12:42:23,4.522106481481481,11,5787,1328,7115
2017-04-23 02:22:34,0.2694097222222222,2,19,21,40
2017-04-22 18:22:47,0.06679398148148148,1,78,68,146
2017-04-22 20:28:55,0.201875,1,2,2,4
2017-04-22 15:28:02,0.04034722222222222,1,13,13,26
2017-09-05 21:17:07,137.8484837962963,1,39,1,40
2017-04-22 13:08:31,0.023900462962962964,1,1,1,2
2017-04-22 13:12:09,0.030636574074074073,1,1,0,1
2017-04-22 13:09:50,0.03585648148148148,1,2,1,3
2017-04-22 13:10:15,0.10692129629629629,1,1,1,2
2017-04-25 13:06:41,3.210277777777778,1,21,17,38
2017-04-22 13:11:58,0.2352662037037037,1,1,1,2
2017-04-23 19:45:03,1.6169212962962962,3,59,58,117
2017-04-23 02:31:40,0.9395370370370371,1,4,4,8
2017-04-23 18:33:45,0.2910185185185185,1,7,5,12
2017-04-22 15:28:37,0.5035416666666667,1,53,2,55
2017-04-22 15:29:03,0.5159722222222223,1,1,1,2
2017-04-22 15:30:35,0.5442939814814814,4,17,15,32
2017-04-22 15:29:47,0.6175462962962963,3,69,3,72
2017-04-22 02:26:26,0.017997685185185186,2,23,3,26
2017-04-22 02:23:18,1.168287037037037,12,435,252,687
2017-04-22 01:36:34,0.07079861111111112,1,4,2,6
2017-04-21 23:22:20,0.02516203703703704,1,2,1,3
2017-04-21 22:13:37,0.061030092592592594,1,29,9,38
2017-04-23 04:04:32,1.3885300925925925,2,2765,938,3703
2017-04-23 04:05:52,1.4438310185185186,2,2837,940,3777
2017-04-23 02:39:51,1.331724537037037,2,1725,923,2648
2017-04-22 01:33:24,0.32533564814814814,2,6,5,11
2017-04-21 17:53:48,0.012905092592592593,1,8,0,8
2017-04-21 17:23:03,0.0030208333333333333,1,2,0,2
2017-04-21 17:23:20,0.004837962962962963,2,2,2,4
2017-04-21 17:18:17,0.0025462962962962965,1,1,1,2
2017-04-21 16:06:44,0.00474537037037037,1,1,1,2
2017-04-24 02:49:09,2.1555092592592593,1,167,53,220
2017-04-21 16:07:18,0.013680555555555555,2,33,2,35
2017-04-21 16:09:05,0.02943287037037037,1,44,37,81
2017-04-21 14:47:16,0.10520833333333333,1,1,1,2
2017-04-21 14:45:14,0.10851851851851851,1,2,2,4
2017-04-21 16:11:20,0.20135416666666667,2,30,24,54
2017-04-21 15:26:24,0.19461805555555556,1,1,1,2
2017-04-22 00:30:36,0.7203240740740741,3,7,1,8
2017-04-21 14:44:15,0.3077662037037037,1,1,1,2
2017-04-21 14:43:58,0.5258217592592592,2,1,1,2
2017-04-21 16:18:58,0.6003819444444445,1,1,1,2
2017-04-21 14:46:33,0.5773958333333333,1,2,2,4
2017-04-23 02:43:43,2.1324768518518518,5,53,6,59
2017-04-21 01:29:01,0.16133101851851853,8,40,13,53
2017-04-21 01:27:46,0.12358796296296297,1,251,78,329
2017-04-21 01:26:53,6.996168981481482,3,194,63,257
2017-04-20 21:53:54,0.13049768518518517,2,2739,137528,140267
2017-04-21 01:29:11,0.29261574074074076,1,2,0,2
2017-04-21 01:28:46,0.32983796296296297,1,2,2,4
2017-04-21 01:28:39,0.34119212962962964,1,4,0,4
2017-04-20 15:18:10,0.07091435185185185,7,63,18,81
2017-04-20 15:13:07,0.05309027777777778,1,0,1,1
2017-04-20 15:19:06,0.06576388888888889,3,125,117,242
2017-04-21 16:17:22,1.1944560185185185,1,12,4,16
2017-04-22 17:48:56,3.576840277777778,2,877,277,1154
2017-04-21 01:30:02,0.6009143518518518,1,11,11,22
2017-04-25 23:22:51,5.5347685185185185,6,45,14,59
2017-04-20 11:09:31,0.041400462962962965,1,3,3,6
2017-04-21 01:30:16,0.6693981481481481,4,13,11,24
2017-04-21 17:15:25,1.8533449074074073,2,667,2,669
2017-04-21 17:16:26,2.1105555555555555,7,2233,432,2665
2017-04-23 12:23:28,3.1985532407407407,1,2,0,2
2017-04-23 03:21:10,68.45893518518518,13,7019,138996,146015
2017-04-20 11:22:55,0.3444097222222222,1,3,2,5
2017-04-20 02:00:03,0.004166666666666667,1,3,3,6
2017-04-20 01:54:25,0.00625,1,1,0,1
2017-04-20 01:54:03,0.02181712962962963,2,4,4,8
2017-04-21 01:30:59,1.0475347222222222,4,31,14,45
2017-04-20 01:12:14,0.04097222222222222,1,2,4,6
2017-04-21 16:17:56,1.7737731481481482,2,31,16,47
2017-04-21 16:20:00,1.8769097222222222,1,14,2,16
2017-04-19 21:21:01,0.046921296296296294,4,44,10,54
2017-04-19 20:19:43,0.01412037037037037,1,6,0,6
2017-04-19 21:47:51,0.0874074074074074,1,23,0,23
2017-04-19 21:16:43,0.07197916666666666,1,2,1,3
2017-04-23 02:22:23,3.3655092592592593,1,1,2,3
2017-04-19 20:19:20,0.1059837962962963,2,24,14,38
2017-04-19 20:19:33,0.1072337962962963,1,26,2,28
2017-04-19 17:21:24,0.004756944444444445,1,6,3,9
2017-04-19 17:20:52,0.03561342592592592,1,2,3,5
2017-04-19 17:21:45,0.031261574074074074,1,1,1,2
2017-04-19 15:46:24,0.0005324074074074074,1,1,1,2
2017-04-26 13:18:09,7.074247685185185,2,2,2,4
2017-04-19 15:19:23,0.016828703703703703,1,0,24,24
2017-04-19 14:40:46,6.018032407407407,7,9518,139325,148843
2017-04-19 14:40:25,0.0358912037037037,1,13,13,26
2017-04-19 14:41:31,0.03832175925925926,2,143,14,157
2017-04-19 15:28:35,0.09166666666666666,2,38,7,45
2017-04-19 13:37:43,0.1531597222222222,1,27,27,54
2017-04-19 12:54:48,0.006828703703703704,1,1,1,2
2017-04-19 12:20:36,0.025706018518518517,1,1,1,2
2017-04-19 12:52:19,3.178738425925926,4,85,20,105
2017-04-19 11:44:08,0.02665509259259259,2,2,1,3
2017-04-19 11:52:37,9.648784722222222,2,285,73,358
2017-04-19 12:21:00,0.18802083333333333,3,282,69,351
2017-04-19 13:39:47,0.2710763888888889,1,11,2,13
2017-04-19 12:58:28,0.2797222222222222,1,1,1,2
2017-04-19 12:18:51,0.36163194444444446,1,2,0,2
2017-04-19 12:20:05,0.8918518518518519,2,815,137016,137831
2017-04-19 12:21:15,0.4896990740740741,1,1,1,2
2017-04-19 01:55:20,0.11543981481481481,1,1,0,1
2017-04-23 22:38:37,5.120659722222222,9,8651,140074,148725
2017-04-19 13:37:18,0.618912037037037,3,396,90,486
2017-04-18 22:52:31,0.005706018518518518,1,2,2,4
2017-04-18 22:52:20,0.031053240740740742,1,7,7,14
2017-04-18 21:39:52,0.0006828703703703704,1,10,11,21
2017-04-18 21:34:50,0.008819444444444444,1,0,136844,136844
2017-04-18 20:29:39,0.0036342592592592594,1,11,1,12
2017-04-18 20:20:12,0.04608796296296296,5,115,12,127
2017-04-18 20:30:18,0.06145833333333333,1,185,4,189
2017-04-18 19:09:08,0.06600694444444444,6,73,7,80
2017-04-18 17:36:19,0.088125,5,92,5,97
2017-04-18 19:29:31,0.16005787037037036,3,6,6,12
2017-04-18 17:35:56,0.10206018518518518,3,5,4,9
2017-04-21 17:24:31,4.291990740740741,3,13,1,14
2017-04-18 15:15:31,0.5731597222222222,7,12,12,24
2017-04-18 13:58:22,0.0069097222222222225,2,2,2,4
2017-04-18 13:57:16,0.014456018518518519,2,881,110,991
2017-04-18 13:57:46,0.016041666666666666,1,2,2,4
2017-04-18 20:29:15,0.3600231481481482,2,18,1,19
2017-04-18 21:15:45,0.3483912037037037,2,38,14,52
2017-04-18 13:21:16,0.9949305555555555,9,707,80,787
2017-04-18 14:04:14,0.13868055555555556,1,3,1,4
2017-04-18 11:10:50,0.0992013888888889,1,12,6,18
2017-04-20 11:29:38,2.1994444444444445,2,22,62,84
2017-04-18 13:21:48,0.22994212962962962,1,4,4,8
2017-04-18 14:03:28,0.4422337962962963,2,22,4,26
2017-04-18 14:04:36,0.3413425925925926,1,3,4,7
2017-04-19 15:17:32,1.531099537037037,5,26,19,45
2017-04-17 23:07:47,0.00042824074074074075,1,21,0,21
2017-04-17 23:01:32,0.025659722222222223,1,157,0,157
2017-04-17 22:16:32,0.07755787037037037,4,58,33,91
2017-04-17 21:19:46,0.06903935185185185,1,1,1,2
2017-04-17 22:16:04,0.2786342592592593,14,234,159,393
2017-04-17 19:28:31,0.06302083333333333,6,11,122,133
2017-04-17 18:02:00,0.02837962962962963,3,47,6,53
2017-04-30 13:01:10,12.915914351851852,4,14,17,31
2017-04-17 19:49:51,0.1313888888888889,1,1,1,2
2017-04-17 18:27:12,0.08966435185185186,1,33,0,33
2017-04-17 18:02:30,0.1275,1,0,16,16
2017-04-17 17:57:03,0.21597222222222223,1,13,1,14
2017-04-17 19:01:43,0.17822916666666666,1,1,1,2
2017-04-17 17:58:04,0.21535879629629628,1,39,19,58
2017-04-17 13:54:34,0.023483796296296298,2,8,11,19
2017-04-17 13:15:27,0.0888425925925926,1,3,3,6
2017-04-17 23:58:24,0.5724652777777778,1,65,28,93
2017-04-17 17:58:39,0.31884259259259257,1,4,4,8
2017-04-17 17:58:54,0.3223726851851852,1,6,8,14
2017-04-17 13:15:15,0.12431712962962962,1,1,1,2
2017-04-17 08:35:07,0.01721064814814815,1,1,0,1
2017-04-17 08:29:08,0.13788194444444443,1,7,1,8
2017-04-17 08:32:42,0.12939814814814815,1,3,3,6
2017-04-17 08:34:33,0.1304050925925926,1,29,5,34
2017-04-17 23:02:02,0.7531481481481481,3,24,6,30
2017-04-17 08:32:10,0.21208333333333335,1,16,4,20
2017-04-17 08:35:42,2.38875,3,3,4,7
2017-04-17 02:32:31,0.027476851851851853,1,248,224,472
2017-04-17 02:22:10,0.022847222222222224,1,1,1,2
2017-04-17 02:22:15,0.02707175925925926,1,1,1,2
2017-04-18 13:20:38,12.446631944444444,28,16628,6974,23602
2017-04-17 08:38:27,8.888425925925926,37,14907,6511,21418
2017-04-20 16:20:41,3.725625,3,4763,138411,143174
2017-04-17 18:30:38,0.8595023148148148,1,6,2,8
2017-04-16 21:15:58,0.0003587962962962963,1,3,2,5
2017-04-16 21:12:20,0.0009837962962962962,1,1,1,2
2017-04-17 08:29:50,0.5146990740740741,1,1,1,2
2017-04-16 19:02:54,0.0003125,1,1,1,2
2017-04-16 18:53:16,0.01443287037037037,1,0,1,1
2017-04-16 18:28:25,1.4744444444444444,2,5,3,8
2017-04-16 17:37:02,0.08644675925925926,16,72,166,238
2017-04-21 18:07:48,5.053784722222222,1,4,3,7
2017-04-17 08:38:13,0.6666435185185186,6,1004,403,1407
2017-04-16 16:26:46,0.0007754629629629629,1,1,7,8
2017-04-16 16:11:07,0.0024652777777777776,1,1,1,2
2017-04-16 16:04:20,0.013981481481481482,1,79,2,81
2017-04-16 16:04:06,0.04546296296296296,2,2,1,3
2017-04-16 16:01:49,0.048622685185185185,1,11,7,18
2017-04-16 17:32:48,0.11872685185185185,2,15,4,19
2017-04-16 14:37:50,0.07903935185185185,2,26,26,52
2017-04-16 14:38:03,0.033483796296296296,1,16,11,27
2017-04-16 14:38:14,0.08623842592592593,1,1,1,2
2017-04-16 14:38:29,0.08241898148148148,1,5,1,6
2017-04-16 14:28:27,0.017453703703703704,1,5,3,8
2017-04-16 14:42:47,0.025625,1,8,0,8
2017-04-16 14:07:59,0.09854166666666667,3,368,141,509
2017-04-16 14:59:54,0.04866898148148148,2,2,1,3
2017-04-17 08:37:01,0.8446296296296296,5,20,4,24
2017-04-16 14:07:46,0.030474537037037036,1,18,2,20
2017-04-16 12:54:09,0.009733796296296296,1,1,1,2
2017-04-18 19:58:58,2.3107407407407408,1,236,121,357
2017-04-16 12:55:43,0.017152777777777777,1,1,0,1
2017-04-16 12:56:04,0.036875,2,79,10,89
2017-04-16 12:55:04,0.047141203703703706,2,3,3,6
2017-04-16 14:08:11,0.11200231481481482,1,1,0,1
2017-04-16 11:42:46,0.012314814814814815,1,17,0,17
2017-04-16 12:05:16,0.07861111111111112,1,12,0,12
2017-04-16 11:44:58,0.11197916666666667,1,2,2,4
2017-04-17 02:23:14,0.7472569444444445,2,6,6,12
2017-04-16 12:15:04,0.1537037037037037,2,2,1,3
2017-04-21 18:05:36,5.44980324074074,8,8253,139945,148198
2017-04-16 11:42:17,0.17322916666666666,4,109,97,206
2017-04-16 12:57:31,0.2687962962962963,1,2,1,3
2017-04-23 03:58:48,8.889675925925927,22,626,240,866
2017-04-17 08:38:59,1.2428125,1,2,0,2
2017-04-16 14:28:53,0.5022453703703704,2,3,7,10
2017-04-16 10:52:18,0.3771875,1,7,4,11
2017-04-16 02:01:28,0.01105324074074074,1,2,2,4
2017-04-16 01:40:33,0.014282407407407407,4,103,65,168
2017-04-16 10:53:58,0.3973726851851852,3,133,72,205
2017-04-16 02:01:59,0.030497685185185187,1,1,1,2
2017-04-16 02:02:29,0.06728009259259259,2,104,75,179
2017-04-16 18:32:00,13.086701388888889,10,15511,5426,20937
2017-04-17 23:02:51,2.0212731481481483,2,586,273,859
2017-04-15 23:12:48,0.037488425925925925,1,24,6,30
2017-04-16 18:32:28,0.8785185185185185,4,357,195,552
2017-04-16 00:40:36,0.13909722222222223,1,1,1,2
2017-04-15 21:02:14,0.04064814814814815,1,0,4,4
2017-04-15 20:48:31,0.02696759259259259,1,5,5,10
2017-04-15 20:48:42,0.03930555555555556,1,2,2,4
2017-04-15 20:48:17,0.044502314814814814,1,1,0,1
2017-04-16 02:32:58,0.2861111111111111,2,176,102,278
2017-04-16 10:51:30,0.7444328703703704,2,316,150,466
2017-04-15 19:17:59,0.020775462962962964,1,1,1,2
2017-04-17 23:20:38,2.3479050925925926,2,468,182,650
2017-04-15 14:41:23,0.017824074074074076,1,1,1,2
2017-04-15 14:46:49,0.04527777777777778,1,1,1,2
2017-04-16 14:33:39,1.868101851851852,4,14,9,23
2017-04-15 14:44:28,0.09103009259259259,1,1,1,2
2017-04-15 14:44:59,0.5099189814814815,1,47,8,55
2017-04-15 11:30:58,0.0028125,1,1,1,2
2017-04-15 11:33:26,0.012627314814814815,2,90,29,119
2017-04-15 11:32:54,0.025729166666666668,1,5,0,5
2017-04-15 11:18:08,0.04482638888888889,1,2,2,4
2017-04-15 11:16:24,0.03601851851851852,1,1,1,2
2017-04-15 11:17:21,0.10680555555555556,1,1,1,2
2017-04-15 11:17:55,0.22278935185185186,1,9,1,10
2017-04-15 11:17:08,0.35333333333333333,3,19,3,22
2017-04-15 11:24:34,0.3694560185185185,2,87,4,91
2017-04-15 14:46:28,0.5387615740740741,1,9,5,14
2017-04-15 11:25:01,0.4348842592592593,2,6,1,7
2017-04-15 01:09:56,0.015960648148148147,1,29,9,38
2017-04-15 00:30:56,0.2408912037037037,1,0,14,14
2017-04-15 00:31:16,0.01773148148148148,1,10,10,20
2017-04-15 00:32:43,0.16469907407407408,1,25,17,42
2017-04-15 00:33:38,2.395925925925926,13,4975,1431,6406
2017-04-14 23:12:39,0.11096064814814814,3,37,2,39
2017-04-15 00:37:01,0.1863425925925926,1,95,0,95
2017-04-15 00:37:21,0.19690972222222222,1,1,1,2
2017-04-14 23:21:02,0.18849537037037037,1,33,0,33
2017-04-14 23:23:50,0.17142361111111112,1,183,3,186
2017-04-15 00:49:43,0.2851388888888889,1,521,0,521
2017-04-15 00:44:11,0.30690972222222224,2,8,8,16
2017-04-15 01:17:08,0.5858217592592593,18,250,86,336
2017-04-14 17:10:13,0.043993055555555556,1,82,1,83
2017-04-14 17:10:39,0.08471064814814815,1,1,1,2
2017-04-15 19:55:29,1.2151967592592592,1,7,2,9
2017-04-15 11:26:04,0.8914236111111111,4,2517,429,2946
2017-04-16 18:32:17,2.1863657407407406,5,3315,786,4101
2017-04-14 17:09:53,0.13355324074074074,1,1,1,2
2017-04-18 15:21:25,4.700057870370371,3,13209,4981,18190
2017-04-15 00:44:34,0.5357986111111112,1,22,22,44
2017-04-15 00:45:47,0.5168055555555555,2,1187,284,1471
2017-04-15 00:48:31,0.8097106481481482,3,214,37,251
2017-04-14 11:22:56,0.029027777777777777,1,1,0,1
2017-04-23 03:36:41,8.72550925925926,7,13465,141267,154732
2017-04-14 10:50:00,0.0303125,1,1,1,2
2017-04-14 11:00:04,0.06074074074074074,1,2,2,4
2017-04-14 10:43:29,0.08997685185185185,2,202,53,255
2017-04-14 09:02:26,0.09303240740740741,1,1,1,2
2017-04-17 08:42:29,3.2299189814814815,2,2966,574,3540
2017-04-14 09:04:19,0.2600810185185185,1,5,4,9
2017-04-21 18:06:25,7.674351851851852,1,1,1,2
2017-04-15 00:43:51,8.921087962962963,16,10487,5122,15609
2017-04-14 09:13:00,0.444212962962963,1,2,2,4
2017-04-17 23:21:56,4.105092592592593,7,29,22,51
2017-04-14 09:09:20,0.46903935185185186,8,8,6,14
2017-04-15 00:55:43,1.1172916666666666,2,2133,382,2515
2017-04-13 20:21:21,0.09947916666666666,1,3,1,4
2017-04-13 20:21:34,3.0418287037037035,1,1,1,2
2017-04-13 19:54:00,0.0016435185185185185,1,4,8,12
2017-04-13 19:52:57,0.007638888888888889,1,1,1,2
2017-04-14 09:15:04,0.5705208333333334,1,4,0,4
2017-04-14 09:10:29,0.7463541666666667,9,246,104,350
2017-04-13 19:49:47,0.14930555555555555,1,1,1,2
2017-04-17 10:27:19,3.7160532407407407,1,1,0,1
2017-05-23 14:54:45,40.07013888888889,10,595,94,689
2017-04-13 19:49:34,0.16408564814814816,3,1112,327,1439
2017-04-15 00:57:26,1.377372685185185,2,11,3,14
2017-04-13 19:49:08,1.1967592592592593,5,498,343,841
2017-04-13 17:37:04,0.07688657407407408,1,1,1,2
2017-04-13 17:23:36,0.07819444444444444,1,3,1,4
2017-04-13 17:36:41,0.09422453703703704,1,19,7,26
2017-04-13 15:11:18,0.022581018518518518,2,169,26,195
2017-04-13 15:10:49,0.030497685185185187,2,170,26,196
2017-04-13 17:18:32,0.1309375,1,313,331,644
2017-04-13 14:00:32,0.014699074074074074,2,4,2,6
2017-04-13 20:27:03,0.4444444444444444,16,1934,259,2193
2017-04-13 13:59:44,0.01853009259259259,1,1,1,2
2017-04-13 14:00:57,0.022569444444444444,1,1,0,1
2017-04-13 13:29:30,0.003726851851851852,1,22,2,24
2017-04-13 13:59:13,0.029479166666666667,2,4,3,7
2017-04-13 15:02:04,0.0817824074074074,1,95,9,104
2017-04-13 12:39:15,0.016087962962962964,1,1,1,2
2017-04-13 11:40:58,0.009756944444444445,1,60,3,63
2017-04-13 11:13:18,0.0010069444444444444,1,2,2,4
2017-04-13 14:02:23,3.7630671296296296,7,485,13,498
2017-04-13 11:39:00,0.07774305555555555,2,1448,241,1689
2017-04-13 11:40:25,0.0889236111111111,1,2,0,2
2017-04-13 10:57:41,0.20291666666666666,6,119,62,181
2017-04-13 14:03:46,0.46292824074074074,1,3,2,5
2017-04-13 11:04:24,0.4117476851851852,5,187,49,236
2017-04-13 01:17:34,0.005636574074074074,1,3,0,3
2017-04-13 11:25:34,5.004479166666667,15,5897,4220,10117
2017-04-13 00:51:13,0.017326388888888888,2,0,8,8
2017-04-13 00:50:57,0.08177083333333333,1,1,0,1
2017-04-15 11:27:27,2.5609837962962962,26,3714,908,4622
2017-04-13 11:09:08,0.6066898148148148,4,122,86,208
2017-04-13 00:17:27,0.3846875,9,1459,657,2116
2017-04-13 11:02:03,0.6377430555555555,2,52,22,74
2017-04-13 14:04:20,0.7477662037037037,1,4,0,4
2017-04-13 11:23:45,1.805949074074074,7,226,112,338
2017-04-13 00:17:40,0.21784722222222222,1,6,0,6
2017-04-13 00:15:46,0.2178125,1,3,3,6
2017-04-12 18:54:49,0.011550925925925926,1,1,3,4
2017-04-18 15:25:45,5.879247685185185,2,6527,1200,7727
2017-04-12 18:40:04,0.00537037037037037,1,2,2,4
2017-04-12 18:41:52,1.1101967592592592,1,122,82,204
2017-04-12 18:28:57,0.008576388888888889,2,123,22,145
2017-04-12 18:19:39,2.1588425925925927,63,5858,4528,10386
2017-04-12 18:19:28,0.01721064814814815,1,1,1,2
2017-04-12 17:34:40,0.0015162037037037036,1,18,25,43
2017-04-19 12:28:00,6.811400462962963,4,8927,1924,10851
2017-04-12 16:27:34,0.007349537037037037,1,2,1,3
2017-04-12 17:09:59,0.07175925925925926,1,1,1,2
2017-04-12 15:07:52,0.0030324074074074073,2,471,335,806
2017-04-12 16:22:39,0.579375,2,155,9,164
2017-04-12 13:53:55,0.007233796296296296,1,14,13,27
2017-04-12 13:58:09,0.02238425925925926,1,4,4,8
2017-04-12 17:54:16,0.21037037037037037,1,1,1,2
2017-04-12 17:56:09,0.34806712962962966,1,1,1,2
2017-04-17 08:41:19,5.099861111111111,4,5103,1073,6176
2017-04-17 10:26:45,5.216539351851852,5,10107,2353,12460
2017-04-12 10:40:38,0.2569560185185185,1,1,1,2
2017-04-12 14:02:00,0.5569328703703704,1,299,299,598
2017-04-12 14:12:43,0.5175810185185186,2,25,7,32
2017-04-17 08:39:55,5.410324074074074,4,8388,1820,10208
2017-04-12 15:16:59,0.7067013888888889,1,30,0,30
2017-04-12 14:03:38,0.6769212962962963,1,36,8,44
2017-04-12 15:13:19,0.7247453703703703,1,1,1,2
2017-04-12 14:12:57,0.7182060185185185,2,15,4,19
2017-04-11 21:28:23,0.0005671296296296297,1,2,2,4
2017-04-13 17:50:19,1.8512152777777777,1,1,1,2
2017-04-19 12:28:23,7.921805555555555,1,1,1,2
2017-04-11 19:58:29,0.009328703703703704,1,5,2,7
2017-04-11 19:57:05,0.008541666666666666,2,507,6,513
2017-04-11 20:51:18,0.048101851851851854,2,9,2,11
2017-04-13 11:23:23,7.365208333333333,12,7418,4588,12006
2017-04-11 20:00:44,0.06489583333333333,8,155,72,227
2017-04-11 20:49:54,0.09024305555555556,1,7,7,14
2017-04-11 17:51:13,0.0069328703703703705,1,0,0,0
2017-04-11 17:35:07,0.008611111111111111,1,1,1,2
2017-04-13 17:51:49,2.044212962962963,3,4,2,6
2017-04-11 19:40:14,0.1507638888888889,4,76,25,101
2017-04-11 19:52:10,1.2230902777777777,25,2339,3047,5386
2017-04-12 18:11:10,1.094849537037037,2,2887,3088,5975
2017-04-11 16:03:03,0.006053240740740741,1,31,1845,1876
2017-04-12 15:11:49,0.9794791666666667,5,194,70,264
2017-04-11 20:53:58,0.2255787037037037,1,60,84,144
2017-04-12 16:24:19,1.0710763888888888,3,763,155,918
2017-04-12 06:50:51,0.8705902777777778,5,552,16,568
2017-04-12 16:20:45,1.6205324074074074,3,95,28,123
2017-04-11 19:41:40,0.2377199074074074,2,39,18,57
2017-04-11 12:21:16,0.04259259259259259,1,2,1,3
2017-04-11 19:54:41,0.5497569444444445,3,76,19,95
2017-04-11 19:41:29,6.214849537037037,30,5233,1480,6713
2017-04-15 00:29:33,3.8954166666666667,1,2,2,4
2017-04-15 11:28:10,6.386412037037037,1,1,1,2
2017-04-11 19:31:01,0.7098263888888889,3,148,22,170
2017-04-11 13:06:08,0.46457175925925925,1,4,4,8
2017-04-11 21:23:35,0.8918402777777777,2,60,28,88
2017-06-27 12:18:53,77.61581018518518,1,31,0,31
2017-04-10 20:58:07,0.032858796296296296,2,44,12,56
2017-04-10 22:13:09,0.07207175925925927,2,1091,478,1569
2017-04-10 22:38:35,0.12275462962962963,1,1,1,2
2017-04-10 19:27:03,0.015104166666666667,2,170,141,311
2017-04-11 12:20:18,0.7232407407407407,1,2,1,3
2017-04-10 18:56:15,0.010543981481481482,1,1,1,2
2017-04-10 19:11:59,0.025775462962962962,1,4,4,8
2017-04-11 03:30:40,0.39471064814814816,2,1200,515,1715
2017-04-10 19:27:53,0.08168981481481481,2,5,2,7
2017-04-10 23:11:42,0.3499189814814815,6,77,65,142
2017-04-10 19:31:26,0.2207175925925926,1,9,1,10
2017-04-10 19:30:59,0.2503009259259259,1,17,5,22
2017-04-10 22:38:59,0.38719907407407406,3,108,138,246
2017-04-25 23:44:51,15.528518518518519,3,24946,145362,170308
2017-04-10 10:49:35,4.845474537037037,26,2538,532,3070
2017-04-10 14:27:30,0.17041666666666666,2,78,75,153
2017-04-10 11:02:11,0.11363425925925925,1,6,6,12
2017-04-10 22:36:03,0.6968055555555556,4,529,19,548
2017-04-10 19:32:46,0.5693402777777777,1,1,2,3
2017-04-10 07:58:09,0.09023148148148148,1,1,1,2
2017-04-10 11:01:44,0.423275462962963,1,4,4,8
2017-04-10 22:35:36,0.9283101851851852,1,2,1,3
2017-04-10 19:48:31,1.3676157407407408,3,31,1,32
2017-04-15 20:47:49,6.034699074074074,5,54,34,88
2017-04-15 00:21:14,5.246354166666666,1,7,3,10
2017-04-11 17:32:03,1.9091203703703703,1,0,32,32
2017-04-11 17:31:23,1.9315046296296297,1,0,473,473
2017-04-12 17:10:53,2.9115277777777777,2,101,104,205
2017-04-09 18:23:15,0.053668981481481484,1,36,30,66
2017-04-09 17:10:39,0.004097222222222223,1,1,1,2
2017-04-09 16:35:52,0.03908564814814815,1,1,1,2
2017-04-09 16:36:04,0.04483796296296296,1,4,4,8
2017-04-09 15:11:38,0.033368055555555554,3,26,56,82
2017-04-19 12:30:23,9.916805555555555,6,11310,4477,15787
2017-04-09 16:43:49,0.1514814814814815,1,9,4,13
2017-04-09 18:55:55,0.23878472222222222,2,184,116,300
2017-04-10 21:45:30,1.411875,3,608,220,828
2017-04-09 12:39:42,0.01685185185185185,1,25,1,26
2017-04-09 12:45:02,0.5256712962962963,4,74,8,82
2017-04-09 20:21:52,0.4082175925925926,1,1,0,1
2017-04-09 12:58:09,0.10445601851851852,3,327,90,417
2017-04-15 01:16:06,5.757592592592593,5,51,40,91
2017-04-12 16:21:08,3.3933912037037035,2,1763,606,2369
2017-04-09 09:35:23,0.17929398148148148,1,1,1,2
2017-04-09 12:45:26,0.42777777777777776,1,22,3,25
2017-04-25 23:21:06,16.89440972222222,1,28,2,30
2017-04-08 23:09:46,0.022858796296296297,2,17,0,17
2017-04-09 03:46:33,0.2475462962962963,1,5,0,5
2017-04-12 15:16:40,3.737222222222222,9,2984,1080,4064
2017-04-08 21:39:32,0.02533564814814815,2,74,56,130
2017-04-08 23:42:14,0.10797453703703704,2,10,10,20
2017-04-09 16:34:30,0.8838194444444445,2,14,7,21
2017-04-09 12:47:26,0.6207870370370371,2,175,55,230
2017-04-09 16:49:27,1.2293981481481482,6,847,347,1194
2017-04-08 20:20:09,0.08145833333333333,2,97,37,134
2017-04-09 12:55:59,0.8633912037037037,5,526,184,710
2017-04-15 00:15:47,6.398738425925926,4,17,7,24
2017-04-08 16:31:50,0.09934027777777778,1,10,4,14
2017-04-10 22:39:40,2.3555208333333333,1,1,1,2
2017-04-17 08:40:15,8.811354166666666,1,5,1,6
2017-04-09 12:54:48,1.0331944444444445,2,24,18,42
2017-04-11 14:04:57,3.111863425925926,8,263,111,374
2017-04-08 13:28:23,0.07991898148148148,1,17,0,17
2017-04-08 10:25:24,0.000462962962962963,1,0,6,6
2017-04-08 11:04:59,0.06302083333333333,1,13,13,26
2017-04-08 10:31:34,0.06449074074074074,1,4,0,4
2017-04-08 10:34:53,0.07878472222222223,1,1,1,2
2017-04-08 09:40:44,0.13792824074074075,1,1,1,2
2017-04-08 09:40:21,0.07741898148148148,1,1,0,1
2017-04-08 11:05:49,0.13965277777777776,1,1,1,2
2017-04-08 11:48:17,0.1833101851851852,2,2,1,3
2017-04-11 23:14:57,3.727476851851852,2,3798,3425,7223
2017-04-08 10:16:16,0.19592592592592592,1,8,0,8
2017-04-15 00:05:41,6.791828703703704,2,8639,4174,12813
2017-04-08 09:35:40,0.23900462962962962,1,1,1,2
2017-04-08 09:37:38,0.24814814814814815,1,4,0,4
2017-04-08 09:37:52,0.2840972222222222,2,8,2,10
2017-04-08 09:37:14,0.3421180555555556,2,496,7,503
2017-04-08 09:36:44,0.3790972222222222,2,516,17,533
2017-04-08 11:26:04,0.47216435185185185,4,748,98,846
2017-04-08 09:36:36,0.4367361111111111,1,1,2,3
2017-04-07 22:59:03,0.0020949074074074073,1,1,0,1
2017-04-07 23:00:32,0.019930555555555556,1,1,1,2
2017-04-07 23:00:06,0.05247685185185185,1,2,4,6
2017-04-08 09:38:34,0.5064004629629629,2,41,6,47
2017-04-08 03:10:26,0.24987268518518518,2,501,11,512
2017-04-08 03:09:10,0.2516319444444444,2,1339,327,1666
2017-04-08 10:15:41,0.5952199074074074,3,26,4,30
2017-04-07 20:25:10,0.03789351851851852,1,12,2,14
2017-04-07 20:25:49,0.03652777777777778,1,1,1,2
2017-04-07 21:02:50,0.0779050925925926,1,1,1,2
2017-04-08 10:16:49,0.6542939814814814,2,2,2,4
2017-04-08 03:07:51,0.35693287037037036,2,814,38,852
2017-04-07 20:28:16,0.09011574074074075,1,86,11,97
2017-04-07 20:30:29,0.15261574074074075,3,193,28,221
2017-04-09 16:33:41,1.9315972222222222,2,60,2,62
2017-04-07 20:50:32,0.21969907407407407,1,47,8,55
2017-04-08 10:17:35,2.8232523148148148,23,1678,476,2154
2017-04-19 12:29:24,11.887152777777779,1,1,0,1
2017-04-09 16:40:24,2.0850347222222223,7,1730,389,2119
2017-04-10 20:47:42,3.31875,50,140,118,258
2017-04-08 11:11:16,0.9722800925925926,1,56,6,62
2017-04-07 21:45:48,0.4267361111111111,1,2,1,3
2017-04-07 11:08:52,0.0022916666666666667,2,51,8,59
2017-04-07 11:08:28,0.019467592592592592,2,93,22,115
2017-04-07 09:09:15,0.002534722222222222,1,7,5,12
2017-04-08 11:03:12,1.0822569444444445,1,2,2,4
2017-04-07 22:24:39,0.8169212962962963,2,3,2,5
2017-04-07 03:56:57,0.059409722222222225,2,395,264,659
2017-04-10 20:41:53,3.8186805555555554,2,519,209,728
2017-04-08 09:38:55,1.439849537037037,2,1309,324,1633
2017-04-09 12:54:02,2.616875,1,1,0,1
2017-04-15 00:08:00,8.067858796296296,2,6,3,9
2017-04-08 02:54:45,1.2047337962962963,2,1319,325,1644
2017-04-06 20:58:45,0.01650462962962963,1,12,2,14
2017-04-08 11:07:55,1.6091898148148147,1,37,17,54
2017-04-06 20:59:48,0.02420138888888889,1,0,0,0
2017-04-08 02:54:15,1.3254398148148148,3,1338,328,1666
2017-04-06 19:35:10,0.026319444444444444,2,7,0,7
2017-04-08 02:49:35,1.345949074074074,2,1336,327,1663
2017-04-08 02:48:03,1.3535532407407407,3,1337,329,1666
2017-04-08 02:47:00,1.3965625,5,1342,332,1674
2017-04-06 17:02:15,0.03166666666666667,1,3,1,4
2017-04-08 02:45:15,1.4430555555555555,2,1346,332,1678
2017-04-08 02:43:47,2.0732175925925924,2,1353,340,1693
2017-04-12 18:04:34,6.128668981481481,13,7138,4496,11634
2017-04-08 02:42:35,1.577002314814815,2,1344,332,1676
2017-04-08 02:41:37,1.5969444444444445,2,1344,332,1676
2017-04-06 17:09:46,0.2194212962962963,1,3,0,3
2017-04-08 02:40:30,1.6860648148148147,2,1343,332,1675
2017-04-06 17:32:13,1.0861342592592593,2,3,3,6
2017-04-08 02:39:06,1.7302430555555555,2,1343,332,1675
2017-04-06 17:32:51,0.41100694444444447,1,4,1,5
2017-04-08 02:37:51,1.8233333333333333,2,1342,332,1674
2017-04-08 02:35:08,1.8256018518518518,2,1441,403,1844
2017-04-08 02:34:10,1.8909027777777778,2,1340,332,1672
2017-04-10 10:52:07,4.343495370370371,5,2579,578,3157
2017-04-06 00:35:35,0.021782407407407407,1,1,1,2
2017-04-08 02:25:45,2.1291782407407407,2,1361,351,1712
2017-04-08 02:18:12,2.196261574074074,2,901,348,1249
2017-04-13 11:38:45,7.634027777777778,8,1347,408,1755
2017-04-05 21:26:44,0.10630787037037037,1,2,0,2
2017-04-08 02:16:50,2.3135069444444443,2,978,399,1377
2017-04-08 02:15:13,2.3131944444444446,2,978,400,1378
2017-04-08 02:13:34,2.3327199074074074,2,1008,410,1418
2017-04-08 02:11:56,2.3693055555555556,2,1009,412,1421
2017-04-08 02:10:23,2.3784259259259257,2,1006,410,1416
2017-04-08 02:09:16,2.389861111111111,4,1007,412,1419
2017-04-08 02:06:07,2.4100462962962963,2,1003,410,1413
2017-04-08 02:03:36,2.41193287037037,2,1002,410,1412
2017-04-08 01:59:52,2.4124421296296297,2,998,410,1408
2017-04-08 01:56:57,2.4115277777777777,2,998,411,1409
2017-04-08 11:02:08,2.793125,1,4,4,8
2017-04-08 01:49:58,2.411886574074074,2,996,410,1406
2017-04-08 01:48:58,2.4162268518518517,2,996,410,1406
2017-04-08 01:45:06,2.447951388888889,2,996,410,1406
2017-04-05 18:48:19,0.1594675925925926,1,37,27,64
2017-04-07 10:58:12,1.8514583333333334,18,803,404,1207
2017-04-08 01:43:20,2.475324074074074,2,1102,407,1509
2017-04-05 14:50:46,0.1289699074074074,6,112,2,114
2017-04-08 01:35:35,2.4811111111111113,3,1102,409,1511
2017-04-05 13:24:53,0.016875,1,1,0,1
2017-04-05 13:24:25,0.025497685185185186,3,7,7,14
2017-04-05 12:57:39,0.024930555555555556,1,1,1,2
2017-04-05 12:57:02,0.031875,1,2,1,3
2017-04-05 12:57:15,0.06783564814814814,1,1,1,2
2017-04-05 13:24:40,0.09133101851851852,2,9,2,11
2017-04-05 10:26:03,0.042847222222222224,1,1,0,1
2017-04-05 10:26:19,0.04818287037037037,1,1,0,1
2017-04-05 10:33:02,0.06951388888888889,1,1,0,1
2017-04-05 10:18:58,0.06585648148148149,1,2,1,3
2017-04-05 08:27:13,0.02474537037037037,5,582,176,758
2017-04-05 08:23:11,0.09737268518518519,1,2,2,4
2017-04-05 08:29:00,0.15628472222222223,1,1,0,1
2017-04-05 08:23:32,0.16145833333333334,1,0,13,13
2017-04-05 08:29:59,0.1729050925925926,2,37,30,67
2017-04-05 08:23:53,0.17310185185185184,1,7,2,9
2017-04-05 17:46:36,0.6039699074074074,10,214,66,280
2017-04-05 08:24:25,0.2758333333333333,1,3,3,6
2017-04-05 08:26:32,0.27998842592592593,1,12,0,12
2017-04-05 08:29:15,0.28715277777777776,1,1,0,1
2017-04-05 00:54:03,0.026261574074074073,1,3,0,3
2017-04-05 00:56:55,0.056226851851851854,1,1,0,1
2017-04-05 01:01:44,0.09467592592592593,2,3,1,4
2017-04-05 01:31:57,0.12640046296296295,7,383,84,467
2017-04-08 09:39:26,3.4814583333333333,6,2033,522,2555
2017-04-05 01:24:08,0.15184027777777778,1,1,1,2
2017-04-04 21:11:34,0.08113425925925925,1,1,0,1
2017-04-05 00:53:10,0.2553009259259259,1,1,1,2
2017-04-05 00:52:00,0.3111921296296296,1,1,1,2
2017-04-05 01:06:42,0.33111111111111113,1,5,5,10
2017-04-05 01:11:14,0.34230324074074076,1,1,0,1
2017-04-05 01:20:51,0.3696990740740741,2,160,82,242
2017-04-05 01:20:01,0.38109953703703703,2,158,78,236
2017-04-05 00:53:40,0.36774305555555553,1,1,1,2
2017-04-05 01:07:28,0.40523148148148147,1,1,1,2
2017-04-05 01:04:58,0.41682870370370373,1,55,2,57
2017-04-05 01:07:47,0.3722916666666667,1,1,0,1
2017-04-05 01:08:59,0.44435185185185183,1,1,1,2
2017-04-05 01:07:59,0.4535648148148148,1,2,0,2
2017-04-05 01:18:48,0.46924768518518517,2,157,78,235
2017-04-05 01:08:25,0.4658333333333333,1,1,1,2
2017-04-05 01:23:17,0.49787037037037035,1,3,0,3
2017-04-04 12:50:14,0.0004976851851851852,1,1,1,2
2017-04-04 12:48:23,0.0015625,1,5,0,5
2017-04-05 01:09:21,0.7794212962962963,4,568,78,646
2017-04-04 12:48:51,0.3267824074074074,1,3,3,6
2017-04-04 12:49:07,0.36679398148148146,1,1,1,2
2017-04-15 00:22:46,11.096261574074074,14,11775,5049,16824
2017-04-05 01:00:58,1.1356712962962963,1,1,1,2
2017-04-04 12:52:28,5.420416666666667,4,5028,1058,6086
2017-04-04 12:51:48,0.6574652777777777,2,166,85,251
2017-04-04 12:51:02,0.7072800925925926,1,1,0,1
2017-04-04 12:50:36,0.7181481481481482,1,1,1,2
2017-04-08 02:21:49,4.332627314814815,4,3224,682,3906
2017-04-05 01:05:51,1.3298958333333333,1,11,11,22
2017-04-05 01:05:31,1.3362731481481482,1,25,25,50
2017-04-04 12:49:48,0.8480555555555556,1,13,0,13
2017-04-03 16:06:03,0.015185185185185185,1,2,2,4
2017-04-03 16:06:17,0.02351851851851852,1,1,0,1
2017-04-15 00:07:22,11.399166666666666,3,10,3,13
2017-04-03 16:06:38,0.09899305555555556,1,384,0,384
2017-04-03 13:04:52,0.12174768518518518,14,909,251,1160
2017-04-03 10:59:42,0.08034722222222222,1,2,2,4
2017-04-03 10:53:50,0.1234837962962963,1,7,0,7
2017-04-03 10:58:38,0.2880671296296296,6,459,263,722
2017-04-03 10:59:17,0.3215625,1,1,2,3
2017-04-03 01:40:34,0.016631944444444446,1,15,15,30
2017-04-03 01:40:00,0.02087962962962963,1,2,2,4
2017-04-03 01:40:21,0.061724537037037036,1,1,0,1
2017-04-02 23:03:43,0.011793981481481482,2,30,19,49
2017-04-03 01:39:35,0.1464699074074074,2,2,3,5
2017-04-02 22:25:38,0.014398148148148148,1,1,0,1
2017-04-02 22:25:56,0.057233796296296297,5,10,5,15
2017-04-02 22:26:24,44.25849537037037,8,219,22,241
2017-04-02 23:10:37,0.07819444444444444,3,302,71,373
2017-04-02 20:22:44,0.588136574074074,6,110,2,112
2017-04-02 20:22:56,0.061481481481481484,2,6,6,12
2017-04-02 20:23:11,0.13976851851851851,1,1,1,2
2017-04-02 15:50:15,0.0012731481481481483,1,2,0,2
2017-04-02 15:53:00,0.04069444444444444,2,4,4,8
2017-04-02 14:30:31,0.04743055555555555,1,1,0,1
2017-04-02 10:32:17,0.01857638888888889,1,15,16,31
2017-04-02 10:33:35,0.2058449074074074,2,16,17,33
2017-04-02 01:15:22,0.008935185185185185,1,4,0,4
2017-04-01 23:27:03,0.0653125,1,1,0,1
2017-04-02 10:38:16,0.6811111111111111,1,2,0,2
2017-04-01 21:10:40,0.21513888888888888,1,1,0,1
2017-03-31 19:25:32,0.021111111111111112,1,6,6,12
2017-03-31 14:36:22,0.001400462962962963,1,1,1,2
2017-03-26 19:45:50,0.0003935185185185185,1,1,1,2
2017-03-31 14:36:30,4.907824074074074,2,2363,84,2447
2017-03-26 11:22:54,2.0202893518518517,3,300,40,340
2017-03-26 11:08:26,0.46444444444444444,3,8,8,16
2017-03-23 23:13:09,0.6446064814814815,1,3,1,4
2017-03-17 17:08:51,0.055092592592592596,1,1,1,2
2017-03-17 15:16:40,0.02798611111111111,6,7,5,12
2017-03-04 11:17:50,0.4582407407407407,1,1,0,1
2017-03-03 21:46:56,0.04775462962962963,1,0,1,1
2017-03-02 17:50:43,24.66582175925926,1,390,33,423
2017-03-01 09:50:28,0.14298611111111112,1,2,1,3
2017-03-01 12:57:52,0.42020833333333335,2,27,7,34
2017-02-28 20:48:06,0.11489583333333334,1,1,0,1
2017-02-27 14:51:57,0.09671296296296296,1,1,1,2
2017-03-15 22:13:26,16.42153935185185,2,1603,358,1961
2017-02-26 22:07:23,7.6075,4,28,6,34
2017-04-13 11:16:28,53.89797453703704,5,603,144,747
2017-02-17 20:13:47,0.0159375,1,1,1,2
2017-02-17 12:09:22,0.3290625,1,5,1,6
2017-02-14 02:20:45,0.0030902777777777777,1,2,2,4
2017-02-13 19:42:41,0.003275462962962963,1,1,0,1
2017-02-13 17:43:59,0.05460648148148148,1,1,1,2
2017-02-13 14:16:16,0.0725,1,1,1,2
2017-02-12 12:27:41,0.3581944444444444,1,0,1,1
2017-02-13 17:38:40,1.8275347222222222,2,8,0,8
2017-02-10 20:13:02,0.0036805555555555554,1,1,0,1
2017-02-10 18:15:22,0.06790509259259259,5,113,67,180
2017-02-10 18:10:16,0.10760416666666667,2,93,54,147
2017-02-10 17:45:20,0.7829166666666667,1,1,0,1
2017-02-07 22:48:51,0.07569444444444444,2,204653,1005,205658
2017-02-07 01:08:41,2.0988194444444446,7,75,47,122
2017-02-05 00:29:08,0.08011574074074074,1,9,5,14
2017-02-03 14:54:24,0.014467592592592593,1,5,5,10
2017-02-02 23:10:23,0.012488425925925925,1,0,1,1
2017-02-26 22:23:55,24.844641203703702,4,34,23,57
2017-01-31 18:06:03,0.6068518518518519,1,2,2,4
2017-01-29 18:26:28,0.7055671296296296,1,45,0,45
2017-01-29 13:26:51,0.24552083333333333,1,2,2,4
2017-01-30 14:22:37,1.6061921296296295,1,2,0,2
2017-01-27 17:41:06,0.0010416666666666667,1,4,0,4
2017-01-27 18:31:15,0.747037037037037,3,4,4,8
2017-01-26 19:41:54,0.1768287037037037,1,3,1,4
2017-01-26 22:03:42,0.2920023148148148,1,4,2,6
2017-01-26 22:02:49,0.33065972222222223,1,201539,5,201544
2017-01-26 09:43:54,0.05619212962962963,1,2,1,3
2017-01-26 11:22:32,0.12537037037037038,1,5,0,5
2017-01-26 09:44:21,0.07275462962962963,1,2,0,2
2017-01-26 10:07:43,0.2595601851851852,6,4865,1350,6215
2017-01-26 01:50:56,0.0050347222222222225,1,1,1,2
2017-01-26 01:51:28,0.022118055555555554,1,1,0,1
2017-01-26 11:23:47,0.7448148148148148,1,2,0,2
2017-01-25 01:16:37,0.001585648148148148,1,1,35,36
2017-01-24 20:26:19,0.05454861111111111,1,2,0,2
2017-01-24 13:29:02,0.47695601851851854,2,156,76,232
2017-01-23 10:34:37,0.1504513888888889,1,8,1,9
2017-01-22 16:07:40,0.12258101851851852,1,2,32,34
2017-01-22 10:43:08,0.07810185185185185,1,108,1,109
2017-01-21 19:56:12,0.0671412037037037,2,0,0,0
2017-01-21 11:37:52,0.06608796296296296,1,1,1,2
2017-01-21 21:19:36,0.4977662037037037,1,23,2,25
2017-01-20 12:27:21,0.41864583333333333,1,71,32,103
2017-01-17 17:46:54,0.2825347222222222,1,126,4,130
2017-01-16 15:38:09,0.01,1,6,2,8
2017-01-16 10:37:44,0.3831134259259259,1,29,5,34
2017-01-15 17:45:53,0.07664351851851851,1,17,18,35
2017-01-15 13:29:48,0.14655092592592592,1,1,1,2
2017-01-15 01:15:37,0.05002314814814815,1,2,0,2
2017-01-21 21:31:26,6.91912037037037,2,182,86,268
2017-01-15 13:05:05,0.6293402777777778,4,44,11,55
2017-01-14 19:33:11,0.015833333333333335,1,1,1,2
2017-01-15 12:19:15,1.3241666666666667,1,18,0,18
2017-01-12 12:50:18,0.020405092592592593,1,19,11,30
2017-01-25 00:29:49,11.816238425925926,2,429,190,619
2017-01-11 13:19:20,0.45493055555555556,1,12,12,24
2017-01-10 11:21:07,0.31969907407407405,1,13,13,26
2017-01-09 13:13:55,0.46784722222222225,1,4,2,6
2017-01-08 12:34:27,0.04293981481481481,1,16,5,21
2017-01-09 13:12:11,1.1306712962962964,1,25,5,30
2017-01-08 12:36:02,0.300462962962963,1,2,0,2
2017-01-08 03:14:55,0.04577546296296296,1,8,4,12
2017-01-08 03:00:22,0.042025462962962966,1,1,1,2
2017-01-08 01:58:20,0.001851851851851852,1,2,2,4
2017-01-08 01:58:43,0.014340277777777778,1,5,0,5
2017-01-08 01:36:12,0.009976851851851851,1,1,1,2
2017-01-08 00:24:07,0.029282407407407406,1,5,3,8
2017-01-07 23:19:24,0.002199074074074074,1,4,1,5
2017-01-07 21:51:15,0.008159722222222223,1,2,2,4
2017-01-07 17:31:59,0.21498842592592593,3,137,9,146
2017-01-06 19:18:35,0.17355324074074074,1,53,47,100
2017-01-06 00:13:35,0.039837962962962964,1,8,5,13
2017-01-06 00:16:45,0.061863425925925926,1,4,0,4
2017-01-05 22:15:02,0.03353009259259259,1,1,1,2
2017-01-05 12:45:37,0.00018518518518518518,1,3,17,20
2017-01-05 12:37:29,0.26003472222222224,2,18,4,22
2017-01-05 12:37:49,0.34261574074074075,1,14,14,28
2017-01-05 12:35:15,0.35487268518518517,1,7,0,7
2017-01-05 12:36:14,0.3675,1,17,10,27
2017-01-05 12:36:56,0.3797916666666667,3,4,14,18
2017-01-05 02:34:07,0.0016435185185185185,1,1,1,2
2017-01-05 02:34:01,0.0029861111111111113,1,10,3,13
2017-01-05 02:34:49,0.016712962962962964,1,7,3,10
2017-01-05 02:35:22,0.023981481481481482,1,5,5,10
2017-01-05 01:57:14,0.021828703703703704,4,31,19,50
2017-01-03 18:58:34,0.004849537037037037,3,1326,220,1546
2017-01-03 11:59:21,0.14065972222222223,1,54,6,60
2016-12-20 22:34:15,0.11424768518518519,1,0,0,0
2016-12-18 20:22:46,4.110949074074074,1,3,3,6
2016-12-08 17:01:32,0.004826388888888889,1,4,2,6
2016-12-08 00:29:00,0.21878472222222223,1,24,24,48
2016-12-07 18:53:10,0.009583333333333333,1,150,1,151
2016-12-05 11:30:08,0.9191435185185185,1,59,0,59
2016-12-03 11:15:38,0.6492824074074074,1,112,0,112
2016-12-01 19:57:26,0.1039236111111111,1,315,315,630
2016-12-01 19:58:00,0.10974537037037037,1,2,2,4
2016-12-01 00:12:38,0.005381944444444444,2,317,49,366
2016-11-30 22:18:30,0.07826388888888888,1,5,0,5
2016-11-28 12:51:09,0.8708333333333333,1,3,1,4
2016-11-26 17:29:46,0.03760416666666667,1,0,1,1
2016-11-26 17:30:03,1.0106597222222222,2,12,6,18
2016-11-25 18:14:13,0.0838425925925926,1,0,6,6
2016-11-25 12:41:49,0.007604166666666667,3,44,24,68
2016-11-26 17:33:48,1.3683912037037036,5,325,8,333
2016-11-25 12:14:30,0.1812037037037037,4,41,357,398
2016-11-24 19:31:35,0.013414351851851853,2,533,170,703
2016-11-29 16:51:24,4.960405092592593,2,7,4,11
2016-11-24 15:27:32,0.7691203703703704,2,41,18,59
2016-11-29 16:50:19,5.96787037037037,1,2,3,5
2016-11-23 16:18:27,0.9945601851851852,5,354,220,574
2016-11-23 08:30:54,0.4123263888888889,1,2,0,2
2016-11-22 10:35:23,0.6096643518518519,17,582,245,827
2016-11-20 10:40:26,0.4156944444444444,2,50,1,51
2016-11-21 10:05:41,1.722175925925926,7,157,18,175
2016-11-19 17:40:03,0.03770833333333334,3,143,4,147
2016-11-18 23:01:36,0.21444444444444444,7,244,75,319
2016-11-18 18:12:44,0.013842592592592592,3,97,48,145
2016-11-17 19:42:52,0.08505787037037037,1,18,0,18
2016-11-02 20:53:05,0.06557870370370371,1,5,4,9
2016-11-02 16:41:33,0.09922453703703704,2,32,4,36
2016-11-02 20:53:00,0.2912152777777778,1,2,1,3
2016-11-02 10:04:27,0.0021875,1,7,5,12
2016-10-20 16:39:30,0.04497685185185185,2,224,44,268
2016-10-14 00:31:49,1.3510532407407407,2,24,5,29
2016-10-12 10:09:46,1.3671296296296296,2,4840,5,4845
2016-10-12 10:00:37,2.332951388888889,5,83,14,97
2016-10-09 10:45:22,0.8955902777777778,1,26,1,27
2016-10-06 10:26:21,0.006504629629629629,1,1,1,2
2016-10-06 07:59:00,0.09297453703703704,1,7,7,14
2024-05-23 11:38:00,0.07759259259259259,1,1,1,2
2024-05-23 09:45:31,1.989224537037037,68,3119,2346,5465
2024-05-22 16:06:50,0.010081018518518519,1,1,3,4
2024-05-22 15:48:26,0.09799768518518519,1,10,9,19
2024-05-22 17:37:15,2.1036689814814813,31,5727,2898,8625
2024-05-22 14:06:51,0.0290625,1,2,2,4
2024-05-22 10:27:41,0.06521990740740741,1,1,1,2
2024-05-22 23:13:56,2.233912037037037,5,47,71,118
2024-05-22 16:39:46,0.7822222222222223,2,1723,1937,3660
2024-05-23 12:31:52,1.840636574074074,20,2739,2818,5557
2024-05-22 14:23:05,0.9280555555555555,5,36,29,65
2024-05-22 13:06:09,1.0774884259259259,1,2,0,2
2024-05-21 14:40:19,0.163125,1,10,62,72
2024-05-22 11:56:41,1.0632986111111111,3,2444,2003,4447
2024-05-21 12:56:53,0.1165625,1,7,2,9
2024-05-22 08:52:59,0.9527430555555556,62,2454,2084,4538
2024-05-22 04:40:15,0.7830092592592592,6,2271,1977,4248
2024-05-21 08:41:29,0.13315972222222222,1,1,1,2
2024-05-21 09:43:22,0.7885763888888889,1,1,0,1
2024-05-20 11:56:11,0.0822800925925926,1,3,3,6
2024-05-21 07:14:15,0.9215162037037037,1,1,1,2
2024-05-20 08:51:04,0.015069444444444444,1,2,2,4
2024-05-20 09:18:17,0.06277777777777778,2,11,5,16
2024-05-22 16:15:42,3.129583333333333,5,82,30,112
2024-05-21 17:38:02,2.3592824074074072,4,1777,147,1924
2024-05-21 13:54:41,2.955208333333333,3,100,19,119
2024-05-20 08:08:26,1.7180902777777778,2,2,2,4
2024-05-20 23:48:52,3.0536921296296295,8,2680,528,3208
2024-05-17 15:09:30,0.005787037037037037,2,0,35,35
2024-05-17 14:51:31,0.26310185185185186,14,6092,648,6740
2024-05-17 11:50:25,0.7150810185185185,2,2,1,3
2024-05-16 16:06:22,0.02050925925925926,2,10,10,20
2024-05-16 15:30:02,0.004895833333333334,1,3,3,6
2024-05-17 14:12:44,0.9575115740740741,2,5,6,11
2024-05-20 08:45:57,3.8529166666666668,3,85,2,87
2024-05-16 12:23:01,0.03231481481481482,1,2,2,4
2024-05-16 13:32:21,0.10181712962962963,1,1,1,2
2024-05-22 14:20:07,6.173310185185185,10,7487,4384,11871
2024-05-16 11:31:14,0.1076388888888889,4,25,15,40
2024-05-17 12:57:47,2.3009375,3,5078,531,5609
2024-05-16 06:19:15,0.44175925925925924,2,10,8,18
2024-05-15 17:31:52,0.03912037037037037,1,9,9,18
2024-05-17 10:23:00,1.7708101851851852,15,259,341,600
2024-05-15 14:02:31,0.05012731481481481,1,3,8,11
2024-05-15 12:57:28,0.031655092592592596,2,4,1,5
2024-05-15 10:19:43,0.6425925925925926,2,0,94,94
2024-05-15 14:00:44,0.2871296296296296,1,1,1,2
2024-05-15 06:38:30,0.03754629629629629,1,1,1,2
2024-05-14 20:07:15,71.24015046296296,120,250008,114604,364612
2024-05-20 08:53:58,5.678368055555556,22,525,415,940
2024-05-22 12:09:01,7.882777777777778,5,16746,4764,21510
2024-05-15 15:17:09,1.0069212962962963,11,9233,397,9630
2024-05-14 17:45:06,0.14609953703703704,1,1,0,1
2024-05-16 11:08:36,1.9613425925925927,4,10242,577,10819
2024-05-21 11:46:07,7.162372685185185,7,15441,3115,18556
2024-05-14 06:36:11,0.17619212962962963,1,2,2,4
2024-05-14 08:31:19,1.7388194444444445,1,3,3,6
2024-05-14 12:48:17,0.8495949074074074,1,7,0,7
2024-05-15 14:14:11,1.9131944444444444,2,7,10,17
2024-05-13 16:00:43,0.01306712962962963,1,4,0,4
2024-05-14 09:43:03,0.7756597222222222,1,0,7,7
2024-05-13 15:08:45,0.05766203703703704,3,13,2,15
2024-05-13 13:12:58,0.01769675925925926,1,0,1,1
2024-05-16 11:41:33,2.9680324074074074,12,184,100,284
2024-05-13 14:48:20,0.10336805555555556,4,97,423,520
2024-05-13 11:32:43,69.85739583333333,14,47254,13452,60706
2024-05-13 11:34:45,1.0798611111111112,2,3146,3146,6292
2024-05-14 13:39:25,2.7933796296296296,3,5,5,10
2024-05-10 17:29:35,0.010289351851851852,2,2,2,4
2024-05-13 12:35:45,2.8546180555555556,11,100,77,177
2024-05-10 16:29:26,-0.11037037037037037,2,2,10,12
2024-05-17 11:15:59,6.9025,5,80,1537,1617
2024-05-17 15:21:26,7.0953587962962965,6,1068,228,1296
2024-05-10 11:40:57,0.06131944444444445,1,1,1,2
2024-05-10 13:16:44,0.17378472222222222,7,32,10,42
2024-05-13 10:08:48,3.063125,2,3,82,85
2024-05-09 16:59:29,0.08333333333333333,1,0,28,28
2024-05-14 08:30:53,4.791296296296296,2,10626,13631,24257
2024-05-13 11:20:16,4.921053240740741,3,240,20,260
2024-05-09 10:10:39,0.7364004629629629,4,93,16,109
2024-05-16 10:22:13,7.790821759259259,5,92,24,116
2024-05-08 17:26:34,0.11125,1,30,70,100
2024-05-13 14:47:58,5.103101851851852,2,2,2,4
2024-05-08 13:56:42,0.10795138888888889,2,2,1,3
2024-05-08 13:35:49,5.117974537037037,2,5934,5954,11888
2024-05-07 17:45:24,0.03605324074074074,1,1,1,2
2024-05-13 15:27:44,6.020706018518519,9,48,19,67
2024-05-08 08:27:31,0.7379166666666667,3,3,3,6
2024-05-07 14:59:16,0.020474537037037038,2,17,20,37
2024-05-07 14:58:50,0.037731481481481484,1,5,2,7
2024-05-20 11:55:57,13.0971875,2,10,10,20
2024-05-07 08:19:24,0.7596180555555555,1,1,1,2
2024-05-09 16:02:03,2.3933449074074074,9,101,75,176
2024-05-09 23:42:01,3.0416898148148146,6,4604,5627,10231
2024-05-08 14:16:14,1.7017361111111111,11,1296,339,1635
2024-05-07 08:28:56,0.6853587962962963,1,1,1,2
2024-05-07 08:39:35,0.6927662037037037,1,1,1,2
2024-05-07 09:23:52,0.7485763888888889,1,3,3,6
2024-05-07 11:56:56,0.9622569444444444,5,25,5,30
2024-05-06 09:26:04,0.007222222222222222,3,3,3,6
2024-05-06 09:33:52,0.04105324074074074,2,4,4,8
2024-05-06 08:32:19,0.24400462962962963,1,1,1,2
2024-05-17 17:38:46,12.582488425925925,18,327,56,383
2024-05-06 13:54:40,1.863125,1,1,1,2
2024-05-15 17:48:19,11.100625,14,24950,15399,40349
2024-05-07 10:57:10,3.5972916666666666,1,1,1,2
2024-05-07 10:57:30,3.621516203703704,1,1,1,2
2024-05-07 11:45:29,3.6552777777777776,1,1,1,2
2024-05-20 14:27:24,16.95201388888889,31,15247,3278,18525
2024-05-06 12:01:26,2.8393402777777776,3,5,2,7
2024-05-09 13:36:53,5.924965277777778,8,163,16,179
2024-05-23 08:59:38,20.94224537037037,25,260,93,353
2024-05-03 16:19:30,0.12975694444444444,1,1,1,2
2024-05-03 14:01:15,0.20503472222222222,1,1,1,2
2024-05-09 10:23:39,6.170949074074074,19,2045,632,2677
2024-05-09 17:01:57,7.113935185185185,9,324,218,542
2024-05-06 16:01:15,4.052106481481482,3,3916,3204,7120
2024-05-02 15:03:10,0.018761574074074073,1,36,12,48
2024-05-02 14:20:05,0.050416666666666665,2,26,2,28
2024-05-21 13:15:19,5.076493055555556,2,393,1,394
2024-05-02 11:59:40,0.048900462962962965,2,2,2,4
2024-05-02 20:18:48,0.3767361111111111,3,5,2,7
2024-05-02 10:00:26,0.016215277777777776,1,5,2,7
2024-05-02 13:30:22,0.2883449074074074,2,6,3,9
2024-05-08 16:54:49,6.834571759259259,7,1515,497,2012
2024-05-07 16:55:27,5.919814814814814,3,31,11,42
2024-05-02 13:42:26,0.8204398148148148,4,32,38,70
2024-05-02 07:15:17,0.6423611111111112,2,6,3,9
2024-05-02 16:25:19,1.1181481481481481,2,15,2,17
2024-05-01 15:30:24,0.8282407407407407,1,1,1,2
2024-05-01 15:36:58,0.8344097222222222,1,1,1,2
2024-05-01 15:35:52,0.8342476851851852,1,1,1,2
2024-05-01 15:38:07,0.8400115740740741,1,1,1,2
2024-05-01 15:37:54,0.8399305555555555,1,1,1,2
2024-05-01 15:37:40,0.8398032407407408,1,1,1,2
2024-05-02 14:24:33,1.8721180555555557,2,31,14,45
2024-05-01 07:43:02,0.6047569444444445,2,36,6,42
2024-04-30 17:30:23,0.040844907407407406,1,5,1,6
2024-05-09 12:15:57,5.870775462962963,4,9625,13547,23172
2024-05-02 11:47:00,1.9377199074074074,2,4,1,5
2024-05-01 07:32:45,0.9118402777777778,1,42,509,551
2024-04-30 19:11:37,0.4098611111111111,2,14,0,14
2024-05-02 10:00:07,2.047974537037037,3,7,3,10
2024-05-20 08:36:58,20.37638888888889,4,13883,16795,30678
2024-04-30 18:51:42,0.8685185185185185,5,75,29,104
2024-04-30 17:32:30,0.8423495370370371,4,234,16,250
2024-05-16 09:56:11,95.65383101851852,1,709,26,735
2024-04-29 18:47:26,0.03916666666666667,2,11,9,20
2024-05-10 12:00:46,9.665856481481482,11,215,206,421
2024-05-01 07:42:11,1.6160532407407406,4,44,149,193
2024-04-30 17:14:12,1.0244560185185185,1,11,8,19
2024-04-30 19:05:09,0.2031712962962963,2,93,24,117
2024-04-30 07:16:18,0.8274537037037037,1,1,0,1
2024-04-29 12:32:43,0.05489583333333333,1,1,1,2
2024-04-29 12:07:41,0.10003472222222222,1,1,1,2
2024-05-13 14:00:39,13.865555555555556,12,13752,16722,30474
2024-05-08 10:42:58,9.110104166666666,2,3912,3151,7063
2024-04-29 09:57:52,2.535972222222222,1,6,6,12
2024-04-26 19:52:24,0.011620370370370371,1,1,1,2
2024-04-29 09:22:33,2.6685185185185185,2,76,52,128
2024-04-26 17:04:41,0.011585648148148149,1,6,1,7
2024-05-06 12:22:52,11.845891203703705,6,4474,306,4780
2024-04-26 15:14:53,0.02486111111111111,1,3,4,7
2024-04-26 15:52:09,0.09295138888888889,2,0,19,19
2024-05-01 14:34:57,5.182847222222223,1,0,12,12
2024-04-26 09:13:53,0.21645833333333334,1,12,16,28
2024-04-26 10:26:44,0.7390162037037037,4,35,5,40
2024-05-07 09:13:11,11.770324074074074,3,10,2,12
2024-04-25 19:09:28,0.21648148148148147,1,3,0,3
2024-05-23 12:25:20,12.987523148148147,21,24086,6344,30430
2024-05-01 15:52:58,6.203460648148148,1,5,5,10
2024-05-01 14:47:06,6.16125,1,52,52,104
2024-04-25 10:49:06,0.05614583333333333,3,5,10,15
2024-04-30 15:37:19,5.274178240740741,12,485,532,1017
2024-04-25 10:13:54,0.05641203703703704,3,4,4,8
2024-04-25 08:36:54,0.006446759259259259,1,2,2,4
2024-04-25 15:28:51,0.29747685185185185,1,41,6,47
2024-04-25 08:56:48,0.025868055555555554,3,2886,208,3094
2024-04-25 08:33:12,0.010081018518518519,1,1,1,2
2024-04-25 10:14:08,0.5557407407407408,1,4,0,4
2024-04-24 20:24:23,0.02082175925925926,3,36,9,45
2024-04-25 13:37:55,0.778275462962963,6,26,21,47
2024-05-03 11:04:15,8.7071875,3,10,5,15
2024-04-24 19:38:52,0.05548611111111111,8,22,15,37
2024-04-25 12:49:30,0.8779513888888889,3,27,2,29
2024-04-24 15:44:12,0.0353587962962963,1,2,2,4
2024-04-24 14:58:54,0.11797453703703703,2,2,15,17
2024-04-26 08:20:35,1.9373148148148147,1,1,1,2
2024-04-24 10:21:27,-0.02712962962962963,2,14,16,30
2024-04-29 16:45:43,5.729421296296296,7,6228,19341,25569
2024-04-24 08:51:35,0.4649421296296296,6,11,19,30
2024-04-29 09:03:27,5.5234143518518515,2,9,9,18
2024-04-30 18:01:01,6.9838657407407405,8,5485,601,6086
2024-04-24 08:50:17,0.6653356481481482,5,31,14,45
2024-04-24 12:03:31,0.7990625,2,10,0,10
2024-05-21 17:14:11,28.059421296296296,1,2,3,5
2024-04-24 07:38:10,0.7717361111111111,1,46,508,554
2024-04-23 13:32:54,0.024444444444444446,1,3,0,3
2024-04-23 15:06:21,0.08962962962962963,4,0,1305,1305
2024-04-25 08:23:41,1.8189467592592592,6,76,16,92
2024-04-24 07:38:19,0.8153587962962963,2,39,14439,14478
2024-04-24 15:32:09,1.1411458333333333,18,3819,20459,24278
2024-05-08 10:42:08,26.785462962962963,35,2467,860,3327
2024-04-24 14:24:34,1.0931018518518518,6,91,18,109
2024-04-24 07:38:31,13.772916666666667,2,14,3625,3639
2024-04-24 12:19:08,1.0990393518518518,4,8,7,15
2024-05-01 07:33:00,8.713506944444445,14,13588,22213,35801
2024-04-30 11:09:08,7.533993055555555,41,265,252,517
2024-04-23 09:39:38,-0.02872685185185185,3,3,1,4
2024-04-23 09:05:57,0.1515162037037037,1,1,1,2
2024-04-23 16:04:17,0.6413194444444444,1,1,1,2
2024-05-20 09:18:09,27.59627314814815,1,1,1,2
2024-04-23 09:42:17,0.6302777777777778,1,3,1,4
2024-04-25 18:38:48,3.0278125,28,367,75,442
2024-04-22 16:13:19,0.018726851851851852,1,14,6,20
2024-04-24 20:32:42,2.280300925925926,4,147,147,294
2024-05-15 12:28:20,25.86841435185185,37,32642,39004,71646
2024-04-22 16:02:55,0.2232523148148148,1,1,1,2
2024-05-07 10:59:49,40.023414351851855,98,6337,8081,14418
2024-04-22 12:42:57,0.20150462962962962,4,41,13,54
2024-04-22 09:57:27,2.3959375,5,5,0,5
2024-04-23 13:23:52,1.7954050925925926,1,12,1,13
2024-04-22 16:00:26,1.1199189814814814,1,2,3,5
2024-04-25 16:23:39,4.1749074074074075,1,10,3,13
2024-04-23 08:57:03,2.6359837962962964,1,1,1,2
2024-04-23 08:56:15,2.6708564814814815,5,4116,203,4319
2024-05-03 15:49:28,13.07074074074074,3,4234,254,4488
2024-05-02 08:33:37,12.432638888888889,2,8,4,12
2024-04-23 17:01:35,3.9292708333333333,2,6,0,6
2024-05-13 11:46:07,46.05696759259259,16,878,703,1581
2024-04-19 14:41:26,0.07550925925925926,4,149,126,275
2024-04-19 13:08:53,0.018414351851851852,1,30,0,30
2024-04-22 13:01:30,3.0202199074074074,5,30,16,46
2024-04-19 12:46:08,0.011180555555555555,1,2,0,2
2024-04-24 07:52:55,1.975486111111111,23,2214,1993,4207
2024-04-19 11:04:12,0.06543981481481481,1,1,1,2
2024-04-19 15:18:36,1.2663425925925926,4,9707,714,10421
2024-04-24 08:11:19,1.782175925925926,12,128204,47395,175599
2024-04-22 16:11:13,3.940173611111111,3,46,5,51
2024-05-07 09:17:28,21.875138888888888,10,167,27,194
2024-04-18 17:46:46,0.11885416666666666,1,8,4,12
2024-04-18 18:18:03,0.18483796296296295,4,17,6,23
2024-04-18 16:18:03,0.8273958333333333,1,6,0,6
2024-04-18 16:41:20,0.12488425925925926,2,28,14,42
2024-04-23 06:05:42,4.687268518518518,1,5,5,10
2024-04-18 13:51:17,0.04840277777777778,5,243,88,331
2024-04-18 12:09:52,0.014861111111111111,2,69,201,270
2024-04-18 14:10:25,0.17069444444444445,1,9,9,18
2024-04-18 12:37:09,0.1487962962962963,4,3256,245,3501
2024-04-18 15:18:01,0.2659375,1,33,33,66
2024-04-18 09:08:34,0.4981481481481482,2,26,10,36
2024-04-17 21:08:12,0.01074074074074074,1,25,9,34
2024-04-18 08:30:40,0.6199074074074075,2,7,1,8
2024-04-19 16:45:53,1.9649189814814816,5,7208,785,7993
2024-04-17 10:01:09,0.003171296296296296,1,0,1,1
2024-04-18 08:35:43,0.9589467592592592,2,26,24,50
2024-04-17 15:17:50,1.0460416666666668,4,31,18,49
2024-04-17 09:26:36,0.022152777777777778,1,7,6,13
2024-04-17 09:23:49,0.026898148148148147,1,1,1,2
2024-04-18 14:31:32,1.9524768518518518,1,6,6,12
2024-04-17 09:47:30,0.18450231481481483,1,2,2,4
2024-04-17 09:46:33,0.24894675925925927,1,1,0,1
2024-04-23 13:33:17,6.789270833333333,3,20,17,37
2024-04-16 17:49:41,0.025833333333333333,2,6,4,10
2024-04-16 19:25:07,0.15791666666666668,1,6,9,15
2024-04-18 09:52:10,1.8468055555555556,3,10,6,16
2024-04-23 08:14:48,6.802546296296296,9,17955,1845,19800
2024-04-16 13:35:03,0.04607638888888889,1,1,1,2
2024-04-17 11:42:27,1.0247800925925925,7,258,142,400
2024-05-13 16:14:36,27.178125,22,35775,38605,74380
2024-04-16 09:58:55,0.054050925925925926,4,65,32,97
2024-04-30 19:02:26,14.467280092592592,6,27184,22183,49367
2024-04-22 19:38:58,6.522037037037037,31,765,197,962
2024-04-19 10:16:09,3.719027777777778,1,18,4,22
2024-05-02 08:24:47,16.658136574074074,16,27127,22198,49325
2024-04-16 16:46:53,1.0098958333333334,3,6,1,7
2024-04-15 17:31:23,0.11143518518518518,1,2,2,4
2024-04-18 08:27:59,3.0321527777777777,13,8896,681,9577
2024-04-15 16:03:03,42.04512731481481,131,57579,19159,76738
2024-04-25 19:18:07,11.025706018518518,8,25981,21971,47952
2024-04-15 15:30:52,0.11016203703703703,1,2,1,3
2024-04-15 13:08:09,0.027199074074074073,1,83,83,166
2024-04-15 12:11:00,0.045717592592592594,2,36,29,65
2024-04-15 11:31:37,0.30430555555555555,2,3,3,6
2024-04-15 08:36:07,0.7212152777777778,1,36,36,72
2024-04-15 16:30:59,1.4341550925925926,1,2,2,4
2024-04-15 12:53:21,2.1136226851851854,1,7,1,8
2024-04-15 10:39:10,2.0541898148148148,1,3,0,3
2024-04-19 19:03:07,6.448518518518519,3,26,3,29
2024-04-25 11:07:21,12.340763888888889,5,96,14,110
2024-04-15 11:18:37,2.571203703703704,1,9,9,18
2024-04-16 12:15:10,3.9013194444444443,10,159,53,212
2024-04-12 15:53:25,0.019097222222222224,1,1,1,2
2024-04-12 16:03:39,0.045023148148148145,1,1,1,2
2024-04-12 14:41:35,0.01476851851851852,1,1,1,2
2024-05-09 20:57:52,27.298460648148147,4,39776,38101,77877
2024-04-12 16:59:45,0.13940972222222223,1,18,17,35
2024-04-12 15:45:15,0.10614583333333333,4,6,6,12
2024-04-16 10:15:57,4.025625,19,56,55,111
2024-04-15 11:20:36,3.1186805555555557,5,308,145,453
2024-04-17 09:38:48,5.794895833333333,3,10,7,17
2024-04-19 08:24:44,7.124386574074074,35,15475,1250,16725
2024-04-12 09:21:24,0.6258217592592593,2,12,10,22
2024-04-12 08:34:45,0.6352083333333334,1,0,1,1
2024-04-15 11:36:50,3.776087962962963,2,10,4,14
2024-04-26 17:21:47,15.041226851851851,2,20,2,22
2024-04-18 16:49:43,7.055983796296296,8,230,219,449
2024-04-12 17:03:49,1.707326388888889,2,9,8,17
2024-04-22 10:31:39,10.8321875,5,17337,1671,19008
2024-05-13 15:30:56,58.7840625,22,855,498,1353
2024-04-15 08:34:37,3.871585648148148,6,13,8,21
2024-04-11 11:47:10,0.08090277777777778,3,7,5,12
2024-05-21 08:16:37,39.95559027777778,23,61230,42717,103947
2024-04-11 08:49:36,0.06018518518518518,1,4,4,8
2024-05-01 07:33:12,20.55346064814815,4,14,7,21
2024-04-11 16:23:56,0.7848842592592593,1,1,1,2
2024-04-10 21:52:52,0.09494212962962963,1,1,1,2
2024-04-11 08:49:17,0.6370254629629629,1,13,2,15
2024-04-10 16:12:43,0.09436342592592592,3,7,4,11
2024-04-10 15:45:49,0.09916666666666667,2,3,2,5
2024-05-21 11:50:11,40.96649305555555,6,78,21,99
2024-04-10 09:51:06,0.03518518518518519,3,4,3,7
2024-04-10 14:58:56,0.5141087962962962,1,2,2,4
2024-04-19 11:21:46,9.572488425925926,11,162,148,310
2024-04-09 16:10:00,0.024895833333333332,4,5,4,9
2024-04-10 08:10:53,4.684537037037037,9,150,358,508
2024-04-09 15:03:36,0.0726736111111111,1,2,2,4
2024-04-10 14:59:13,37.00079861111111,97,1633950,20935,1654885
2024-04-09 10:52:50,0.041087962962962965,2,7,2,9
2024-04-09 09:58:02,0.02189814814814815,1,10,0,10
2024-04-19 10:03:32,10.212256944444444,5,21294,1292,22586
2024-04-11 13:04:46,2.339166666666667,7,3141,575,3716
2024-04-23 13:00:28,14.486400462962964,6,28882,2419,31301
2024-04-09 16:08:37,0.6948958333333334,1,173,6,179
2024-04-11 08:38:24,2.5766435185185186,1,13,12,25
2024-04-09 10:55:42,0.7053935185185185,4,140,62,202
2024-04-09 10:04:18,0.6921643518518519,3,12,13,25
2024-04-17 09:21:26,8.720856481481482,5,72,20,92
2024-04-08 14:57:38,0.02042824074074074,2,4,4,8
2024-04-08 14:25:08,0.043784722222222225,3,38,18,56
2024-04-22 17:30:38,14.294247685185185,16,2557,252,2809
2024-04-08 11:41:29,0.06413194444444445,1,8,8,16
2024-04-08 12:29:21,0.10846064814814815,3,6,5,11
2024-04-08 11:49:32,0.11559027777777778,3,5,1,6
2024-04-09 06:31:47,0.9875694444444445,5,28199,12127,40326
2024-04-08 07:44:05,0.2296412037037037,1,1,1,2
2024-04-08 13:51:11,1.470775462962963,4,18,8,26
2024-04-08 16:45:22,1.8061342592592593,1,3,1,4
2024-04-08 11:49:59,1.8189699074074075,1,14,0,14
2024-04-10 14:36:44,3.9933564814814817,3,5,4,9
2024-04-08 13:54:12,1.9638194444444443,1,1,1,2
2024-04-08 17:07:30,2.486388888888889,4,227,115,342
2024-04-10 13:42:00,4.4442361111111115,4,219,105,324
2024-04-09 08:26:16,3.231527777777778,3,222,106,328
2024-05-13 09:41:03,37.71971064814815,9,46205,31343,77548
2024-04-17 20:21:00,12.303564814814814,22,17565,1850,19415
2024-04-23 11:23:36,4.137037037037037,9,6118,798,6916
2024-04-05 15:49:46,0.31381944444444443,2,8,8,16
2024-04-08 15:10:06,3.2913657407407406,4,26,21,47
2024-04-15 17:42:46,11.434467592592593,8,11631,1096,12727
2024-04-16 10:28:11,11.774456018518519,5,1779,904,2683
2024-04-05 12:30:36,0.8800462962962963,2,18,3,21
2024-04-05 13:14:09,0.9633449074074074,6,51,46,97
2024-04-05 07:06:40,0.7453356481481481,1,1,0,1
2024-04-05 07:07:41,0.7504050925925926,1,4,0,4
2024-04-05 11:11:28,1.0622916666666666,1,2,0,2
2024-05-03 09:02:17,29.27769675925926,4,41617,25578,67195
2024-04-04 10:46:21,0.6426388888888889,3,54,28,82
2024-04-05 14:19:54,1.8734722222222222,8,46,30,76
2024-04-03 17:34:39,0.023449074074074074,2,3,2,5
2024-04-05 16:28:58,2.2005324074074073,3,185,91,276
2024-04-19 16:32:52,16.24943287037037,7,16185,1739,17924
2024-04-08 08:36:53,4.930706018518518,1,2,2,4
2024-04-05 12:04:50,2.133472222222222,2,2,2,4
2024-04-05 13:49:51,2.2681828703703704,5,300,170,470
2024-05-15 06:30:33,42.03024305555556,4,18,18,36
2024-04-10 12:46:39,7.381018518518519,1,3,3,6
2024-04-03 17:05:15,0.9140625,1,3,3,6
2024-05-14 14:32:01,42.406469907407406,122,70531,45020,115551
2024-04-22 12:15:28,19.826319444444444,7,33,13,46
2024-04-16 15:21:25,14.073784722222221,2,37,1,38
2024-05-01 15:23:38,29.164305555555554,2,16,18,34
2024-04-03 19:54:34,1.5675925925925926,1,1,0,1
2024-04-17 09:27:50,15.428182870370371,3,14,5,19
2024-04-03 13:54:45,3.0983680555555555,1,2,2,4
2024-04-01 10:43:58,0.040810185185185185,4,27,10,37
2024-04-24 15:56:45,23.362881944444446,1,5,5,10
2024-04-02 07:51:45,0.9853935185185185,12,52,27,79
2024-04-01 11:08:39,0.05568287037037037,1,1,1,2
2024-05-01 15:58:01,31.946261574074075,2,18,13,31
2024-03-30 18:37:26,0.11144675925925926,1,3,3,6
2024-04-02 09:18:03,3.6619444444444444,1,4,1,5
2024-04-08 10:20:02,9.7240625,3,29,36,65
2024-05-01 16:38:45,33.09577546296296,15,1303,2319,3622
2024-04-02 11:37:56,4.353587962962963,1,31,31,62
2024-03-28 21:26:28,0.09359953703703704,1,1,1,2
2024-04-18 09:04:02,20.733726851851852,78,33247,4673,37920
2024-04-03 07:25:01,5.711111111111111,1,0,44,44
2024-04-02 10:23:49,5.0491319444444445,16,8517,796,9313
2024-04-26 16:06:03,29.111770833333335,5,49,27,76
2024-03-28 14:13:23,0.10015046296296297,2,6,6,12
2024-04-19 16:05:34,22.206712962962964,13,32298,2896,35194
2024-04-10 15:07:58,13.188425925925927,4,6,2,8
2024-04-03 15:42:43,6.334027777777778,1,23,4,27
2024-03-30 16:49:04,2.4299074074074074,3,21,21,42
2024-03-29 14:31:32,1.3868287037037037,2,21,29,50
2024-03-28 07:56:14,0.12758101851851852,2,11,2,13
2024-04-18 13:18:52,21.64607638888889,137,34388,4979,39367
2024-04-02 01:47:32,5.185659722222222,2,157,163,320
2024-03-28 09:54:51,0.5278819444444445,4,19,5,24
2024-03-30 16:38:29,2.8170023148148147,1,8,1,9
2024-03-28 09:53:31,0.6587731481481481,2,36,40,76
2024-04-09 15:10:29,13.161990740740741,48,9148,3159,12307
2024-04-03 09:11:01,6.697997685185185,4,38,30,68
2024-04-01 07:51:00,4.6803125,2,15,19,34
2024-04-02 14:59:05,57.278946759259256,13,273,81,354
2024-04-09 11:28:54,18.099872685185186,35,543,407,950
2024-04-02 08:27:26,5.928032407407407,8,48,16,64
2024-04-01 11:45:25,5.027256944444445,1,13,11,24
2024-04-08 08:36:25,11.927453703703703,6,116,54,170
2024-04-03 17:32:01,7.315150462962963,1,2,2,4
2024-04-05 08:10:44,9.003101851851852,2,44,27,71
2024-03-28 09:42:49,1.1328472222222221,1,11,12,23
2024-03-30 15:30:52,3.4028240740740743,1,5,0,5
2024-03-28 07:56:53,1.1944675925925925,1,1,0,1
2024-04-17 15:59:07,33.82105324074074,71,30644,9498,40142
2024-04-08 13:21:16,12.538032407407407,12,41,41,82
2024-03-31 02:19:17,4.369479166666666,4,22,19,41
2024-03-28 02:30:30,1.4176273148148149,1,5,5,10
2024-03-27 09:18:48,0.7097685185185185,1,3,1,4
2024-04-03 17:37:52,8.05638888888889,8,72,67,139
2024-05-20 08:06:57,54.883032407407406,19,88252,44452,132704
2024-03-28 09:54:08,1.955775462962963,1,7,1,8
2024-04-03 16:00:08,8.225752314814814,4,8617,732,9349
2024-03-26 13:43:12,0.19528935185185184,2,11,5,16
2024-03-30 16:02:32,4.563773148148148,2,10,2,12
2024-03-27 15:14:26,0.16113425925925925,1,12,1,13
2024-03-26 11:32:38,0.6421643518518518,1,1,1,2
2024-04-05 07:49:42,10.53207175925926,3,8689,668,9357
2024-03-26 13:46:02,0.8580092592592593,1,2,0,2
2024-04-10 16:24:32,16.017453703703705,1,1,1,2
2024-03-28 12:54:51,3.0272685185185186,4,12,5,17
2024-05-15 14:02:56,51.090752314814814,51,67326,31004,98330
2024-03-27 07:58:08,21.805706018518517,2,107,26,133
2024-03-28 08:10:26,3.1657060185185184,2,6,0,6
2024-03-28 14:49:57,3.6768171296296295,1,1,1,2
2024-03-28 10:37:16,3.998287037037037,6,143,75,218
2024-03-23 18:32:31,0.2689930555555556,1,1,1,2
2024-03-22 16:04:30,0.05318287037037037,1,2,2,4
2024-03-27 05:28:00,4.6818634259259255,6,5003,8712,13715
2024-03-25 13:26:54,3.087337962962963,1,1,1,2
2024-04-11 12:59:30,20.02658564814815,6,72,75,147
2024-03-28 11:25:50,5.965613425925926,4,777,349,1126
2024-03-22 12:25:40,0.07109953703703703,1,0,10,10
2024-03-22 10:56:47,0.0709837962962963,2,96,90,186
2024-04-25 10:51:19,112.8438425925926,98,214311,64473,278784
2024-03-28 15:19:32,6.578738425925926,8,9327,9040,18367
2024-03-26 12:03:39,4.448287037037037,1,43,43,86
2024-04-22 09:41:03,31.43662037037037,2,5,5,10
2024-04-22 19:41:51,32.04207175925926,5,371,43,414
2024-03-22 12:20:32,0.7059953703703704,1,0,9,9
2024-03-22 12:23:16,0.8033101851851852,1,3,3,6
2024-03-21 16:28:26,0.025451388888888888,1,0,87,87
2024-05-20 13:21:40,59.99413194444445,16,232,174,406
2024-03-21 14:26:51,0.05820601851851852,2,25,8,33
2024-03-21 15:07:39,0.105,3,14,7,21
2024-03-21 15:09:35,0.23991898148148147,1,17,0,17
2024-03-21 12:47:58,0.5074421296296296,3,44,44,88
2024-03-26 12:51:00,5.243888888888889,3,16,4,20
2024-03-22 09:11:59,1.1021296296296297,7,445,371,816
2024-03-21 10:56:41,0.37506944444444446,1,5,5,10
2024-03-21 11:02:53,0.4472453703703704,1,1,1,2
2024-03-21 12:14:29,0.6597685185185185,2,5,16,21
2024-03-20 18:17:26,0.013981481481481482,1,5,5,10
2024-03-20 18:37:29,0.04545138888888889,2,16,1,17
2024-03-20 15:41:03,0.016215277777777776,1,63,30,93
2024-03-20 15:53:42,0.042395833333333334,2,4,2,6
2024-03-21 14:04:12,1.0296527777777778,2,15,1,16
2024-03-20 13:51:16,0.10040509259259259,1,1,1,2
2024-03-20 22:47:01,0.8227662037037037,22,2626,1904,4530
2024-03-20 09:02:11,0.017939814814814815,1,4,4,8
2024-03-26 10:12:24,6.246203703703704,8,4907,1364,6271
2024-04-08 21:51:58,22.15861111111111,7,121,34,155
2024-03-20 10:06:52,0.36618055555555556,1,4,2,6
2024-03-22 10:46:15,2.5966319444444443,3,4609,1197,5806
2024-03-20 12:26:00,0.6189236111111112,2,27,331,358
2024-03-20 07:45:53,0.5975,3,27,314,341
2024-05-15 11:42:29,56.89407407407408,57,83109,54252,137361
2024-03-19 17:32:01,0.18586805555555555,2,151,19,170
2024-03-19 13:47:42,17.349895833333335,21,18605,1664,20269
2024-03-19 17:52:36,0.04,2,369,355,724
2024-04-05 07:26:44,16.708935185185187,3,47,21,68
2024-05-01 16:49:45,43.5541087962963,9,249,163,412
2024-04-02 16:18:32,14.87037037037037,2,28,56,84
2024-03-19 09:23:22,0.5611574074074074,2,2,2,4
2024-03-21 11:17:45,2.9476851851851853,9,48,50,98
2024-03-18 13:32:42,0.11549768518518519,4,20,8,28
2024-03-22 13:13:18,9.118402777777778,3,43,9,52
2024-03-30 16:41:27,12.43287037037037,1,6,1,7
2024-04-04 08:29:32,17.5896875,18,34431,12209,46640
2024-04-24 17:22:08,37.87920138888889,1,4,2,6
2024-03-24 01:29:39,6.221863425925926,4,5,5,10
2024-04-11 12:24:38,24.991435185185185,1,13,26,39
2024-03-20 10:05:29,3.3107060185185184,7,10344,319,10663
2024-03-21 11:18:17,4.993831018518518,1,3,0,3
2024-05-15 07:53:17,60.580613425925925,15,78753,46108,124861
2024-04-25 09:10:02,40.51954861111111,8,248,49,297
2024-03-18 16:17:41,2.918287037037037,8,36,10,46
2024-03-15 17:59:37,0.07475694444444445,1,1,1,2
2024-03-15 18:55:35,-0.008842592592592593,6,1022,186,1208
2024-03-21 16:37:33,6.08425925925926,13,13304,686,13990
2024-03-15 15:35:02,0.017893518518518517,3,3,3,6
2024-04-02 09:39:33,19.75144675925926,14,190,57,247
2024-05-14 08:31:39,59.90354166666667,47,87474,52263,139737
2024-03-15 12:59:10,0.0840625,2,53,19,72
2024-03-15 14:38:36,0.18449074074074073,1,1,1,2
2024-03-15 17:58:11,0.3300810185185185,3,14,2,16
2024-03-18 11:36:01,3.0817592592592593,3,4251,292,4543
2024-03-19 12:44:31,4.124155092592592,4,4263,294,4557
2024-04-25 15:00:09,41.43283564814815,15,448,118,566
2024-03-21 16:30:18,6.839328703703703,2,12,33,45
2024-03-15 17:49:41,0.9151041666666667,3,285,227,512
2024-03-14 19:59:32,0.11623842592592593,2,4,4,8
2024-03-14 16:00:32,0.01693287037037037,2,3,3,6
2024-03-14 18:23:14,0.1633449074074074,11,104,26,130
2024-03-14 15:43:16,0.18122685185185186,1,1,0,1
2024-03-15 15:02:51,1.2633680555555555,1,2,2,4
2024-03-14 10:54:18,0.46525462962962966,1,8,3,11
2024-03-13 20:04:51,-0.09818287037037036,4,5,5,10
2024-03-21 16:33:18,7.92542824074074,5,43,17,60
2024-03-13 17:51:13,0.024363425925925927,2,5,6,11
2024-03-15 14:21:47,1.9109606481481483,1,44,3,47
2024-05-02 16:51:49,8.14462962962963,78,8801,3820,12621
2024-03-21 11:27:03,7.826099537037037,1,1,1,2
2024-03-13 17:52:49,0.10957175925925926,2,57,3,60
2024-03-13 18:12:20,0.14101851851851852,1,2,2,4
2024-03-13 13:53:13,0.21105324074074075,3,33,2,35
2024-03-27 14:54:28,14.238530092592592,9,22077,3150,25227
2024-03-13 08:16:59,0.01724537037037037,1,1,1,2
2024-03-15 13:29:11,2.6495949074074074,27,518084,509652,1027736
2024-03-13 14:49:09,0.7233101851851852,1,1,1,2
2024-03-13 15:07:52,0.8940393518518519,1,35,41,76
2024-03-12 16:32:50,0.04190972222222222,1,1,1,2
2024-03-15 13:00:18,2.900173611111111,6,114,116,230
2024-03-12 18:26:09,0.17594907407407406,1,14,2,16
2024-03-12 16:04:53,0.06386574074074074,3,8,8,16
2024-03-14 15:48:11,2.104814814814815,7,43,17,60
2024-03-13 17:44:35,0.9247106481481482,1,9,1,10
2024-03-12 12:56:52,0.43831018518518516,3,17,16,33
2024-03-20 12:53:22,8.4996875,14,184,180,364
2024-03-12 13:01:55,0.6578472222222222,1,2,2,4
2024-03-12 10:39:57,0.5304513888888889,1,1,1,2
2024-03-12 10:16:21,0.5956597222222222,1,2,2,4
2024-03-12 18:58:12,0.9634490740740741,1,13,0,13
2024-03-12 13:49:57,0.8168287037037038,4,15,6,21
2024-03-12 12:22:29,0.7844444444444445,2,12,8,20
2024-04-19 07:06:01,38.725659722222225,10,1338,1298,2636
2024-03-28 14:01:40,19.94787037037037,11,22096,3200,25296
2024-03-19 10:40:23,7.926712962962963,44,17290,1044,18334
2024-03-13 16:33:02,54.34884259259259,27,64900,15579,80479
2024-03-20 15:51:12,9.217731481481481,29,3969,689,4658
2024-04-10 07:45:07,29.901875,16,39453,13122,52575
2024-03-19 17:03:31,14.033495370370371,10,11934,2679,14613
2024-03-11 17:43:35,0.4842939814814815,2,4,4,8
2024-03-11 17:17:43,0.10425925925925926,2,129,8,137
2024-03-11 14:14:03,0.718599537037037,1,10,10,20
2024-04-10 13:47:17,30.719722222222224,3,36,26,62
2024-04-10 14:02:50,30.83199074074074,2,33,5,38
2024-03-11 17:15:37,1.6151851851851853,2,1975,109,2084
2024-03-27 03:52:12,17.236863425925925,5,41,10,51
2024-03-13 16:28:11,15.497939814814815,9,19281,2130,21411
2024-03-11 17:26:39,2.033935185185185,1,1,1,2
2024-03-27 01:08:43,17.55527777777778,5,77,66,143
2024-03-11 11:05:16,2.029826388888889,1,1,1,2
2024-04-26 18:40:13,49.309699074074075,12,76040,35829,111869
2024-03-13 14:52:37,4.770925925925926,2,49,23,72
2024-03-13 16:40:14,4.903761574074074,3,14,16,30
2024-03-08 17:27:30,0.01738425925925926,1,1,1,2
2024-05-22 13:07:52,75.12527777777778,1,5,6,11
2024-03-08 16:04:19,0.040185185185185185,4,17,6,23
2024-03-08 11:20:32,0.016168981481481482,1,1,1,2
2024-03-13 13:53:27,5.163356481481482,4,100,13,113
2024-03-08 11:21:44,1.192048611111111,5,346,1001,1347
2024-03-12 21:44:50,4.6967592592592595,3,12,3,15
2024-03-07 17:30:28,0.03498842592592592,2,5,3,8
2024-03-08 12:53:17,0.8735879629629629,2,4,4,8
2024-03-08 10:06:46,0.8352430555555556,2,57,86,143
2024-03-11 18:42:06,4.2880671296296295,6,243,189,432
2024-03-08 09:47:44,0.9210763888888889,2,26,14,40
2024-03-07 11:12:42,0.012129629629629629,1,4,81,85
2024-03-08 10:13:54,1.1051041666666668,11,204,524,728
2024-03-07 09:28:02,0.29783564814814817,3,3,1,4
2024-03-07 20:45:52,0.920162037037037,2,125,1,126
2024-03-07 20:43:58,1.0645833333333334,4,13,12,25
2024-03-07 10:44:44,0.7602314814814815,1,9,400,409
2024-03-06 17:03:55,0.04766203703703704,1,2,3,5
2024-03-13 14:40:03,6.97042824074074,3,16,4,20
2024-03-13 13:44:19,6.95480324074074,1,11,37,48
2024-03-07 11:44:23,1.058113425925926,1,1,1,2
2024-03-29 10:51:20,23.03934027777778,5,52,9,61
2024-03-15 14:28:52,10.468414351851852,11,28525,2102,30627
2024-03-06 05:30:47,0.06431712962962963,2,40,1,41
2024-03-19 14:13:56,13.534976851851852,17,18026,1759,19785
2024-03-11 08:46:24,5.317974537037037,3,15,18,33
2024-03-14 16:35:31,8.90320601851852,6,188,111,299
2024-03-06 10:57:05,0.8198611111111112,1,72,2,74
2024-03-27 12:18:10,22.00517361111111,29,32574,13167,45741
2024-03-06 02:58:43,7.949583333333333,5,13050,996,14046
2024-03-05 10:01:08,0.013472222222222222,2,9,4,13
2024-03-05 09:39:42,0.005300925925925926,4,5,4,9
2024-03-06 05:58:38,0.915787037037037,4,33,7,40
2024-03-28 12:58:40,23.29140046296296,4,2897,281,3178
2024-03-05 08:42:52,0.1373263888888889,7,38,36,74
2024-03-15 14:18:41,10.461342592592592,9,38495,3582,42077
2024-04-04 09:11:10,30.19846064814815,16,47841,13841,61682
2024-03-06 09:44:08,1.3360069444444445,4,2219,169,2388
2024-03-07 11:45:47,2.6106944444444444,4,9486,898,10384
2024-03-06 11:19:48,1.9117824074074075,1,2,2,4
2024-03-06 12:11:54,1.9025,2,5,2,7
2024-03-06 14:28:45,2.0077199074074072,3,12775,1074,13849
2024-03-06 11:18:35,1.9033796296296297,4,103,65,168
2024-03-06 23:57:23,2.4625925925925927,3,18,18,36
2024-03-05 10:27:36,0.9217824074074074,1,117,104,221
2024-03-05 17:19:00,1.2896990740740741,2,246,6,252
2024-03-18 14:50:56,14.568078703703703,4,28666,1852,30518
2024-03-05 07:57:34,1.3933912037037037,1,8,8,16
2024-03-06 23:56:25,3.798773148148148,13,9077,817,9894
2024-03-04 09:19:13,1.9456712962962963,4,49,8,57
2024-03-05 12:37:55,4.097893518518519,5,117,40,157
2024-03-22 11:57:08,21.10565972222222,8,36279,4085,40364
2024-03-14 11:30:19,13.113912037037037,5,18283,1565,19848
2024-03-01 07:59:26,0.316724537037037,2,2,2,4
2024-03-01 15:32:37,0.7653472222222222,1,8,0,8
2024-03-27 01:11:55,27.798842592592592,46,15713,12345,28058
2024-03-01 17:00:29,1.1060185185185185,5,31,27,58
2024-03-04 11:17:42,3.881875,1,12,72,84
2024-03-04 07:26:01,3.741435185185185,1,1,1,2
2024-03-01 09:22:31,0.9303587962962963,2,8,30,38
2024-02-29 10:25:17,0.025729166666666668,1,2,3,5
2024-03-04 08:08:56,4.077569444444444,1,2,2,4
2024-02-29 09:19:18,0.21212962962962964,2,94,85,179
2024-02-29 03:49:02,0.021354166666666667,1,1,0,1
2024-02-29 02:52:13,0.009837962962962963,1,4,4,8
2024-03-11 12:44:13,11.514293981481481,2,3,2,5
2024-02-29 10:09:50,0.5459375,3,3199,677,3876
2024-04-02 17:15:27,33.93799768518519,1,1,1,2
2024-03-20 14:22:35,20.931631944444444,19,469,231,700
2024-02-28 09:41:58,0.02662037037037037,3,6,6,12
2024-02-28 09:13:57,0.01105324074074074,1,1,1,2
2024-03-08 11:11:10,9.130821759259259,3,36,7,43
2024-03-26 12:57:07,27.224050925925926,2,89,1,90
2024-03-07 13:52:00,8.466956018518518,1,1,1,2
2024-03-11 14:07:16,122.24340277777777,7,144,101,245
2024-02-28 17:41:18,0.6474537037037037,2,269,346,615
2024-02-29 02:56:16,1.0687731481481482,1,11,1,12
2024-03-01 02:01:53,2.0368981481481483,3,24,10,34
2024-02-28 08:38:44,0.6174768518518519,3,19,17,36
2024-02-28 11:34:54,0.8420023148148148,2,22,34,56
2024-02-28 15:36:47,1.1712384259259259,9,163,201,364
2024-03-05 01:29:19,6.670914351851851,2,3383,581,3964
2024-04-02 14:55:11,35.358715277777776,5,18,10,28
2024-03-04 21:57:53,6.726898148148148,5,601,21,622
2024-03-05 08:16:06,7.163356481481482,3,5,3,8
2024-03-04 07:24:39,6.1342592592592595,2,8,8,16
2024-03-08 15:52:25,10.543310185185184,2,5,2,7
2024-02-28 14:56:25,1.1694791666666666,5,2813,45,2858
2024-02-27 19:26:57,0.7178472222222222,2,164,1,165
2024-03-04 11:04:49,6.555208333333334,2,17,4,21
2024-03-01 09:42:13,3.7317939814814816,3,46,47,93
2024-03-12 17:46:19,15.20962962962963,31,21738,2531,24269
2024-03-05 07:18:23,7.822800925925926,10,41,30,71
2024-02-27 09:43:01,0.9226273148148149,1,4,2,6
2024-02-26 17:24:31,0.2564351851851852,1,1,1,2
2024-02-26 09:41:01,0.024756944444444446,1,1,1,2
2024-02-28 14:16:53,2.3421875,20,7957,272,8229
2024-02-27 09:44:49,1.2945717592592592,7,19,9,28
2024-02-26 09:01:45,0.5009259259259259,1,1,0,1
2024-02-27 18:15:43,2.8378472222222224,5,9,9,18
2024-04-17 10:19:18,53.34481481481482,14,204,77,281
2024-02-27 14:58:43,3.6879050925925925,3,18,4,22
2024-02-28 02:10:36,4.240844907407407,1,5,20,25
2024-03-01 01:58:19,6.344733796296296,3,13,11,24
2024-03-26 06:13:14,31.563391203703702,4,73,9,82
2024-02-28 10:16:15,4.8176041666666665,4,5046,158,5204
2024-04-03 15:53:07,40.07996527777778,3,58,2,60
2024-02-27 09:51:38,3.8680671296296296,1,4,6,10
2024-02-28 05:25:23,4.756342592592593,8,7922,282,8204
2024-02-26 13:06:43,3.0800925925925924,1,13,5,18
2024-02-23 09:43:31,0.010115740740740741,2,4,4,8
2024-03-08 11:58:25,14.145208333333333,4,19,19,38
2024-04-12 08:01:28,49.03390046296296,176,62690,16772,79462
2024-02-26 16:27:47,3.3966666666666665,1,199,0,199
2024-02-26 16:53:05,3.438298611111111,2,404,1,405
2024-03-04 14:18:10,19.316944444444445,18,17038,4046,21084
2024-02-26 16:42:46,3.5970949074074072,3,594,3,597
2024-03-28 09:31:24,34.58153935185185,33,50794,14240,65034
2024-04-03 15:51:03,41.093587962962964,6,69,8,77
2024-02-26 16:18:15,4.689537037037037,11,869,321,1190
2024-03-20 15:50:23,26.903425925925927,28,7151,555,7706
2024-02-28 00:24:35,48.16930555555555,26,53644,17156,70800
2024-02-26 10:05:49,3.8370254629629628,3,100,54,154
2024-03-04 13:12:35,11.0090625,2,3,3,6
2024-02-22 15:40:06,0.11787037037037038,3,41,35,76
2024-02-23 09:40:44,0.888125,3,51,51,102
2024-02-23 13:37:08,1.100439814814815,3,14,35,49
2024-05-06 08:10:32,74.08224537037037,234,102190,42406,144596
2024-02-28 09:45:53,6.274097222222222,25,8355,563,8918
2024-02-23 08:19:52,1.2477777777777779,3,30,14,44
2024-03-08 13:36:31,15.602569444444445,1,2,2,4
2024-02-22 00:07:53,0.06878472222222222,6,149,20,169
2024-02-23 12:46:31,3.029849537037037,9,67,30,97
2024-04-16 14:34:05,55.0405787037037,24,113371,29965,143336
2024-02-26 13:36:12,4.998530092592593,6,24,42,66
2024-02-21 13:56:34,0.013460648148148149,1,21,23,44
2024-03-01 10:29:22,8.873784722222222,1,2,0,2
2024-02-21 13:21:29,30.73949074074074,142,40288,16210,56498
2024-02-21 12:51:15,0.02701388888888889,1,1,1,2
2024-02-27 00:43:52,5.662685185185185,1,9,4,13
2024-03-13 15:30:32,21.62733796296296,4,23,23,46
2024-03-05 12:23:34,13.637685185185186,3,2389,2389,4778
2024-02-27 18:15:26,7.2175115740740745,7,9441,3741,13182
2024-02-20 17:31:59,0.274837962962963,1,3,4,7
2024-02-20 16:17:51,0.05417824074074074,1,8,0,8
2024-02-21 09:47:42,0.9374652777777778,2,38,44,82
2024-02-21 16:09:36,1.1045717592592592,5,6462,184,6646
2024-02-20 13:31:36,0.05792824074074074,1,19,16,35
2024-02-20 12:06:47,0.07487268518518518,2,0,144,144
2024-02-27 02:03:00,6.681111111111111,1,2,2,4
2024-02-20 11:38:59,0.08497685185185185,12,827,625,1452
2024-03-06 15:06:45,15.278865740740741,7,26070,2503,28573
2024-02-20 10:11:15,0.32158564814814816,2,1,1,2
2024-02-20 11:34:31,0.6928587962962963,4,49,31,80
2024-02-20 01:24:48,0.2788541666666667,1,2,2,4
2024-02-26 16:06:17,6.905543981481482,2,43,45,88
2024-02-21 11:19:31,1.7624421296296295,16,1797,1023,2820
2024-03-25 09:33:39,18.9884375,13,11175,15180,26355
2024-02-20 10:23:17,0.8576851851851852,3,39,12,51
2024-02-20 13:33:12,1.9010648148148148,1,129,1,130
2024-02-21 12:12:49,1.9817824074074073,7,178,11,189
2024-02-19 12:23:25,0.009050925925925926,1,1,1,2
2024-02-20 17:13:15,1.2164814814814815,1,268,0,268
2024-02-19 18:50:29,0.3756365740740741,2,5,5,10
2024-03-25 09:43:46,35.275983796296295,3,53469,6242,59711
2024-02-19 14:08:44,0.35106481481481483,9,45,45,90
2024-03-04 10:53:58,14.244212962962964,5,29,24,53
2024-02-19 09:39:12,0.3515277777777778,1,1,1,2
2024-02-19 10:15:58,0.42261574074074076,1,1,1,2
2024-03-05 23:47:33,16.23542824074074,5,365,28,393
2024-03-12 13:20:49,22.79232638888889,8,31990,3444,35434
2024-02-22 10:48:01,4.009722222222222,2,188,92,280
2024-02-20 01:43:02,1.5114930555555555,5,395,47,442
2024-02-27 08:32:39,9.525729166666666,6,8126,1038,9164
2024-02-19 13:01:16,2.5283333333333333,1,1,1,2
2024-02-20 12:08:32,3.631712962962963,2,22,9,31
2024-02-19 18:04:45,3.047025462962963,3,4,0,4
2024-03-08 14:31:05,20.906909722222224,1,3,1,4
2024-02-20 15:20:20,3.9802546296296297,9,2601,623,3224
2024-02-16 15:04:24,0.026087962962962962,2,15,23,38
2024-02-16 12:41:09,0.10388888888888889,1,5,0,5
2024-02-16 11:48:46,0.0764699074074074,1,0,3,3
2024-02-20 11:45:09,4.186319444444444,6,3940,2830,6770
2024-02-23 08:26:21,7.078321759259259,2,3,2,5
2024-02-28 15:09:25,12.910185185185185,25,13604,5418,19022
2024-02-15 18:12:31,0.04787037037037037,1,1,1,2
2024-02-15 17:26:34,0.025497685185185186,2,44,4,48
2024-03-05 11:54:00,18.86945601851852,10,29961,5008,34969
2024-02-15 14:33:26,0.02869212962962963,2,3,2,5
2024-04-26 15:55:24,125.8153125,32,771,663,1434
2024-02-15 14:02:58,0.019398148148148147,1,2,1,3
2024-02-15 18:11:13,0.31462962962962965,1,0,1,1
2024-02-16 14:47:19,1.3399652777777777,4,25,3,28
2024-02-14 23:55:48,0.018773148148148146,2,35,50,85
2024-05-07 09:12:21,73.78783564814815,5,21988,21736,43724
2024-03-15 15:51:30,29.761782407407406,58,42143,7024,49167
2024-02-16 10:31:51,1.8737152777777777,1,1,0,1
2024-02-15 12:31:09,1.2426273148148148,11,43,30,73
2024-02-14 22:56:35,0.9038425925925926,2,37,3,40
2024-05-20 09:38:32,96.6762962962963,12,99177,20441,119618
2024-02-14 10:29:23,0.7801041666666667,4,6,5,11
2024-02-16 07:16:58,2.648321759259259,2,2688,2693,5381
2024-03-15 12:34:48,30.890069444444446,8,47653,6295,53948
2024-02-16 11:25:12,3.0722569444444443,18,14026,3728,17754
2024-02-14 00:30:23,0.8098958333333334,3,20,7,27
2024-02-15 12:09:39,25.954166666666666,24,16587,5702,22289
2024-02-14 00:19:42,0.9070370370370371,4,12,7,19
2024-02-19 00:31:39,5.960532407407407,5,9518,442,9960
2024-02-20 20:22:09,8.031759259259259,2,57,9,66
2024-03-01 17:04:40,17.989988425925926,4,46613,13352,59965
2024-02-13 09:58:20,0.8333912037037037,4,66,20,86
2024-02-12 14:57:25,0.0369212962962963,1,2,2,4
2024-02-27 09:39:59,14.82292824074074,17,13732,3420,17152
2024-03-19 14:43:02,36.93327546296296,39,1893,168,2061
2024-02-12 18:50:31,1.3735648148148147,1,9,6,15
2024-02-12 18:48:31,2.039270833333333,1,137,137,274
2024-02-12 21:39:20,2.205625,4,372,36,408
2024-02-14 07:41:31,3.862673611111111,4,391,16,407
2024-02-12 14:34:08,2.1653356481481483,1,1,1,2
2024-02-14 21:44:50,5.04087962962963,10,147,59,206
2024-02-14 20:39:01,5.018622685185186,5,125,21,146
2024-02-12 15:47:08,3.072372685185185,1,4,2,6
2024-02-13 13:02:07,3.7184606481481484,2,2,2,4
2024-02-16 16:41:01,6.967546296296296,14,200,54,254
2024-02-26 10:35:37,16.73267361111111,20,22857,4419,27276
2024-02-09 15:42:01,0.07486111111111111,1,2,2,4
2024-02-09 15:10:47,0.1024074074074074,1,1,1,2
2024-03-25 09:46:40,23.804131944444446,4,88,58,146
2024-02-15 05:27:40,5.974583333333333,42,7505,772,8277
2024-02-09 20:56:22,1.0572453703703704,4,643,56,699
2024-04-22 13:13:04,75.94815972222223,68,1328,803,2131
2024-02-12 14:43:34,3.9525,3,4,2,6
2024-02-14 08:25:41,5.7730092592592595,24,616,129,745
2024-02-08 15:38:29,0.08958333333333333,2,2,2,4
2024-02-08 14:17:33,0.033032407407407406,1,0,50,50
2024-02-14 15:40:58,6.24994212962963,2,2,5,7
2024-02-14 13:55:12,6.496875,1,3,3,6
2024-02-08 22:13:35,0.9523148148148148,5,59,62,121
2024-02-08 01:19:39,0.31688657407407406,1,1,1,2
2024-02-08 02:31:48,0.375,1,3,3,6
2024-02-07 15:37:09,0.24275462962962963,3,8,10,18
2024-02-06 20:00:42,0.13591435185185186,3,6,0,6
2024-02-06 16:18:30,0.02953703703703704,1,15,113,128
2024-02-14 18:29:49,8.155,28,284,44,328
2024-02-07 12:28:24,0.9103819444444444,1,12,5,17
2024-02-06 17:45:20,0.1354050925925926,1,2,3,5
2024-02-06 16:21:05,0.2278125,4,50,48,98
2024-02-07 08:40:11,0.8574421296296296,1,1,8,9
2024-02-06 10:05:23,0.02607638888888889,2,4,3,7
2024-02-08 16:00:53,2.290439814814815,15,364,396,760
2024-02-07 17:27:01,1.4526273148148148,1,3,0,3
2024-02-07 07:46:37,1.1016550925925925,1,1,1,2
2024-02-08 15:28:17,2.472303240740741,1,15,15,30
2024-04-23 21:13:00,77.73982638888889,28,110547,21328,131875
2024-02-06 02:53:08,0.01721064814814815,1,1,1,2
2024-02-06 03:06:30,0.27510416666666665,1,5,5,10
2024-02-06 19:15:45,1.021400462962963,1,35,36,71
2024-02-06 03:24:20,0.410150462962963,1,2,0,2
2024-02-06 05:55:45,0.6984490740740741,2,12,3,15
2024-02-12 09:21:36,6.883842592592592,3,15,11,26
2024-02-06 02:21:50,0.7124189814814815,1,3,1,4
2024-02-05 12:19:21,0.41737268518518517,1,1,2,3
2024-02-05 02:38:08,1.0573148148148148,1,3,3,6
2024-02-16 13:40:23,12.737268518518519,4,96,11,107
2024-02-06 20:01:02,3.2386921296296296,5,203,189,392
2024-02-12 15:47:21,9.726157407407408,2,2289,791,3080
2024-02-05 02:12:30,2.3274421296296297,1,1,1,2
2024-02-16 23:50:06,14.18074074074074,9,2722,872,3594
2024-02-20 10:05:46,17.683854166666666,23,17903,5306,23209
2024-02-02 16:57:08,0.05116898148148148,1,5,0,5
2024-02-02 15:44:13,0.043368055555555556,1,2,2,4
2024-02-02 13:11:50,0.019594907407407408,2,22,2,24
2024-03-04 13:24:40,31.054074074074073,3,32754,5963,38717
2024-02-02 12:11:48,0.08472222222222223,1,2,2,4
2024-02-02 15:48:01,0.37474537037037037,1,2,0,2
2024-02-02 07:45:00,0.3068518518518519,5,185,186,371
2024-02-02 08:13:37,0.4549537037037037,1,3,3,6
2024-02-05 13:14:47,3.7820601851851854,5,419,278,697
2024-02-02 07:22:18,0.5587615740740741,2,18,13,31
2024-03-18 13:06:12,74.93751157407408,72,101267,21961,123228
2024-03-11 15:58:06,39.2334375,1,3,2,5
2024-02-14 06:15:18,13.06712962962963,11,4780,1311,6091
2024-02-01 16:59:29,0.4976041666666667,1,50,49,99
2024-02-02 08:34:12,1.2626967592592593,6,29,16,45
2024-04-26 15:23:44,71.77195601851852,22,68316,15934,84250
2024-02-01 08:03:54,0.7568055555555555,1,8,0,8
2024-01-31 13:18:31,0.02625,2,38,20,58
2024-02-26 16:42:24,319.15358796296294,18,465735,159955,625690
2024-01-31 02:21:28,0.01337962962962963,1,0,22,22
2024-01-31 00:31:20,0.028252314814814813,1,2,0,2
2024-01-31 17:07:30,0.9753240740740741,1,1,1,2
2024-01-30 22:01:12,0.170625,12,19,16,35
2024-02-14 20:46:44,54.01762731481482,10,238,65,303
2024-02-05 02:48:41,5.402511574074074,2,10,3,13
2024-01-30 16:48:49,0.027083333333333334,1,1,1,2
2024-01-31 01:10:44,1.365775462962963,1,1,1,2
2024-02-06 02:41:42,7.550983796296296,8,147,12,159
2024-01-30 13:54:42,0.11813657407407407,1,6,1,7
2024-01-31 17:04:43,2.2497337962962964,26,286,225,511
2024-05-06 12:23:40,99.62042824074074,20,135910,48795,184705
2024-01-30 06:20:21,0.17506944444444444,1,3,3,6
2024-02-01 14:44:58,2.8184722222222223,3,12,3,15
2024-01-31 14:39:08,1.9295717592592592,5,231,157,388
2024-02-16 11:44:58,17.88253472222222,17,22897,5962,28859
2024-01-29 15:22:14,0.03943287037037037,3,3,3,6
2024-01-29 15:22:25,0.057060185185185186,2,2,0,2
2024-03-04 09:23:40,34.82224537037037,1,2,1,3
2024-03-01 01:12:51,31.514664351851852,1,4,0,4
2024-02-09 10:24:01,10.944467592592593,6,31,11,42
2024-01-29 10:06:52,0.820949074074074,2,2,2,4
2024-01-31 12:58:27,3.195821759259259,5,113,79,192
2024-01-29 10:06:31,2.4752083333333332,1,49,23,72
2024-02-01 17:16:17,5.895324074074074,6,9758,4402,14160
2024-01-28 15:10:14,1.817800925925926,1,27,4,31
2024-01-26 18:20:40,0.03159722222222222,1,1,1,2
2024-01-31 13:18:42,4.844710648148149,4,91,48,139
2024-01-29 09:42:56,2.698773148148148,3,4,7,11
2024-01-26 16:39:33,0.13429398148148147,2,2,2,4
2024-01-29 15:25:00,3.1505324074074075,1,10,2,12
2024-01-26 12:00:49,0.04116898148148148,1,20,15,35
2024-02-01 08:45:02,5.938240740740741,2,135,111,246
2024-01-26 11:58:57,0.23607638888888888,2,2,2,4
2024-01-26 11:59:34,0.2887962962962963,1,1,1,2
2024-01-26 17:29:07,0.7656828703703704,2,112,75,187
2024-01-26 12:22:30,0.7620138888888889,2,15,7,22
2024-01-26 08:02:33,0.6603935185185185,2,10,12,22
2024-02-20 00:52:15,25.36608796296296,7,27,11,38
2024-05-20 11:40:42,116.00581018518518,5,158188,59848,218036
2024-02-19 14:22:29,25.09587962962963,8,19928,6134,26062
2024-01-26 11:52:54,1.0908680555555557,1,1,2,3
2024-01-29 18:07:49,4.39605324074074,5,602,13,615
2024-01-25 09:34:53,0.06324074074074074,1,1,1,2
2024-01-25 14:06:38,0.27145833333333336,2,1363,3,1366
2024-01-31 12:02:07,6.6074421296296295,30,10414,7050,17464
2024-01-29 10:10:41,10.60099537037037,4,4869,3989,8858
2024-01-24 19:19:00,0.039502314814814816,3,41,38,79
2024-01-31 14:58:17,7.017731481481482,4,67,54,121
2024-01-24 14:37:30,0.027939814814814813,2,84,18,102
2024-01-24 11:57:45,0.713113425925926,2,9,3,12
2024-02-19 17:34:17,59.03525462962963,1,221,5,226
2024-01-25 11:51:59,1.8065046296296297,3,3190,2735,5925
2024-01-23 16:53:07,0.021458333333333333,2,1,18,19
2024-02-14 15:18:09,22.00346064814815,18,370,77,447
2024-01-30 16:54:09,38.85611111111111,8,141,96,237
2024-01-23 11:22:02,0.06157407407407407,1,1,1,2
2024-05-01 18:58:35,99.87254629629629,1,1,1,2
2024-01-25 08:34:50,2.521689814814815,23,2381,661,3042
2024-01-23 09:11:10,0.5359490740740741,1,8,9,17
2024-01-24 17:07:14,1.6674305555555555,12,713,243,956
2024-01-22 14:50:01,0.03657407407407407,1,1,1,2
2024-01-29 14:46:33,7.043611111111111,1,3,3,6
2024-01-22 13:16:29,0.017511574074074075,1,6,0,6
2024-01-22 13:45:30,0.104375,2,20,17,37
2024-01-23 13:30:36,1.0816435185185185,1,5,3,8
2024-01-22 15:20:17,0.19967592592592592,1,1,1,2
2024-03-05 02:22:48,42.724699074074074,16,47495,13705,61200
2024-01-25 15:03:21,2.903113425925926,2,3793,2927,6720
2024-03-22 12:02:43,59.95291666666667,6,83294,17501,100795
2024-01-23 15:27:25,1.6341435185185185,1,4,1,5
2024-02-07 12:42:01,17.14361111111111,7,15500,7850,23350
2024-02-08 07:23:15,18.252881944444443,1,1,1,2
2024-01-22 14:28:18,1.621539351851852,3,27,5,32
2024-02-01 15:07:45,12.077847222222223,17,5942,3773,9715
2024-01-23 21:09:01,3.676527777777778,1,9,9,18
2024-01-27 15:54:19,8.04699074074074,1,3,3,6
2024-01-27 15:52:59,8.048553240740741,1,0,11,11
2024-01-23 17:48:38,4.238090277777777,4,18,8,26
2024-01-21 17:01:20,2.2206828703703705,7,40,29,69
2024-01-22 13:46:05,3.086099537037037,1,10,0,10
2024-01-19 14:09:36,0.1620023148148148,2,19,1,20
2024-01-22 11:31:31,3.7871875,1,1,1,2
2024-01-30 17:26:36,12.06587962962963,19,2871,2728,5599
2024-01-19 11:25:01,0.8516087962962963,3,24,4,28
2024-01-19 09:59:15,0.8390277777777778,6,37,23,60
2024-01-25 17:55:11,7.133622685185185,1,13,4,17
2024-01-18 17:01:49,0.133125,2,21,6,27
2024-01-22 17:15:07,4.146909722222222,1,4,4,8
2024-01-19 12:30:00,1.0503587962962964,1,8,6,14
2024-01-18 13:41:25,0.14550925925925925,2,62,58,120
2024-01-18 13:35:09,0.11543981481481481,1,5,5,10
2024-01-19 12:31:25,1.416261574074074,2,2,2,4
2024-01-18 13:47:50,0.7197453703703703,2,9,9,18
2024-01-26 16:25:09,8.874479166666667,2,64,38,102
2024-01-17 21:26:21,0.17108796296296297,1,1,1,2
2024-01-18 16:41:44,0.9738310185185185,3,24,9,33
2024-01-22 15:17:39,4.97917824074074,3,24,21,45
2024-02-05 20:04:17,123.3709375,7,3237,3105,6342
2024-01-26 08:37:05,8.782824074074075,4,38,33,71
2024-01-17 16:29:19,0.205,8,27,16,43
2024-01-17 09:59:40,0.014143518518518519,1,6,4,10
2024-01-24 16:31:28,12.009212962962962,7,6338,4833,11171
2024-02-20 01:23:25,34.36412037037037,4,40800,12965,53765
2024-01-17 13:22:45,0.8839467592592593,2,17,18,35
2024-01-19 12:32:06,2.8943287037037035,5,49,32,81
2024-01-16 15:37:16,0.2235185185185185,5,36,25,61
2024-01-16 15:50:02,0.3107523148148148,5,34,10,44
2024-01-16 17:52:44,0.42131944444444447,3,19,15,34
2024-01-16 15:36:29,0.33265046296296297,6,33,7,40
2024-01-24 09:12:14,8.676261574074074,10,124,69,193
2024-01-16 18:31:02,0.9810300925925926,9,173,98,271
2024-01-15 17:00:55,0.0303125,3,17,4,21
2024-01-15 19:37:00,0.3155439814814815,1,9,0,9
2024-01-19 14:07:32,4.054421296296296,7,86,38,124
2024-01-18 10:55:30,3.022060185185185,3,74,32,106
2024-01-17 19:03:08,2.524537037037037,1,5,3,8
2024-02-13 03:47:20,29.468831018518518,23,27505,10365,37870
2024-01-23 15:08:18,9.20556712962963,14,11675,2113,13788
2024-01-16 10:30:27,2.0203819444444444,2,22,2,24
2024-01-15 18:36:40,1.5666782407407407,3,484,520,1004
2024-01-15 17:04:08,1.9252199074074074,2,176,458,634
2024-01-13 20:31:25,0.1128125,2,7,6,13
2024-01-15 16:45:15,2.536412037037037,1,3,3,6
2024-01-18 16:11:50,5.9461458333333335,3,20,85,105
2024-01-18 16:12:15,5.955069444444445,2,7,1,8
2024-01-12 16:56:34,0.028449074074074075,1,240,1689,1929
2024-01-15 10:38:21,2.8341435185185184,2,6,2,8
2024-01-16 14:14:29,4.051620370370371,9,669,1878,2547
2024-01-24 16:47:35,12.130185185185185,10,1406,1406,2812
2024-01-12 15:21:15,0.12385416666666667,2,15,2,17
2024-01-12 16:01:17,0.1616550925925926,3,20,25,45
2024-01-12 15:25:44,0.18994212962962964,1,10,10,20
2024-01-12 14:31:01,0.2484375,1,1,1,2
2024-01-12 17:54:11,0.9597106481481481,5,10,4,14
2024-01-12 11:58:59,0.734224537037037,2,9,2,11
2024-01-12 14:28:55,0.8638078703703703,1,1,1,2
2024-01-11 14:34:06,0.00920138888888889,1,2,2,4
2024-01-11 17:26:13,0.15265046296296297,2,10,10,20
2024-01-11 17:23:42,0.17840277777777777,1,4,0,4
2024-01-17 10:50:54,5.964652777777777,6,2438,2810,5248
2024-02-01 02:53:49,20.78210648148148,12,1601,76,1677
2024-01-30 16:54:57,19.99471064814815,6,157,157,314
2024-01-10 17:09:07,0.02105324074074074,1,1,1,2
2024-01-17 15:02:22,6.960324074074074,76,6191,3279,9470
2024-01-11 10:29:39,1.5722106481481481,1,132,17,149
2024-01-10 12:39:05,0.09070601851851852,4,11,11,22
2024-01-11 16:55:48,1.387488425925926,4,27,12,39
2024-01-10 11:11:09,0.14248842592592592,1,1,1,2
2024-01-15 08:09:23,5.329236111111111,1,18,14,32
2024-01-11 14:38:44,1.633923611111111,1,47,38,85
2024-01-10 11:02:31,0.6331597222222223,2,5,2,7
2024-01-11 14:52:14,1.888136574074074,7,351,101,452
2024-01-11 15:12:09,1.930810185185185,2,15,9,24
2024-01-10 10:22:44,0.7590393518518519,1,1,1,2
2024-01-16 13:29:51,6.948402777777778,9,650,130,780
2024-01-16 07:04:08,6.878229166666666,8,2169,2341,4510
2024-01-10 21:35:36,1.4966782407407409,5,12,3,15
2024-01-19 14:12:02,45.57625,53,65642,6858,72500
2024-01-15 13:48:08,6.240347222222222,29,2101,2394,4495
2024-01-09 10:05:19,0.6524768518518519,3,8,8,16
2024-01-11 13:39:49,2.0709375,1,1,1,2
2024-01-12 12:35:31,3.8516435185185185,6,77,52,129
2024-01-10 15:07:48,2.044837962962963,2,26,1,27
2024-01-19 12:28:54,11.132002314814814,6,16479,3672,20151
2024-01-08 09:39:41,0.40702546296296294,2,10,4,14
2024-03-04 10:51:16,70.03496527777777,8,123,79,202
2024-01-15 18:12:09,7.936145833333334,1,1,1,2
2024-01-12 20:01:22,5.853715277777778,1,7,7,14
2024-01-08 12:33:45,1.9276273148148149,1,2,2,4
2024-01-10 15:55:43,4.709895833333333,5,29,23,52
2024-02-13 18:27:06,38.90927083333333,7,2481,799,3280
2024-01-15 15:52:18,54.686597222222225,14,72199,8018,80217
2024-01-05 21:19:15,0.1233912037037037,1,12,12,24
2024-01-09 10:17:08,4.103043981481481,2,19,3,22
2024-01-05 11:21:29,-0.027604166666666666,1,0,3,3
2024-01-08 08:19:06,3.3107175925925927,11,191,88,279
2024-01-05 15:46:55,1.2293402777777778,3,27,11,38
2024-01-04 16:40:54,0.2727199074074074,4,71,30,101
2024-01-10 07:33:33,6.354456018518518,9,124,32,156
2024-01-10 08:57:31,6.541724537037037,1,60,3,63
2024-01-15 15:39:12,12.185497685185185,7,39,17,56
2024-01-03 18:26:07,0.20679398148148148,2,3,3,6
2024-01-26 11:05:01,23.126145833333332,14,26246,7458,33704
2024-01-04 17:36:16,1.9031944444444444,1,101,101,202
2024-02-16 11:38:59,44.65318287037037,14,49249,13363,62612
2024-01-03 08:12:54,0.6440856481481482,1,1,1,2
2024-02-01 17:15:55,31.065925925925924,12,72186,23192,95378
2024-01-08 14:33:28,6.996956018518518,1,1,1,2
2024-01-29 17:10:15,28.460034722222222,6,38,17,55
2024-03-13 07:43:00,72.17950231481481,11,81700,18461,100161
2024-01-02 16:22:29,2.8288194444444446,8,28,26,54
2024-02-16 00:53:09,48.62821759259259,1,11,2,13
2024-01-04 08:53:25,5.9753125,2,4,4,8
2024-01-03 17:20:35,6.777256944444445,1,0,8,8
2024-01-30 00:43:41,33.13033564814815,5,46,7,53
2024-01-11 10:42:14,14.829699074074075,6,57,52,109
2024-01-03 22:35:58,13.907592592592593,15,2260,755,3015
2024-01-11 15:16:13,20.319444444444443,3,9,13,22
2024-01-02 14:19:43,7.331979166666667,1,1,1,2
2024-01-09 14:58:22,14.950208333333334,6,134,42,176
2024-01-03 22:35:03,9.324826388888889,3,4550,74,4624
2024-02-12 09:21:15,48.800891203703706,7,37133,12073,49206
2024-01-12 13:29:36,18.07673611111111,9,10950,932,11882
2024-01-12 05:55:54,17.79508101851852,3,10204,521,10725
2023-12-26 20:52:11,2.68537037037037,1,1,1,2
2024-01-02 11:48:17,9.792708333333334,1,2,14,16
2024-01-08 11:33:58,15.916666666666666,1,1,37,38
2024-01-02 12:58:29,10.22162037037037,2,4,2,6
2024-02-05 14:50:08,44.7284375,25,565,231,796
2024-01-23 11:01:50,31.61144675925926,10,456,131,587
2024-01-02 18:32:24,10.931203703703703,1,41,8,49
2024-01-07 07:19:14,15.554780092592592,2,101,34,135
2024-01-09 07:51:38,17.648078703703703,4,27,23,50
2024-02-12 14:04:53,51.921018518518515,5,39295,12774,52069
2024-01-11 15:18:28,19.97539351851852,2,44,199,243
2023-12-26 03:06:41,3.6386226851851853,1,15,15,30
2023-12-22 11:56:11,0.09475694444444445,3,105,66,171
2024-01-10 10:46:49,19.07375,1,17,0,17
2023-12-22 09:40:22,0.020763888888888887,1,2,0,2
2023-12-22 12:19:04,0.16547453703703704,1,3,0,3
2024-01-31 01:19:18,7.770798611111111,2,39,0,39
2023-12-21 18:17:07,0.024618055555555556,1,11,11,22
2023-12-21 18:16:51,0.04097222222222222,1,5,5,10
2023-12-22 09:18:33,0.8262847222222223,3,5,4,9
2023-12-22 15:05:10,1.0819328703703703,2,1118,316,1434
2023-12-22 11:41:35,1.6320023148148148,3,8,5,13
2023-12-21 07:39:44,0.5141550925925926,1,6,0,6
2023-12-21 11:01:55,0.6705787037037036,1,221,185,406
2023-12-20 18:55:35,0.20675925925925925,7,114,96,210
2024-01-18 13:37:34,29.825833333333332,77,22534,8116,30650
2024-01-11 14:58:02,22.67111111111111,15,13008,1839,14847
2023-12-20 16:52:17,2.0146990740740742,2,4,3,7
2023-12-20 04:51:36,0.3337615740740741,1,0,76,76
2023-12-21 15:14:47,1.957488425925926,11,47,40,87
2023-12-20 18:37:23,1.0039467592592592,3,299,348,647
2023-12-22 10:33:44,2.7124421296296295,5,105,81,186
2023-12-19 18:34:14,-0.09104166666666667,1,1,1,2
2023-12-20 08:55:07,0.6938657407407407,8,22,10,32
2024-01-05 16:52:32,17.915532407407408,3,3,3,6
2024-01-29 16:07:35,41.201643518518516,2,41,5,46
2023-12-19 13:55:09,0.11002314814814815,1,1,1,2
2023-12-21 11:38:22,2.1789467592592593,17,1360,869,2229
2023-12-19 17:07:58,0.6654050925925926,1,1,1,2
2023-12-20 09:05:32,1.9738425925925926,2,7,3,10
2023-12-18 23:06:55,-0.13184027777777776,1,1,1,2
2023-12-20 13:20:02,1.7250925925925926,6,119,14,133
2023-12-18 18:44:35,0.035925925925925924,1,6,6,12
2023-12-18 17:47:54,0.028668981481481483,1,1,2,3
2023-12-19 16:31:54,1.1940046296296296,16,40,42,82
2023-12-22 12:43:11,73.81914351851852,11,156054,17511,173565
2023-12-18 15:18:01,0.0889236111111111,1,3,9,12
2023-12-18 14:04:05,0.13452546296296297,1,1,1,2
2023-12-20 16:24:54,2.2647453703703704,6,42,42,84
2023-12-18 12:46:30,0.14532407407407408,1,16,0,16
2024-03-05 11:01:06,79.68737268518518,123,78805,23805,102610
2023-12-18 15:08:37,2.542025462962963,1,2,2,4
2024-01-10 11:03:13,25.621412037037036,1,84,17,101
2023-12-18 18:44:09,2.9463078703703705,4,34,44,78
2023-12-15 19:16:47,0.028333333333333332,2,11,8,19
2024-01-29 10:09:27,47.586840277777775,18,146,120,266
2023-12-18 15:26:04,2.942222222222222,3,7,6,13
2023-12-15 16:58:37,0.12267361111111111,3,47,30,77
2023-12-15 16:18:56,0.02834490740740741,2,4,2,6
2023-12-18 15:08:56,3.000347222222222,6,458,460,918
2023-12-15 13:05:20,0.01898148148148148,2,1,1,2
2023-12-15 13:01:39,0.09017361111111111,1,1,1,2
2023-12-15 12:15:06,0.09988425925925926,1,0,15,15
2023-12-15 10:34:42,0.031203703703703702,1,7,7,14
2023-12-15 13:39:16,0.16552083333333334,2,6,4,10
2023-12-15 10:57:37,0.06084490740740741,1,6,0,6
2023-12-15 14:45:32,0.6319675925925926,2,2,2,4
2023-12-15 14:05:20,0.7753356481481481,1,2,0,2
2023-12-14 19:50:20,0.11153935185185185,1,11,19,30
2023-12-14 17:42:25,0.0715162037037037,1,10,10,20
2023-12-15 10:08:27,0.7978935185185185,12,11102,528,11630
2023-12-14 14:52:45,0.14418981481481483,8,32,14,46
2023-12-14 13:56:04,0.02048611111111111,2,6,2,8
2023-12-22 16:47:38,8.268715277777778,12,15030,2534,17564
2023-12-14 11:19:45,0.060520833333333336,1,35,35,70
2023-12-14 13:31:14,0.14976851851851852,1,67,71,138
2023-12-14 11:44:00,0.09613425925925925,1,2,2,4
2023-12-14 07:46:10,0.05893518518518519,1,6,4,10
2023-12-15 17:09:51,1.8102777777777779,2,6,6,12
2023-12-14 14:43:44,0.7405902777777778,3,49,19,68
2024-01-15 16:22:55,32.86375,3,13,14,27
2024-01-15 09:08:03,32.5403125,1,10,10,20
2023-12-15 21:17:30,2.063252314814815,3,11858,1145,13003
2023-12-14 14:52:03,0.8229976851851852,1,1,1,2
2023-12-15 10:57:19,1.7035532407407408,2,4,4,8
2023-12-14 05:51:04,0.49613425925925925,1,1,1,2
2024-02-20 11:50:32,68.78583333333333,40,69694,18701,88395
2023-12-13 17:17:30,0.04880787037037037,7,25,5,30
2024-01-16 16:10:44,34.051006944444445,2,5,4,9
2023-12-13 12:37:11,0.12239583333333333,3,4,4,8
2023-12-13 12:34:26,0.12842592592592592,2,31,30,61
2024-01-11 10:25:00,29.09744212962963,4,15794,2023,17817
2023-12-19 10:08:51,6.34037037037037,3,19,15,34
2024-01-05 14:20:21,31.582025462962964,35,54740,5890,60630
2023-12-15 20:06:55,2.8337731481481483,4,483,396,879
2023-12-12 21:29:59,0.022939814814814816,1,1,1,2
2023-12-12 20:32:42,0.025798611111111112,1,1,1,2
2023-12-19 13:58:30,6.920601851851852,8,223,151,374
2023-12-12 14:41:55,0.01940972222222222,4,13,6,19
2023-12-12 15:33:46,0.17958333333333334,4,49,11,60
2023-12-13 08:13:01,0.8740625,2,11,1,12
2023-12-12 13:07:15,0.11663194444444444,1,1,1,2
2023-12-13 17:22:00,1.840787037037037,18,747,306,1053
2023-12-13 19:13:44,1.9288194444444444,10,41,26,67
2023-12-11 18:03:19,0.02666666666666667,1,3,3,6
2023-12-11 15:22:11,0.033796296296296297,1,2,2,4
2023-12-25 10:06:57,13.827847222222223,11,18794,3173,21967
2023-12-11 15:12:40,0.05298611111111111,1,2,2,4
2023-12-12 11:20:29,0.8939930555555555,2,3,2,5
2023-12-11 14:57:41,0.05137731481481481,2,3,3,6
2023-12-11 14:58:06,0.06456018518518518,2,9,5,14
2023-12-11 14:58:49,0.09046296296296297,1,3,3,6
2023-12-11 18:03:42,0.31199074074074074,1,16,16,32
2023-12-11 11:56:57,0.08782407407407407,2,357,365,722
2023-12-11 11:50:28,3.0027777777777778,111,109300,7420,116720
2023-12-11 09:56:38,0.021458333333333333,1,10,8,18
2023-12-11 08:17:02,0.6309837962962963,1,1,1,2
2023-12-13 09:42:24,2.908703703703704,32,5632,975,6607
2024-02-08 10:50:34,60.045451388888885,121,61560,17068,78628
2023-12-11 23:44:23,2.757766203703704,2,4,4,8
2023-12-09 10:59:24,0.36780092592592595,1,1,1,2
2023-12-22 10:47:31,13.81482638888889,13,21718,2685,24403
2023-12-11 08:17:38,2.7031365740740743,1,4,0,4
2023-12-11 08:18:42,2.719988425925926,1,3,2,5
2023-12-08 15:02:50,0.03577546296296296,1,2,1,3
2023-12-08 16:32:34,0.09510416666666667,6,57,13,70
2023-12-08 20:02:20,0.26241898148148146,9,232,150,382
2023-12-08 13:54:32,0.13043981481481481,1,10,1,11
2023-12-14 15:14:13,6.18693287037037,2,4,3,7
2023-12-08 13:55:02,0.22717592592592592,2,4,1,5
2023-12-08 18:32:48,0.5218981481481482,1,1,1,2
2023-12-11 16:19:16,3.651921296296296,1,3,0,3
2023-12-11 18:41:34,3.7580555555555555,1,61,90,151
2023-12-11 09:22:26,3.5500231481481483,3,45,56,101
2024-01-05 11:36:10,28.81597222222222,3,59,7,66
2023-12-16 14:11:43,9.046574074074075,4,23966,2511,26477
2023-12-08 18:32:18,1.7958217592592594,14,8142,749,8891
2023-12-08 13:55:29,1.0831597222222222,5,21,12,33
2023-12-07 12:34:44,0.0330787037037037,1,3,3,6
2023-12-13 18:02:30,6.283518518518519,12,4981,521,5502
2023-12-07 14:09:31,0.17287037037037037,5,131,34,165
2023-12-11 16:20:31,4.753796296296296,1,1,1,2
2024-01-22 14:22:18,46.85729166666667,2,18,18,36
2024-01-29 09:41:20,53.64025462962963,3,101,50,151
2023-12-08 09:44:47,1.7108217592592592,5,76,8,84
2023-12-06 16:19:44,0.2927199074074074,4,35,30,65
2023-12-11 19:30:11,5.485555555555556,2,5,2,7
2023-12-08 13:06:11,2.4928587962962965,1,12,6,18
2023-12-07 18:47:36,1.8511689814814816,3,57,4,61
2023-12-05 20:33:59,0.19310185185185186,1,1,1,2
2023-12-05 21:15:22,0.31168981481481484,8,367,367,734
2023-12-06 09:30:57,0.8235532407407408,1,0,26,26
2023-12-05 13:04:20,0.015104166666666667,1,1,0,1
2023-12-05 11:27:00,0.027766203703703703,1,1,1,2
2023-12-05 09:17:24,0.023310185185185184,1,2,2,4
2023-12-07 12:25:10,2.2502546296296297,1,1,1,2
2023-12-07 06:43:05,2.007650462962963,3,5637,345,5982
2023-12-20 09:55:56,15.312233796296296,8,35670,3665,39335
2023-12-11 06:57:30,6.274490740740741,8,28585,1803,30388
2023-12-22 13:24:41,17.661863425925926,10,261312,29533,290845
2024-01-30 01:15:58,77.121875,1,1,0,1
2024-05-22 16:25:47,169.94047453703703,1,40,0,40
2023-12-05 18:01:08,1.1145138888888888,2,11407,149,11556
2023-12-05 15:32:43,1.0452893518518518,1,1,1,2
2023-12-05 15:33:28,1.0691203703703704,1,1,0,1
2023-12-04 16:34:14,0.2019675925925926,1,18,0,18
2023-12-04 11:47:54,0.07387731481481481,1,1,0,1
2023-12-18 14:27:05,1.7156828703703704,1,18,9,27
2023-12-04 07:33:15,0.013414351851851853,2,2,1,3
2023-12-08 13:08:54,4.6028009259259255,1,32,6,38
2023-12-07 05:34:18,3.584050925925926,2,24,16,40
2023-12-08 13:10:14,4.937627314814815,3,76,52,128
2023-12-08 13:14:16,5.371782407407407,6,42,45,87
2023-12-05 18:53:55,2.9441319444444445,16,17634,561,18195
2023-12-17 10:13:42,14.832662037037037,1,6,2,8
2023-12-04 13:56:01,2.5970601851851853,2,8,6,14
2023-12-08 10:25:49,6.553668981481482,2,17,3,20
2023-12-07 15:11:35,5.852384259259259,6,446,122,568
2023-12-04 11:48:22,2.747013888888889,1,1,1,2
2023-12-14 15:17:30,12.937291666666667,83,146226,135604,281830
2023-12-04 08:45:22,2.6626967592592594,2,7,5,12
2023-12-04 08:40:43,2.6735069444444446,3,9,7,16
2023-12-09 09:39:39,7.78556712962963,3,23166,821,23987
2023-12-04 06:41:50,2.8192476851851853,1,5,5,10
2023-12-01 09:39:33,0.17649305555555556,1,1,1,2
2023-12-07 18:50:46,15.838333333333333,10,39202,4124,43326
2023-11-30 19:24:44,16.82027777777778,45,8862,1853,10715
2023-12-01 13:57:50,1.740011574074074,2,8,5,13
2023-12-04 15:48:38,4.046342592592593,5,54,77,131
2024-01-13 17:15:58,45.9496875,17,658,497,1155
2023-12-07 19:12:24,7.301087962962963,9,28164,815,28979
2023-11-30 09:17:25,0.02943287037037037,1,0,68,68
2023-12-01 16:59:14,1.8756018518518518,3,7,8,15
2023-11-30 13:52:03,0.8184953703703703,1,9,9,18
2023-12-15 17:03:42,16.005381944444444,1,1,1,2
2024-01-18 10:21:46,6.8419791666666665,4,488,27,515
2023-11-30 14:16:31,1.0230439814814816,1,46,0,46
2023-12-07 12:06:02,8.543530092592592,3,14,5,19
2023-12-12 09:25:58,13.62329861111111,6,423,222,645
2023-12-05 14:06:46,7.027337962962963,1,2,1,3
2023-11-28 16:03:07,0.1050925925925926,1,3,0,3
2023-12-04 14:32:05,6.922048611111111,4,74,37,111
2023-12-22 11:12:56,24.080439814814813,12,791,254,1045
2023-11-28 16:40:44,0.22961805555555556,1,15,15,30
2023-12-04 13:56:51,6.171030092592592,1,1,1,2
2024-02-26 18:17:19,91.12824074074074,122,139803,28544,168347
2023-11-28 08:30:21,0.6390162037037037,2,4,4,8
2023-12-04 06:38:23,6.6290625,4,32,26,58
2023-11-27 13:59:59,0.11613425925925926,1,2,1,3
2023-11-28 09:44:05,0.9831018518518518,2,7,1,8
2024-02-13 02:49:20,77.8156712962963,36,106419,19494,125913
2023-12-01 09:34:15,4.166030092592592,2,16689,3175,19864
2023-12-11 11:38:18,14.802719907407408,21,45757,3868,49625
2023-11-29 15:30:50,4.514884259259259,10,6076,1475,7551
2023-11-27 15:29:07,2.8199189814814813,2,56,20,76
2023-11-27 08:11:59,2.627835648148148,1,12,0,12
2023-11-24 18:47:51,0.11780092592592592,5,15,7,22
2023-11-28 16:21:21,4.079050925925926,11,143,21,164
2023-11-27 08:38:19,2.9172800925925926,1,24,22,46
2023-12-05 09:45:39,10.974143518518519,4,99,95,194
2023-11-27 08:14:40,2.9324652777777778,1,1,1,2
2023-11-24 08:43:20,0.025671296296296296,1,12,0,12
2023-11-27 14:48:17,3.868576388888889,2,1,612,613
2023-11-24 11:41:17,0.8812847222222222,1,1,1,2
2023-11-28 09:05:34,4.772615740740741,1,35,23,58
2023-12-06 18:38:22,13.272766203703704,16,36870,3988,40858
2023-11-23 17:02:17,0.1307638888888889,1,3,3,6
2023-12-07 06:59:27,13.959421296296297,1,1,1,2
2023-11-24 11:34:24,1.2697106481481482,2,15,5,20
2023-12-20 20:55:52,28.015925925925927,3,64,41,105
2023-12-07 08:30:47,14.794201388888888,166,59380,9595,68975
2023-12-07 06:57:49,14.503252314814814,6,349,14,363
2023-12-07 06:44:14,14.530729166666667,7,36448,4311,40759
2024-01-19 12:04:17,57.75555555555555,87,95143,15139,110282
2023-12-01 13:00:08,244.91039351851853,18,375004,128714,503718
2023-11-23 17:44:08,1.1694328703703705,3,36,9,45
2023-11-24 06:10:52,1.8246296296296296,13,3965,928,4893
2023-11-24 15:30:06,2.297627314814815,11,34,21,55
2023-11-22 10:49:40,0.3295486111111111,1,2,20,22
2023-11-28 16:41:47,6.826967592592593,3,491,529,1020
2023-12-04 18:04:28,14.255671296296295,3,810,36,846
2023-12-04 12:36:58,12.82917824074074,13,628,382,1010
2023-11-24 15:59:17,2.9653125,5,27,21,48
2023-11-21 16:53:10,0.017800925925925925,1,10,2,12
2023-11-27 18:40:10,6.102789351851852,4,9,6,15
2023-12-11 15:33:37,20.03931712962963,35,44104,6614,50718
2023-11-22 16:28:27,1.2023842592592593,1,2,2,4
2023-11-21 14:20:44,0.19131944444444443,6,97,79,176
2023-11-22 11:10:11,1.0757175925925926,3,15,13,28
2023-11-21 10:14:42,0.0899537037037037,2,10,12,22
2023-11-21 16:09:35,0.5449652777777778,2,1,58,59
2023-11-21 10:48:15,0.7180902777777778,3,59,17,76
2023-12-04 12:52:18,13.97179398148148,45,25876,4415,30291
2023-11-21 10:03:31,0.6982291666666667,4,25,4,29
2023-11-21 08:29:51,0.7003587962962963,2,13,4,17
2023-11-24 10:48:02,3.1030439814814814,7,10526,11542,22068
2023-12-20 18:33:17,30.17888888888889,10,320,229,549
2024-01-23 09:28:23,63.94153935185185,14,162,134,296
2023-11-28 07:33:45,8.281319444444444,2,29,1,30
2023-12-04 06:36:29,14.50417824074074,1,1,1,2
2023-11-20 07:08:40,0.7655902777777778,1,13,0,13
2023-11-20 06:56:18,0.7037731481481482,2,31,5,36
2023-11-27 20:36:37,10.140532407407408,6,4636,221,4857
2023-11-23 08:09:56,4.070601851851852,4,269,95,364
2023-11-29 12:36:39,57.7559375,250,146778,28518,175296
2023-11-18 17:22:53,0.23752314814814815,1,1,1,2
2023-11-19 15:42:01,1.724212962962963,1,1,0,1
2023-12-01 14:51:10,13.8159375,16,572,262,834
2023-11-20 22:22:52,3.1453587962962963,5,21,13,34
2023-11-17 21:44:10,0.1610300925925926,2,123,123,246
2023-12-08 16:51:02,20.949675925925927,7,60,13,73
2023-11-21 17:36:27,4.082847222222222,4,77,115,192
2023-11-21 14:28:38,4.060208333333334,3,35,3,38
2023-11-17 16:20:42,0.17775462962962962,1,5,5,10
2023-11-17 11:23:10,0.018449074074074073,1,3,2,5
2023-11-17 09:44:37,0.016215277777777776,1,11,7,18
2023-11-17 09:35:05,0.03966435185185185,2,15,0,15
2023-11-27 09:18:42,10.451585648148148,9,12778,2289,15067
2023-11-28 16:40:02,11.864340277777778,5,144,70,214
2023-11-17 10:15:01,0.7127893518518519,5,22,27,49
2023-11-16 16:00:46,0.04466435185185185,1,35,34,69
2023-11-16 18:54:20,0.18327546296296296,3,87,68,155
2023-12-17 10:08:04,7.097013888888889,14,224,64,288
2023-11-20 12:24:39,4.2623495370370375,1,2,2,4
2023-11-27 16:26:33,10.588576388888889,2,47,47,94
2023-11-16 20:07:16,1.0942013888888888,4,2163,355,2518
2023-11-24 16:55:08,8.649039351851853,5,8020,1833,9853
2023-11-16 13:50:40,0.5847106481481481,2,141,46,187
2023-12-11 18:01:27,25.903622685185184,2,6,3,9
2023-11-16 13:16:19,0.8203125,1,3,1,4
2023-11-15 18:18:54,0.16622685185185185,3,57,59,116
2023-11-16 00:59:04,1.4127546296296296,2,145,2,147
2023-11-15 14:24:05,0.017962962962962962,1,0,3,3
2023-11-15 09:43:17,0.017847222222222223,1,28,28,56
2023-11-15 09:17:52,1.005,9,1194,3158,4352
2023-11-16 10:13:07,1.1221412037037037,1,3,0,3
2023-11-15 07:39:29,0.9366782407407407,8,1193,3158,4351
2023-11-15 08:50:46,0.09596064814814814,1,1,1,2
2023-11-27 14:23:55,12.521284722222223,23,9922,2150,12072
2023-11-16 15:35:41,1.8038194444444444,1,6,1,7
2023-11-15 18:16:42,0.9375578703703704,1,8,3,11
2023-11-17 21:49:32,3.1916782407407407,4,7105,4704,11809
2023-11-15 09:46:02,0.7196064814814814,5,648,121,769
2023-11-22 12:27:35,7.914363425925926,39,8123,2436,10559
2023-12-07 14:28:53,23.035474537037036,21,145,156,301
2023-11-20 17:14:23,6.152511574074074,1,15,14,29
2023-11-14 18:40:57,0.22546296296296298,1,8,3,11
2023-11-14 12:24:01,0.021087962962962965,1,171,2974,3145
2023-11-14 18:21:50,0.27275462962962965,1,19,12,31
2024-02-05 08:17:24,82.87494212962963,6,89574,10751,100325
2023-11-16 14:29:53,2.167789351851852,9,1519,3240,4759
2023-11-14 09:34:03,0.016238425925925927,4,25,9,34
2023-11-14 20:05:54,1.032650462962963,1,2,2,4
2023-11-28 13:19:50,14.946678240740741,6,105,21,126
2023-11-13 15:32:04,0.07520833333333334,1,1,1,2
2023-11-13 15:31:44,7.281655092592593,2,3,3,6
2023-11-13 17:18:42,0.18815972222222221,1,1,2,3
2023-11-14 09:32:57,0.8702083333333334,3,65,5,70
2023-11-13 15:38:14,0.1303587962962963,1,3,0,3
2024-03-11 12:14:02,119.00231481481481,16,2024,199,2223
2024-01-08 16:40:36,56.23274305555555,13,92711,11551,104262
2023-11-13 11:37:47,0.03819444444444445,5,9,9,18
2023-11-13 11:43:02,0.03930555555555556,1,1,1,2
2023-11-13 14:17:02,0.15259259259259259,2,201,33,234
2023-11-13 11:35:52,0.057511574074074076,1,992,992,1984
2023-12-11 13:22:18,28.72099537037037,17,151,34,185
2023-11-13 17:50:40,1.3332291666666667,1,1,1,2
2023-11-14 10:41:13,2.1098958333333333,1,2,2,4
2023-11-16 09:56:34,4.778518518518519,1,14,14,28
2023-11-15 19:00:22,4.475231481481481,2,9,4,13
2023-11-14 18:26:13,4.029178240740741,7,207,101,308
2023-11-14 11:18:26,3.7316666666666665,1,1,1,2
2023-12-01 17:10:03,20.97971064814815,1,1,1,2
2023-11-15 13:10:40,4.867685185185185,11,12071,1724,13795
2023-11-10 19:05:05,0.13244212962962962,1,2,0,2
2023-11-10 15:19:06,0.03560185185185185,1,4,0,4
2023-11-14 17:57:17,4.487719907407407,4,13644,1472,15116
2023-12-11 11:59:29,31.04335648148148,2,10,10,20
2023-11-13 17:46:41,4.540254629629629,3,553,8,561
2023-11-09 18:35:42,0.03133101851851852,2,2,78,80
2023-11-09 21:01:07,0.135,2,2,2,4
2023-12-05 11:14:45,25.81678240740741,51,70693,10594,81287
2023-11-22 08:40:31,12.68650462962963,10,19876,4628,24504
2023-11-09 17:52:29,0.07878472222222223,10,12,8,20
2023-11-09 17:53:27,0.11630787037037037,2,49,46,95
2023-11-09 15:20:13,0.022511574074074073,2,2,2,4
2023-11-13 17:01:30,4.092708333333333,3,9,3,12
2023-11-09 20:39:03,0.24519675925925927,7,17,17,34
2023-11-15 18:13:52,6.147337962962963,7,1406,564,1970
2023-11-10 13:40:30,0.963761574074074,5,57,23,80
2023-11-09 14:47:46,0.06578703703703703,1,2,2,4
2023-11-14 09:52:11,4.870416666666666,1,23,0,23
2023-11-13 14:18:20,4.228761574074074,3,68,2,70
2023-11-09 11:03:37,0.030393518518518518,2,8,2,10
2023-11-09 12:32:54,0.056400462962962965,1,14,14,28
2023-11-23 20:00:39,0.23630787037037038,2,278,11,289
2023-11-09 09:44:36,0.44265046296296295,1,1,1,2
2023-11-16 13:47:44,7.852106481481481,2,10,10,20
2023-11-08 22:04:06,0.20226851851851851,3,1621,163,1784
2023-11-08 16:15:57,0.02079861111111111,1,2,2,4
2023-11-09 10:50:20,0.11256944444444444,1,3,6,9
2023-11-08 17:06:35,0.33998842592592593,12,501,168,669
2023-11-08 15:11:38,0.1426273148148148,1,3,1,4
2023-11-09 09:15:11,1.0650694444444444,4,11,9,20
2023-11-09 06:17:24,0.9841550925925926,5,8,10,18
2023-11-08 19:58:36,0.7558101851851852,2,2,3,5
2023-11-08 14:07:32,0.711099537037037,1,0,7,7
2023-11-08 12:45:22,0.6893287037037037,2,4,5,9
2023-11-09 12:19:32,2.832025462962963,3,139,25,164
2023-11-15 12:49:15,7.839085648148148,4,65,19,84
2023-11-07 17:43:26,0.039456018518518515,2,3,3,6
2023-11-07 17:24:43,0.0484375,1,0,15,15
2023-11-07 16:26:15,0.026238425925925925,1,1,2,3
2023-11-08 13:14:45,0.8922569444444445,3,5,3,8
2023-11-09 11:34:14,1.9661111111111111,1,14,13,27
2023-11-07 10:21:04,0.013101851851851852,2,2,2,4
2023-11-07 14:07:56,0.19152777777777777,25,394,190,584
2023-11-08 08:27:37,0.9761574074074074,1,0,0,0
2023-11-20 16:36:49,13.378344907407408,17,790,270,1060
2023-11-08 16:48:46,2.4877546296296296,4,200,8,208
2023-11-14 09:20:30,7.543993055555555,6,13164,1848,15012
2023-12-07 09:00:09,16.818472222222223,11,704,139,843
2023-11-06 19:45:03,0.06697916666666667,2,102,91,193
2024-02-19 19:07:41,105.06270833333333,2,19,7,26
2023-11-27 15:25:47,20.906712962962963,2,2,2,4
2023-11-06 18:05:51,0.03521990740740741,3,20,18,38
2023-11-07 10:04:24,0.734386574074074,2,55,1,56
2023-11-10 12:45:00,3.864259259259259,9,3361,477,3838
2023-11-13 17:01:59,7.091423611111111,5,23,22,45
2023-11-13 13:51:48,6.984571759259259,10,11981,1745,13726
2023-11-06 14:11:00,0.06091435185185185,1,4,0,4
2023-11-06 10:27:23,0.049699074074074076,1,2,2,4
2023-11-06 10:27:49,0.028356481481481483,1,1,1,2
2023-11-06 17:20:06,0.9105439814814815,3,7,6,13
2023-11-07 23:31:51,2.518136574074074,5,517,209,726
2023-11-07 15:57:48,8.59849537037037,4,40251,10086,50337
2023-11-07 23:34:33,4.3592361111111115,7,3185,1138,4323
2023-12-15 15:01:18,41.11068287037037,2,23,23,46
2023-11-06 14:21:49,2.3641550925925925,1,1,1,2
2023-11-06 13:44:22,3.2641087962962962,1,18,3,21
2023-11-14 19:09:22,10.936712962962963,2,1,1,2
2023-11-14 20:31:04,11.10375,6,38,9,47
2023-11-06 12:16:03,2.8475,1,0,1,1
2023-11-07 18:32:01,4.2487152777777775,3,95,27,122
2023-11-03 16:16:55,0.45600694444444445,2,157,6,163
2023-11-03 14:23:14,0.009699074074074074,1,3,2,5
2023-11-07 12:08:29,4.054004629629629,2,24,38,62
2023-11-27 21:19:04,29.565462962962965,19,63788,10785,74573
2023-11-03 11:47:08,0.29942129629629627,4,1003,999,2002
2023-11-03 11:23:02,0.23600694444444445,1,46,4,50
2024-01-23 09:09:32,81.24394675925926,1,2,18,20
2023-11-15 19:58:09,13.09962962962963,4,16965,2487,19452
2023-11-03 13:17:46,0.7927777777777778,3,11,11,22
2023-11-10 15:35:27,8.14925925925926,3,45,7,52
2023-11-03 07:45:06,0.6029513888888889,1,11,4,15
2023-11-03 17:19:42,1.498738425925926,4,2369,636,3005
2023-11-02 15:23:32,0.044675925925925924,1,1,0,1
2023-11-02 14:32:18,0.13800925925925925,5,65,39,104
2023-11-02 12:03:30,0.058472222222222224,1,7,0,7
2023-11-02 11:03:51,0.03189814814814815,3,36,3,39
2023-11-02 14:03:10,0.2379513888888889,11,105,32,137
2023-11-16 19:44:37,14.862673611111111,8,108,54,162
2023-11-06 09:26:18,4.4419560185185185,2,4,0,4
2023-11-03 14:00:33,1.6703587962962962,2,2,2,4
2023-11-02 16:01:41,0.8957060185185185,4,17,23,40
2023-11-02 17:42:29,1.514375,4,2979,114,3093
2023-11-03 12:03:14,1.830162037037037,1,16,0,16
2023-11-02 10:27:13,8.9584375,3,20,2,22
2023-11-01 15:31:14,0.08689814814814815,1,4,2,6
2023-11-01 18:25:23,0.24506944444444445,1,147,5,152
2023-11-01 20:03:01,0.4265277777777778,18,4085,516,4601
2023-11-01 12:26:15,0.7334837962962963,6,23,19,42
2023-11-01 15:01:54,0.7051504629629629,10,667,88,755
2023-11-01 12:42:23,0.7125115740740741,2,2130,1048,3178
2023-11-01 12:42:41,0.7775,1,15,15,30
2023-12-04 06:43:32,33.532789351851854,1,19,0,19
2023-10-31 18:12:14,0.08008101851851852,1,22,22,44
2023-10-31 15:44:58,0.026712962962962963,1,1,1,2
2023-11-01 16:28:35,3.3172569444444444,5,13605,1057,14662
2023-10-31 15:25:54,0.06255787037037037,1,2,3,5
2023-10-31 15:12:06,0.06189814814814815,2,21,9,30
2023-10-31 13:49:02,0.025486111111111112,1,4,0,4
2023-10-31 10:41:57,0.02574074074074074,1,6,6,12
2023-10-31 10:59:22,0.1296875,1,7,142,149
2023-10-31 13:09:56,0.5123148148148148,1,2,2,4
2023-10-31 10:17:54,0.4575810185185185,1,13,26,39
2023-11-02 20:08:03,2.908773148148148,3,7,6,13
2023-11-01 15:58:35,1.755451388888889,8,32,8,40
2023-10-30 20:42:20,0.035,1,8,4,12
2023-10-30 20:08:29,0.03490740740740741,2,6,9,15
2023-10-30 19:12:10,0.025613425925925925,1,2,2,4
2023-12-08 13:48:29,38.81646990740741,2,35,25,60
2023-10-30 15:07:27,0.03309027777777778,4,2,10,12
2023-10-30 14:27:15,0.1674074074074074,4,17,17,34
2023-10-31 17:12:14,1.2070486111111112,5,456,241,697
2023-10-30 14:43:08,0.17355324074074074,2,29,19,48
2023-11-16 16:43:20,17.250520833333333,54,43806,10135,53941
2023-10-31 15:04:00,1.237962962962963,11,4913,134,5047
2023-11-02 18:13:57,3.6930439814814813,2,4,17,21
2023-10-31 19:50:48,2.002384259259259,4,13759,1210,14969
2023-10-30 18:16:40,1.4279050925925927,1,87,46,133
2023-10-29 18:22:27,0.3980092592592593,1,1,1,2
2023-10-31 14:46:31,3.0339467592592593,2,86,80,166
2023-10-31 10:20:15,2.3310416666666667,7,11633,216,11849
2023-10-30 10:04:50,1.6401967592592592,1,1,0,1
2023-10-30 18:53:46,2.0153125,13,6094,245,6339
2023-10-31 15:57:38,2.957824074074074,4,424,15,439
2023-11-01 06:17:07,5.61550925925926,3,13872,4500,18372
2023-11-01 14:16:58,4.582708333333334,14,235,116,351
2023-10-30 10:52:25,2.4234027777777776,1,5,6,11
2023-11-10 14:22:44,13.919988425925926,8,33510,4968,38478
2023-11-01 17:09:21,35.24188657407407,38,74347,11416,85763
2023-10-27 12:32:54,0.12467592592592593,1,298,127,425
2023-10-27 19:50:10,0.594375,1,2,2,4
2023-10-27 09:23:06,0.020972222222222222,1,5,93,98
2023-12-13 08:11:35,47.024907407407404,8,93413,14737,108150
2023-12-04 22:10:55,45.69965277777778,56,116208,21155,137363
2023-11-08 13:35:20,12.807916666666667,7,749,252,1001
2023-10-26 21:10:16,0.056574074074074075,1,1,1,2
2023-10-27 13:49:20,0.7908912037037037,5,25,24,49
2023-10-27 14:28:12,0.8350231481481482,2,4,0,4
2023-10-27 14:42:01,0.9753125,39,6526,8759,15285
2023-10-27 06:18:24,23.68777777777778,11,49251,6307,55558
2023-11-08 13:26:02,12.97,6,261,45,306
2023-10-30 14:56:41,4.468206018518519,1,32,33,65
2023-10-26 09:55:31,0.011875,1,0,4,4
2023-10-26 09:21:05,0.025034722222222222,2,5,5,10
2023-10-27 18:40:11,14.396585648148148,44,26737,3545,30282
2023-10-30 15:50:30,4.4682407407407405,2,191,8,199
2023-10-26 11:06:21,0.5619791666666667,12,101,69,170
2023-10-27 14:15:23,1.8497337962962963,12,268,1171,1439
2023-10-26 06:56:28,0.5235416666666667,1,1,1,2
2023-10-25 16:09:05,0.04203703703703704,1,3,3,6
2023-10-26 06:41:07,0.6944791666666666,1,3,3,6
2023-10-30 11:41:48,4.916712962962963,6,3110,4289,7399
2023-10-25 18:20:32,0.2883912037037037,2,308,1,309
2023-10-31 18:16:49,6.349004629629629,18,569,273,842
2023-10-25 17:31:36,0.32003472222222223,7,1292,2303,3595
2023-10-25 08:47:33,0.013414351851851853,3,5,1,6
2023-11-13 13:20:54,19.21383101851852,4,36170,10784,46954
2023-11-24 11:24:05,30.330810185185186,3,4,4,8
2024-01-08 12:32:37,75.60035879629629,6,124605,19042,143647
2023-10-25 17:21:13,0.9071990740740741,1,10,10,20
2023-10-26 15:46:17,0.5779050925925926,3,6,6,12
2023-10-27 19:45:44,3.1360763888888887,2,301,14,315
2023-11-01 08:06:32,7.808622685185185,72,17855,7583,25438
2023-10-24 17:05:38,0.061342592592592594,4,8,5,13
2023-10-30 09:48:24,5.778402777777778,3,61,40,101
2023-11-26 15:28:37,33.05863425925926,2,3,3,6
2023-11-23 15:58:21,30.088159722222223,18,48656,11682,60338
2023-10-24 12:40:17,0.05337962962962963,1,40,0,40
2023-11-01 14:37:19,8.303796296296296,5,8,4,12
2024-01-10 17:20:39,78.8883912037037,3,15,18,33
2023-10-23 22:36:43,0.15626157407407407,1,1,1,2
2023-10-23 22:44:42,0.19703703703703704,1,391,0,391
2023-11-14 19:54:45,22.18435185185185,9,93,30,123
2023-10-24 12:56:01,0.9237037037037037,4,9,3,12
2023-10-26 16:13:19,3.152997685185185,6,50,12,62
2023-10-25 10:16:15,1.8810300925925927,16,14081,3135,17216
2023-10-23 13:25:06,0.012314814814814815,1,1,1,2
2023-10-23 10:52:06,0.017002314814814814,3,12,1,13
2023-10-23 12:54:23,0.10753472222222223,2,22,5,27
2023-10-23 10:34:21,0.021643518518518517,1,3,0,3
2023-11-02 11:25:41,14.478020833333334,11,77705,49660,127365
2023-11-15 08:33:05,24.81921296296296,15,239,173,412
2023-10-23 12:19:59,0.6552662037037037,1,3,3,6
2023-10-23 10:51:35,0.9739699074074074,1,1,1,2
2023-10-23 14:08:40,1.840335648148148,1,2,2,4
2023-10-24 09:08:17,3.6992708333333333,5,91,37,128
2023-10-23 15:18:03,3.076388888888889,1,10,0,10
2023-10-31 14:20:04,11.067835648148149,11,51,55,106
2023-10-23 17:36:24,3.425798611111111,5,32947,1054,34001
2023-10-23 15:58:00,5.007858796296296,5,7232,1133,8365
2023-10-24 13:10:24,4.604907407407407,4,40,15,55
2024-01-31 13:19:02,106.1572337962963,98,189155,43000,232155
2023-10-23 12:25:49,3.8269907407407406,5,954,60,1014
2023-12-11 15:51:52,53.009351851851854,16,353,265,618
2023-11-21 13:55:13,32.92347222222222,24,611,118,729
2023-10-19 15:53:28,0.05616898148148148,1,67,20,87
2023-10-23 10:33:06,3.8409722222222222,3,9,6,15
2023-10-23 17:35:18,4.133414351851852,2,11812,355,12167
2023-11-03 11:05:56,14.930763888888889,7,35418,8161,43579
2023-10-19 13:36:41,0.04864583333333333,1,2,2,4
2023-10-24 17:37:09,5.2598263888888885,5,28,26,54
2023-11-15 08:35:54,26.889282407407407,3,439,3,442
2023-10-19 11:01:47,0.01615740740740741,1,5,0,5
2023-11-20 14:45:43,32.221180555555556,3,13,9,22
2023-10-20 11:46:06,1.492199074074074,3,68,40,108
2023-10-18 22:36:25,0.013055555555555556,1,12,3,15
2023-11-20 15:45:56,32.75868055555556,3,60686,10979,71665
2023-10-19 16:30:27,0.8249537037037037,1,4,4,8
2023-10-19 13:48:49,0.7398842592592593,1,1,0,1
2023-10-18 22:24:11,5.439131944444444,121,33908,8784,42692
2023-10-18 17:45:41,0.052222222222222225,1,72,1,73
2023-11-20 16:00:30,33.05053240740741,5,75,70,145
2023-10-19 11:04:25,0.8396759259259259,2,11,8,19
2023-10-18 14:33:43,0.009479166666666667,1,1,0,1
2023-10-19 13:39:32,1.0069212962962963,4,6,2,8
2023-10-18 17:35:59,0.23685185185185184,1,18,18,36
2023-10-30 16:39:15,13.237546296296296,30,41817,7037,48854
2023-11-10 11:05:15,23.19724537037037,14,47182,11154,58336
2023-10-18 11:30:50,0.42591435185185184,1,1,1,2
2023-10-18 11:31:06,0.4263194444444444,1,1,1,2
2023-10-26 07:10:29,0.008611111111111111,1,1,1,2
2023-10-20 07:49:55,2.4362962962962964,6,62,51,113
2023-10-31 16:44:52,13.856851851851852,9,39537,7068,46605
2023-10-19 08:52:14,1.565150462962963,3,18,12,30
2023-10-17 21:06:37,0.08979166666666667,1,1,1,2
2023-11-03 14:57:04,16.86835648148148,8,18470,1898,20368
2023-10-20 21:23:41,3.288854166666667,2,18,16,34
2024-05-13 14:59:47,209.07211805555556,119,7471,4128,11599
2023-11-21 17:51:48,35.29708333333333,1,4,0,4
2023-10-18 08:55:01,0.9510879629629629,2,75,39,114
2023-10-17 17:30:46,0.5771875,2,12,7,19
2023-10-20 09:16:37,3.265648148148148,3,3,4,7
2023-10-17 13:38:03,0.6787615740740741,1,5,1,6
2023-10-26 09:20:12,9.589247685185185,6,24,14,38
2023-10-23 18:34:27,6.969780092592592,8,227,213,440
2023-10-16 20:47:20,0.015381944444444445,1,3,2,5
2023-10-18 17:48:56,1.9607175925925926,6,1778,334,2112
2023-10-17 09:32:50,0.6669907407407407,4,28,17,45
2023-10-17 22:15:50,67.37378472222223,1,1,0,1
2023-10-18 12:28:16,1.8295949074074074,1,3,1,4
2023-11-21 12:26:02,35.96392361111111,26,1411617,1394072,2805689
2023-10-25 18:21:49,10.066087962962962,6,20517,3433,23950
2023-10-24 07:55:14,7.827349537037037,3,23,18,41
2023-11-07 12:39:42,22.058587962962964,14,45438,10230,55668
2023-10-17 05:10:08,0.7583680555555555,2,11,11,22
2024-02-05 02:33:55,111.68768518518519,1,9,7,16
2023-10-20 22:27:55,7.554733796296296,25,11544,533,12077
2023-10-16 13:47:45,0.8629513888888889,1,20,2,22
2023-10-19 12:21:40,3.9044444444444446,7,46,38,84
2023-10-16 16:26:56,1.4100925925925927,4,21226,610,21836
2024-03-13 19:05:20,151.3982986111111,250,245579,51792,297371
2023-10-16 07:52:30,1.5524537037037036,1,1,4,5
2023-10-17 07:26:03,3.3824074074074075,1,6,1,7
2023-10-16 08:10:24,2.4552430555555556,1,1,1,2
2023-11-01 18:42:38,18.90732638888889,7,37,19,56
2023-10-16 16:27:45,3.0327199074074076,7,36,19,55
2023-10-23 16:54:00,10.14642361111111,28,12044,1433,13477
2023-10-24 17:10:07,19.978101851851854,9,444,362,806
2023-10-13 16:38:37,0.26266203703703705,3,15,4,19
2023-10-16 14:16:04,3.203078703703704,4,20,4,24
2023-10-13 10:56:50,0.07939814814814815,2,19,17,36
2023-10-17 08:13:37,3.9894097222222222,2,21,9,30
2023-10-13 08:20:31,0.06578703703703703,2,2,3,5
2023-10-13 07:52:11,0.17782407407407408,1,2,3,5
2023-10-31 09:15:40,18.315509259259258,3,21,17,38
2023-10-16 08:08:44,3.469375,3,9,4,13
2023-10-13 14:10:27,0.7841435185185185,1,0,2,2
2023-10-13 18:13:48,0.9902430555555556,8,588,12,600
2023-10-13 13:48:38,0.8888657407407408,2,5,5,10
2023-10-12 16:22:09,0.0309375,2,9,1,10
2023-10-16 17:56:53,4.167997685185185,8,86,21,107
2023-10-12 15:43:06,0.09936342592592592,1,1,1,2
2023-10-12 16:00:27,0.24219907407407407,1,8,8,16
2023-10-12 10:31:12,0.04241898148148148,3,14,7,21
2023-10-24 17:26:16,12.382280092592593,4,67,15,82
2023-10-12 08:28:41,0.024131944444444445,1,331,331,662
2023-10-12 09:24:18,0.06319444444444444,7,26,13,39
2023-10-17 22:01:21,5.632777777777778,8,3018,951,3969
2023-10-12 11:19:24,0.7200462962962964,2,14,2,16
2023-10-16 13:29:47,4.891956018518519,3,21031,541,21572
2023-10-12 08:01:08,0.6676041666666667,9,20,52,72
2023-10-11 14:23:36,0.04605324074074074,1,4,3,7
2023-10-11 14:46:42,0.07650462962962963,4,41,5,46
2023-10-11 14:16:27,0.08179398148148148,1,12,12,24
2023-10-11 13:58:23,0.13282407407407407,1,3,3,6
2023-10-31 13:45:24,21.068391203703705,4,5,4,9
2023-10-11 12:12:09,1.157037037037037,13,154,72,226
2023-10-11 14:08:55,1.2283449074074073,1,17,10,27
2023-10-11 16:01:23,1.3816203703703704,2,16,9,25
2023-10-10 09:50:10,0.3903009259259259,1,1,0,1
2023-10-26 10:37:09,22.733715277777776,9,47186,6085,53271
2023-10-10 19:35:17,0.9963773148148148,1,28,28,56
2023-10-11 13:52:21,1.8334953703703705,13,8740,2526,11266
2023-10-09 14:39:58,0.05877314814814815,2,25,24,49
2023-10-09 15:39:06,0.10358796296296297,1,20,13,33
2023-10-10 15:05:49,1.2562847222222222,11,219,147,366
2023-10-13 15:20:27,4.298981481481482,3,7,7,14
2023-12-08 08:00:18,60.03523148148148,35,1438,671,2109
2023-10-11 13:53:32,2.465358796296296,5,12,7,19
2024-01-18 11:31:54,106.77173611111111,62,183565,28675,212240
2023-10-09 10:34:02,0.6263888888888889,2,24,11,35
2023-10-09 12:22:44,0.7263888888888889,2,89,31,120
2023-10-27 10:07:33,18.65050925925926,29,236,123,359
2023-10-13 10:13:43,4.740324074074074,3,4,3,7
2023-10-11 15:03:32,3.297638888888889,3,370,129,499
2023-10-13 14:41:24,5.9564004629629625,32,5534,901,6435
2023-10-16 08:11:46,8.151921296296296,5,21992,946,22938
2023-10-12 14:51:35,4.776886574074074,11,68,41,109
2023-10-10 18:36:33,3.0524537037037036,2,2,2,4
2023-10-12 15:01:14,5.848738425925926,2,7,4,11
2023-10-09 09:04:57,1.7347916666666667,1,1,1,2
2023-10-10 18:49:10,3.3967824074074073,1,1,1,2
2023-10-30 11:55:03,23.151493055555555,2,2,11,13
2023-10-09 10:18:03,2.1607291666666666,2,3,3,6
2023-10-12 15:01:00,5.733020833333334,4,38,36,74
2023-10-09 14:32:13,2.738888888888889,5,95,38,133
2023-10-09 09:34:44,2.7263657407407407,2,3,3,6
2023-10-09 09:42:09,2.7361805555555554,1,2,1,3
2023-10-18 16:38:52,12.05542824074074,6,194,90,284
2023-10-06 15:36:22,0.01835648148148148,1,6,1,7
2023-10-16 14:24:31,13.201469907407407,5,69,29,98
2023-10-16 13:29:01,10.165868055555556,1,1,0,1
2023-10-06 16:24:29,0.48935185185185187,1,142,143,285
2023-10-06 11:04:40,0.738275462962963,1,66,5,71
2023-10-05 14:57:51,0.03211805555555555,1,0,1,1
2023-10-24 09:02:40,18.849398148148147,3,31,14,45
2023-10-05 13:33:35,0.1177662037037037,1,3,2,5
2023-10-05 13:33:05,1.0484837962962963,1,3,1,4
2024-01-30 01:48:25,37.3309375,83,37909,12514,50423
2023-10-05 07:38:09,0.009097222222222222,1,1,1,2
2023-10-05 08:27:05,0.014456018518518519,3,10,0,10
2023-10-06 14:40:55,1.31625,6,663,735,1398
2023-10-06 11:04:54,1.4904282407407408,1,3,3,6
2023-10-04 15:28:54,0.017905092592592594,1,1,1,2
2023-10-16 13:12:04,11.928680555555555,12,148,14,162
2023-10-04 15:47:55,0.03875,2,2709,602,3311
2023-10-04 15:02:35,0.019814814814814816,4,16,11,27
2023-10-04 15:48:12,0.11197916666666667,1,2,2,4
2023-10-05 12:44:31,0.9965972222222222,6,2339,598,2937
2023-10-04 15:34:33,0.19436342592592593,1,1,1,2
2023-10-06 13:53:59,2.1828125,4,20,16,36
2023-10-04 15:09:48,0.5828125,1,8,0,8
2023-10-04 09:52:46,0.3742013888888889,1,1,1,2
2023-10-25 10:36:43,21.433356481481482,3,4,4,8
2023-10-06 08:49:03,2.584189814814815,3,13,1,14
2023-10-03 17:43:42,0.010844907407407407,3,20,3,23
2023-10-04 14:15:30,0.8731712962962963,6,73,9,82
2023-12-08 20:38:14,66.27384259259259,114,148118,24214,172332
2023-10-18 14:30:54,14.896041666666667,114,30227,4182,34409
2023-10-05 13:20:39,1.8792939814814815,11,61,51,112
2023-10-03 14:32:13,0.007835648148148149,2,6,10,16
2023-10-06 08:40:47,2.858113425925926,1,31,23,54
2023-10-03 12:53:09,0.08503472222222222,6,58,20,78
2023-10-03 06:55:12,0.03971064814814815,1,1,1,2
2023-10-03 06:55:01,0.09011574074074075,1,1,1,2
2023-10-03 06:54:50,0.09371527777777777,1,1,1,2
2023-10-05 14:20:42,2.883321759259259,4,303,488,791
2023-10-03 06:55:39,0.6017476851851852,1,1,1,2
2023-10-03 10:23:47,5.0110879629629625,16,1296,463,1759
2023-10-02 12:59:25,0.03505787037037037,1,1,1,2
2023-10-13 18:13:00,11.346087962962963,8,28214,2784,30998
2023-10-02 15:19:13,0.2999189814814815,7,205,206,411
2023-10-12 08:48:38,10.07420138888889,2,43,0,43
2024-01-08 17:17:16,100.86994212962964,99,61526,6042,67568
2023-10-03 09:21:25,1.724548611111111,7,979,980,1959
2023-10-02 08:52:51,0.8120717592592592,1,1,1,2
2023-10-03 17:25:50,3.3483912037037036,6,691,100,791
2023-10-03 18:20:22,3.2805092592592593,1,1,0,1
2023-12-09 10:04:14,70.59254629629629,14,153437,21395,174832
2023-10-03 08:52:34,3.695474537037037,1,7,0,7
2023-10-05 09:08:44,5.768935185185185,2,8,1,9
2023-10-02 08:10:19,2.84587962962963,2,18,10,28
2023-11-03 16:07:54,35.17916666666667,7,70694,10534,81228
2023-10-02 09:23:03,3.017372685185185,3,9,5,14
2023-10-02 09:19:12,3.020347222222222,1,1,1,2
2023-11-07 13:54:02,39.21189814814815,9,74293,13034,87327
2023-09-29 08:52:18,0.015810185185185184,1,3,2,5
2023-10-02 14:52:01,4.197361111111111,5,1219,386,1605
2023-10-02 16:56:40,3.8806712962962964,5,1824,328,2152
2023-11-07 21:40:00,39.808622685185185,4,35,12,47
2023-10-31 11:21:02,32.6156712962963,14,51897,9294,61191
2023-09-29 07:42:21,0.6209143518518518,1,10,10,20
2023-09-29 07:43:39,0.6485763888888889,2,18,12,30
2023-09-29 17:32:38,1.0715277777777779,5,73,45,118
2023-11-02 17:06:57,35.070092592592594,12,70627,10704,81331
2023-10-02 07:13:20,25.82800925925926,2,8,232,240
2023-09-29 09:06:06,0.8373611111111111,1,2,1,3
2023-10-04 12:57:41,6.070717592592593,1,1,0,1
2023-10-03 11:44:46,5.034293981481482,28,551,106,657
2023-12-06 16:22:33,69.25443287037037,14,138512,20956,159468
2023-09-28 17:49:40,0.9428819444444444,2,5,5,10
2023-09-27 16:47:27,0.009293981481481481,2,2,0,2
2023-09-28 08:00:16,0.7477314814814815,3,12,7,19
2023-09-27 16:30:46,0.09844907407407408,7,1986,14,2000
2023-10-26 14:15:05,29.120868055555555,13,53277,3866,57143
2023-09-27 17:25:53,0.2993287037037037,2,26,26,52
2023-10-02 09:35:07,5.043460648148148,6,9,7,16
2023-09-26 17:27:11,0.024259259259259258,1,3,0,3
2023-09-28 13:08:36,1.9322685185185184,2,44,2,46
2023-09-27 09:51:44,0.8245023148148148,1,1,1,2
2023-10-17 13:59:35,21.08789351851852,4,19202,2712,21914
2023-09-27 10:21:54,0.9578356481481481,2,30,1,31
2023-11-23 10:16:51,57.985289351851854,16,100685,15201,115886
2023-09-27 14:45:31,1.2809722222222222,12,268,116,384
2023-09-28 08:15:48,2.0130439814814816,2,8,8,16
2023-09-27 08:56:07,1.504513888888889,4,39,19,58
2023-09-26 08:11:28,0.5193518518518518,1,0,2,2
2023-09-26 08:19:00,0.6329050925925926,1,1,1,2
2023-09-26 08:15:53,0.7563310185185185,1,27,6,33
2023-10-13 09:03:14,17.810497685185187,7,53,19,72
2023-10-10 04:45:24,15.079201388888889,4,59,38,97
2023-09-25 11:08:26,0.8745486111111112,3,8,10,18
2023-09-25 10:58:12,1.109050925925926,1,20,20,40
2023-10-04 16:12:10,12.045555555555556,6,2635,499,3134
2023-09-22 15:55:55,0.03746527777777778,3,8,8,16
2023-09-25 13:41:59,2.944375,1,5,2,7
2023-10-03 09:13:46,10.760798611111111,21,150,143,293
2023-09-22 14:29:27,0.045509259259259256,1,2,2,4
2023-11-08 07:39:38,46.86990740740741,14,86104,13806,99910
2023-10-05 08:18:27,13.555474537037037,4,17055,1271,18326
2023-09-22 17:22:47,0.9719097222222223,4,25,1,26
2023-09-22 06:58:31,0.6424074074074074,1,3,2,5
2023-10-02 11:55:47,12.146030092592593,32,11950,634,12584
2023-09-26 05:06:39,4.81792824074074,1,14,3,17
2023-09-27 18:33:05,6.4449652777777775,13,2993,357,3350
2024-01-19 11:36:55,27.833645833333332,18,10465,603,11068
2023-09-26 15:52:20,6.049398148148148,3,5005,190,5195
2023-09-21 12:57:36,0.8706134259259259,1,2,2,4
2023-10-02 16:29:28,12.040729166666667,4,26,8,34
2023-09-28 18:02:27,8.10894675925926,1,30,34,64
2023-10-02 16:30:45,12.055787037037037,3,15,2,17
2023-09-21 16:36:05,1.0622453703703705,4,10,11,21
2023-09-20 14:48:36,0.02141203703703704,1,8,7,15
2023-09-22 01:33:30,1.4777546296296296,5,123,58,181
2023-09-21 12:46:06,0.9439120370370371,1,21,2,23
2023-09-20 14:18:49,0.0171875,1,7,6,13
2023-10-02 09:06:41,11.9021875,9,12315,426,12741
2023-09-25 16:08:13,5.280914351851852,13,200,56,256
2023-09-20 06:02:56,0.0271875,2,2,1,3
2023-09-20 08:22:07,0.8866666666666667,3,1624,94,1718
2023-10-12 12:48:02,22.699363425925927,18,36054,3515,39569
2023-09-28 09:13:04,8.641076388888889,16,11581,456,12037
2023-09-20 15:19:31,1.1568287037037037,2,14,0,14
2023-09-19 19:04:56,0.3975578703703704,2,55,62,117
2023-09-19 11:25:12,0.024131944444444445,2,4,4,8
2023-09-20 14:40:15,1.1997916666666666,1,11,1,12
2023-12-04 09:29:13,76.05548611111111,12,55,40,95
2023-09-20 15:39:00,1.3438541666666666,3,18,14,32
2023-12-05 14:31:35,95.99658564814816,229,196742,56375,253117
2023-09-27 20:47:44,72.08295138888889,3,397,91,488
2023-10-12 22:00:13,94.87328703703703,5,37667,3438,41105
2023-09-27 20:51:16,80.4269212962963,4,804,271,1075
2023-10-02 16:55:33,79.36423611111111,4,267,14,281
2023-09-22 18:39:28,3.5954282407407407,1,13,13,26
2023-09-18 23:49:03,0.043680555555555556,1,2,2,4
2023-09-27 09:58:04,8.543020833333333,3,8,5,13
2023-09-19 05:35:42,0.38006944444444446,1,12,8,20
2023-10-03 08:25:10,14.591527777777777,10,68,25,93
2023-09-28 08:14:20,9.575879629629629,6,29,25,54
2023-10-04 14:31:38,15.870787037037037,13,37,39,76
2023-09-18 17:49:51,0.023993055555555556,1,1,1,2
2023-09-20 16:51:57,2.0003935185185187,3,10,2,12
2023-09-21 10:00:03,2.7336342592592593,4,33,25,58
2023-09-22 06:56:54,3.616585648148148,1,6,1,7
2023-09-18 17:58:02,0.08797453703703703,1,1,4,5
2023-09-18 14:08:57,0.02025462962962963,1,35,5,40
2023-09-19 15:27:51,1.2558449074074074,4,17,6,23
2023-09-18 11:33:01,0.11436342592592592,2,0,501,501
2023-09-18 11:31:59,0.12616898148148148,1,1,0,1
2023-09-28 09:27:43,10.052534722222223,1,2,0,2
2023-09-25 16:42:24,7.6911805555555555,6,7014,2882,9896
2023-09-18 22:45:12,1.119386574074074,1,1,1,2
2023-09-25 17:24:45,9.174930555555555,6,6844,2931,9775
2023-09-18 22:02:53,2.4324305555555554,1,1,1,2
2023-09-18 22:41:16,2.4708449074074075,1,6,6,12
2023-10-04 12:57:11,18.453125,1,9,0,9
2023-09-18 16:24:36,2.969363425925926,3,9,9,18
2023-09-18 14:58:39,2.9857175925925925,3,23,2,25
2023-09-18 11:52:43,2.9930555555555554,4,30,21,51
2023-09-21 15:52:48,6.243506944444444,14,191,62,253
2023-09-20 04:56:16,5.730763888888889,26,562,276,838
2023-10-09 07:58:04,24.072824074074074,3,65,20,85
2023-11-10 15:28:30,56.781782407407405,42,4789,2704,7493
2023-09-15 11:50:58,0.8114583333333333,4,8,6,14
2023-09-15 14:46:31,1.0319212962962963,1,33,1,34
2023-09-27 10:28:40,20.846296296296295,1,16,6,22
2023-10-06 09:25:15,21.841851851851853,7,26867,4939,31806
2023-10-11 17:54:22,27.288020833333334,3,113028,26396,139424
2023-10-11 11:50:23,27.55855324074074,2,7,4,11
2023-09-18 15:40:11,4.800740740740741,1,12,2,14
2023-09-18 21:46:13,5.105648148148148,1,1,1,2
2023-10-03 16:57:17,20.04976851851852,3,102,12,114
2023-09-13 15:50:58,0.037766203703703705,2,6,6,12
2023-09-15 09:00:36,1.7554050925925926,1,4,2,6
2023-09-13 18:35:43,0.21575231481481483,2,8,1,9
2023-09-28 07:55:58,14.89425925925926,2,22,38,60
2023-10-11 17:26:37,28.29125,91,49647,9000,58647
2023-09-13 16:00:52,11.982013888888888,5,119,28,147
2023-09-14 15:57:07,1.2640856481481482,5,43,41,84
2023-09-13 20:03:52,0.45966435185185184,1,2,1,3
2023-09-13 14:30:20,0.25265046296296295,4,42,8,50
2023-09-13 12:12:35,0.17421296296296296,2,36,4,40
2023-09-13 12:45:55,0.75125,1,1,1,2
2023-12-21 11:04:05,99.75672453703703,4,57,17,74
2023-09-12 17:40:46,0.03785879629629629,1,5,3,8
2023-09-13 10:12:27,0.7271875,1,1,1,2
2023-09-28 08:56:37,18.494479166666668,4,6,4,10
2023-09-13 13:05:11,0.9405324074074074,1,2,2,4
2023-09-12 09:49:07,0.042847222222222224,1,4,3,7
2023-09-19 19:44:41,7.534097222222222,4,8,3,11
2023-09-12 15:29:07,1.0418634259259258,3,87,16,103
2023-09-18 21:47:54,7.329768518518518,2,14,2,16
2023-11-13 16:20:42,65.15539351851852,32,1361,508,1869
2023-09-12 19:53:31,1.395,5,14,4,18
2023-09-11 15:20:29,0.2632175925925926,4,132,61,193
2024-04-11 07:32:16,206.19699074074074,250,347791,74419,422210
2023-10-04 16:39:02,23.962476851851854,2,260,2,262
2023-09-11 11:57:04,1.1420023148148148,1,15,15,30
2023-09-13 15:27:42,3.3066550925925924,1,4,0,4
2023-09-18 15:47:58,8.777708333333333,2,4,4,8
2023-09-12 17:31:24,2.8614814814814813,1,13,12,25
2023-09-11 21:03:26,2.019560185185185,2,26,26,52
2023-09-09 03:43:26,0.01599537037037037,2,4,1,5
2023-09-14 09:57:47,5.570520833333333,1,1,1,2
2023-10-06 08:28:00,27.577766203703703,2,15,46,61
2023-10-16 14:09:51,37.82478009259259,16,1072,332,1404
2023-09-13 04:56:37,4.480138888888889,1,5,1,6
2023-09-14 11:00:43,5.883252314814815,16,213,116,329
2023-10-04 13:13:37,41.19592592592593,39,1999,666,2665
2023-10-24 12:32:03,46.11667824074074,8,35,25,60
2023-09-12 15:04:27,4.295763888888889,8,356,24,380
2023-09-08 19:38:42,1.550150462962963,4,175,58,233
2023-09-12 09:33:28,4.525439814814815,59,4297,2058,6355
2023-09-08 20:03:09,0.8793287037037038,5,21,10,31
2023-12-21 10:54:44,11.5065625,22,491,304,795
2023-09-15 16:15:08,8.003530092592593,11,483,52,535
2023-10-11 08:08:55,33.73165509259259,27,14960,4105,19065
2023-09-08 13:51:54,0.9798148148148148,3,33,2,35
2023-09-14 23:27:40,7.556875,27,237,103,340
2023-09-07 18:54:52,0.41833333333333333,1,1,1,2
2023-09-07 09:10:40,0.05903935185185185,1,11,1,12
2023-09-07 12:51:35,0.2257986111111111,1,1,1,2
2023-09-13 04:56:54,5.943252314814814,2,5,8,13
2023-09-07 18:51:45,0.6167824074074074,3,9,1,10
2023-09-07 18:53:43,0.6647453703703704,2,6,6,12
2023-09-06 14:49:04,0.04777777777777778,1,0,6,6
2023-09-20 12:48:50,13.970046296296296,31,805,409,1214
2023-09-06 11:21:01,0.012604166666666666,2,4,6,10
2023-09-06 09:55:11,0.18847222222222224,1,1,1,2
2023-09-18 20:12:41,18.623738425925925,5,158,38,196
2023-09-13 18:21:46,7.867662037037037,2,2,1,3
2023-09-05 19:21:33,0.04787037037037037,2,2,2,4
2023-09-05 18:16:00,0.0515162037037037,7,63,13,76
2023-09-07 04:22:54,1.610798611111111,2,17,16,33
2023-09-05 13:47:00,0.09211805555555555,3,32,21,53
2023-09-07 16:49:14,2.251689814814815,8,587,139,726
2023-09-05 17:26:07,0.291875,4,55,6,61
2023-09-13 15:53:44,8.2721875,1,6,5,11
2023-09-05 10:13:07,0.07141203703703704,1,1,1,2
2023-09-13 18:12:48,8.413576388888888,2,12,6,18
2023-09-05 09:34:28,0.10451388888888889,3,5,5,10
2023-09-05 10:07:02,0.12637731481481482,1,6,0,6
2023-09-05 09:37:55,0.1325462962962963,1,1,15,16
2023-09-05 11:04:50,0.19033564814814816,2,57,56,113
2023-09-05 09:19:57,0.13175925925925927,1,1,1,2
2023-09-12 11:36:32,7.265243055555556,1,2,2,4
2023-09-12 17:01:23,7.65119212962963,6,107,27,134
2023-09-05 08:12:26,0.5625694444444445,2,35,35,70
2023-09-04 16:53:51,0.009918981481481482,1,1,1,2
2023-09-12 11:08:17,7.773796296296296,6,71,47,118
2023-09-04 18:17:10,0.11371527777777778,3,244,20,264
2023-09-11 11:56:37,5.804155092592593,1,2,1,3
2023-09-05 11:27:20,47.08704861111111,1,5,5,10
2023-09-04 16:54:35,0.1282523148148148,3,7,7,14
2023-09-04 16:18:35,0.10803240740740741,6,171,12,183
2023-09-05 11:31:59,0.9143402777777778,1,1,1,2
2023-11-28 08:38:33,84.79239583333333,11,658,78,736
2023-09-05 20:47:48,1.3543981481481482,4,129,83,212
2023-09-04 10:53:41,0.018680555555555554,1,5,4,9
2023-09-04 18:34:04,0.3548611111111111,5,42,37,79
2023-09-04 10:54:05,0.04193287037037037,1,8,3,11
2023-09-04 16:09:28,0.27119212962962963,5,38,22,60
2023-11-14 09:54:09,71.0543287037037,24,60863,8057,68920
2023-09-26 05:06:05,24.351400462962964,83,4242,1900,6142
2023-09-04 10:28:22,0.21487268518518518,1,1,1,2
2023-09-04 10:15:12,0.5846064814814815,14,28,28,56
2023-09-06 13:07:30,2.8899074074074074,2,6,6,12
2023-09-05 15:34:35,3.851539351851852,7,8,4,12
2023-09-05 16:13:06,2.257465277777778,8,396,262,658
2023-09-04 10:16:49,1.2095601851851852,1,1,1,2
2023-09-04 10:16:34,1.2106018518518518,1,2,2,4
2023-11-13 18:06:32,88.88702546296297,201,134960,27735,162695
2023-09-04 14:11:00,2.413402777777778,1,1,1,2
2023-09-05 11:43:52,3.467997685185185,1,3,3,6
2023-09-04 13:03:49,2.7226041666666667,1,1,1,2
2023-09-01 18:27:02,0.09916666666666667,1,1,1,2
2023-09-04 09:35:39,2.7581944444444444,2,15,0,15
2023-09-01 14:09:12,0.0430787037037037,4,12,4,16
2023-09-01 15:51:00,0.21366898148148147,3,190,2,192
2023-09-01 15:39:00,0.2198263888888889,4,33,33,66
2023-09-01 14:26:42,0.21900462962962963,1,6,22,28
2023-09-01 15:24:12,0.2760300925925926,2,31,58,89
2023-09-06 15:45:48,5.831261574074074,11,5503,514,6017
2023-09-01 19:27:02,1.0315393518518519,1,2,2,4
2023-09-05 13:49:33,4.89380787037037,3,22,13,35
2023-08-31 21:38:14,0.2785416666666667,3,7,7,14
2023-08-31 16:54:01,0.1230787037037037,1,2,2,4
2023-08-31 14:06:56,0.03405092592592593,2,6,3,9
2023-08-31 15:01:27,0.11524305555555556,1,3,3,6
2023-08-31 14:08:20,0.27775462962962966,2,22,4,26
2023-09-04 17:16:11,4.514490740740741,10,425,250,675
2023-08-30 20:49:04,0.04902777777777778,1,32,21,53
2023-11-02 10:05:21,63.69623842592593,3,4,23,27
2023-09-01 11:05:53,1.7267824074074074,2,196,26,222
2023-09-12 15:35:30,13.901400462962963,23,7443,1520,8963
2023-08-30 16:15:08,0.047789351851851854,1,2,1,3
2023-08-30 16:10:01,0.020983796296296296,1,1,1,2
2023-08-30 15:23:44,0.01605324074074074,1,2,1,3
2023-09-07 19:00:22,8.19548611111111,10,6198,777,6975
2023-08-31 17:14:19,1.7625810185185184,5,134,83,217
2023-10-24 14:49:26,61.1934375,19,55431,7297,62728
2023-08-30 14:11:54,0.015219907407407408,1,3,3,6
2023-08-30 13:40:39,0.02340277777777778,1,5,17,22
2023-09-05 17:01:20,6.226458333333333,13,5424,637,6061
2023-08-30 13:13:51,0.16527777777777777,1,1,1,2
2023-09-05 17:50:08,6.3684375,2,26,4,30
2023-09-07 16:17:30,8.304039351851852,22,131,85,216
2023-11-21 16:41:55,161.35880787037038,64,313254,140428,453682
2023-08-31 16:00:04,1.4301041666666667,8,244,163,407
2023-09-01 09:50:42,2.1904398148148148,2,9,9,18
2023-09-14 11:01:58,15.510543981481481,7,6594,767,7361
2023-09-19 13:56:11,20.74303240740741,22,1768,244,2012
2023-08-30 15:00:37,0.8210069444444444,1,7,0,7
2023-08-29 19:10:46,0.07416666666666667,1,9,27,36
2023-08-29 17:26:41,0.044270833333333336,1,1,0,1
2023-08-29 19:02:58,0.1509375,1,1,1,2
2023-08-29 16:01:45,0.04443287037037037,1,2,2,4
2023-08-30 09:52:42,0.7796759259259259,1,1,1,2
2023-10-05 08:05:40,36.73056712962963,17,43966,6741,50707
2023-08-30 10:56:06,0.848287037037037,1,1,1,2
2023-08-29 17:00:40,0.12424768518518518,1,14,20,34
2023-09-01 18:40:40,3.2122800925925925,19,10517,1091,11608
2023-08-29 11:52:26,0.016273148148148148,1,4,2,6
2023-08-29 11:32:20,0.05402777777777778,1,2,2,4
2023-08-29 14:06:41,0.17475694444444445,2,6,2,8
2023-08-31 09:47:54,2.063946759259259,2,20,12,32
2023-08-29 13:02:58,0.23967592592592593,2,11,9,20
2023-08-31 09:55:11,2.3194675925925927,2,15,15,30
2023-08-31 09:31:16,2.664976851851852,2,14,3,17
2023-08-29 13:09:07,1.0459375,2,4,4,8
2023-09-15 15:52:19,18.21349537037037,7,4116,853,4969
2023-08-28 10:07:31,0.0792361111111111,5,34,13,47
2023-08-29 13:08:14,1.2690277777777779,5,89,22,111
2023-09-06 14:40:04,15.286261574074073,6,311,88,399
2023-08-29 07:22:37,1.379537037037037,1,1,1,2
2023-08-28 14:37:37,0.6964814814814815,1,2,2,4
2023-08-29 12:11:49,2.0561689814814814,1,10,10,20
2023-08-29 07:22:15,3.4941087962962962,4,25,8,33
2023-09-05 19:50:14,11.089710648148149,3,38,3,41
2023-08-25 17:59:29,0.013078703703703703,1,2,4,6
2023-08-29 15:15:06,4.013645833333333,20,98,82,180
2023-08-25 15:46:56,0.07871527777777777,2,2,2,4
2023-08-25 13:56:39,0.045856481481481484,4,143,192,335
2023-08-29 13:48:51,4.7621064814814815,23,4245,1406,5651
2023-08-25 12:30:39,0.05289351851851852,1,2,2,4
2023-10-24 12:33:05,60.23054398148148,2,7,3,10
2023-08-28 13:31:22,3.291550925925926,8,3692,1120,4812
2023-08-28 13:31:33,3.3784490740740742,10,3651,1084,4735
2023-08-25 07:20:37,0.33510416666666665,1,2,2,4
2023-08-29 17:49:15,4.9538773148148145,1,22,20,42
2023-08-25 16:57:41,0.9672685185185185,57,36769,13633,50402
2023-08-25 06:19:12,0.5632870370370371,2,25,1,26
2023-08-25 13:36:41,0.9148726851851852,2,12,6,18
2023-08-24 15:33:15,0.010659722222222221,1,18,3,21
2023-08-24 16:48:42,0.09741898148148148,1,2,1,3
2023-09-15 15:53:39,22.102858796296296,7,21705,3244,24949
2024-01-30 08:33:56,158.81177083333333,11,231159,33232,264391
2023-08-24 16:58:38,0.17092592592592593,1,2,2,4
2023-08-24 14:18:39,0.10429398148148149,9,172,102,274
2023-08-24 13:15:44,0.13336805555555556,3,9,3,12
2023-09-15 16:22:02,22.280324074074073,13,21736,3267,25003
2023-08-24 09:15:30,0.014247685185185184,1,3,3,6
2023-08-24 12:56:12,0.18383101851851852,5,198,124,322
2023-09-05 14:41:42,12.272361111111111,22,13761,2505,16266
2023-08-24 12:57:16,0.19614583333333332,2,4,3,7
2023-08-24 09:14:27,0.05628472222222222,1,2,2,4
2023-08-24 10:09:13,0.09925925925925926,3,18,16,34
2023-08-24 08:13:30,0.09496527777777777,1,12,9,21
2023-08-29 13:10:00,5.364629629629629,5,292,81,373
2023-08-25 14:12:55,2.334074074074074,6,26,26,52
2023-10-06 14:03:12,44.97234953703704,8,92,352,444
2023-10-23 12:49:48,67.91222222222223,250,117308,27681,144989
2023-08-25 11:42:06,1.761238425925926,6,593,650,1243
2023-08-23 18:09:14,0.033541666666666664,1,1,1,2
2023-08-24 06:03:34,0.564699074074074,1,4,1,5
2023-08-24 16:24:37,1.07125,5,501,170,671
2023-08-23 18:17:02,0.12993055555555555,6,99,85,184
2023-08-24 06:00:43,0.6547222222222222,1,2,2,4
2023-08-23 14:39:28,0.01871527777777778,1,1,1,2
2023-08-25 12:41:04,2.0304050925925927,2,1080,1534,2614
2023-08-23 12:17:37,0.024641203703703703,1,2,3,5
2023-08-23 09:14:45,0.06538194444444445,7,1051,1512,2563
2023-08-24 18:14:58,1.7501851851851853,6,544,167,711
2023-08-23 12:21:08,0.1902199074074074,1,1,1,2
2023-08-23 18:40:03,0.5273032407407408,1,1,1,2
2023-08-29 15:47:25,7.181585648148148,4,172,103,275
2023-08-23 05:49:20,0.47350694444444447,1,0,1,1
2023-08-22 20:58:56,0.21278935185185185,2,1476,1477,2953
2023-08-22 18:28:38,0.10696759259259259,3,29,19,48
2023-08-23 06:34:30,0.6290625,2,18,19,37
2023-08-23 05:16:44,0.8144791666666666,7,6735,162,6897
2023-08-22 15:08:13,0.18092592592592593,3,21,4,25
2023-08-25 10:56:17,3.0341550925925924,7,370,80,450
2023-08-22 12:50:13,5.889907407407407,13,6694,141,6835
2023-08-22 08:39:11,0.019097222222222224,1,2,2,4
2023-08-22 08:13:56,0.015555555555555555,1,1,4,5
2023-08-22 07:54:45,0.025636574074074076,2,2,2,4
2023-08-22 14:10:31,0.5904166666666667,1,3,9,12
2023-10-24 10:02:07,63.55400462962963,18,226,191,417
2023-09-14 09:30:50,23.802685185185187,4,48,8,56
2023-08-22 15:21:01,0.8911111111111111,2,6,2,8
2023-08-25 15:36:37,3.9158564814814816,6,75,46,121
2023-08-21 15:23:17,0.015300925925925926,1,1,1,2
2023-08-29 18:24:25,8.211631944444445,22,90,43,133
2023-08-21 13:20:44,0.017858796296296296,1,10,1,11
2023-08-22 12:13:38,1.0049189814814814,4,9,9,18
2023-08-26 19:08:47,5.3220833333333335,3,119,17,136
2023-08-21 12:33:44,0.065625,1,1,1,2
2023-08-31 12:17:26,41.804270833333334,11,193,106,299
2023-08-21 08:04:44,0.018993055555555555,1,3,1,4
2023-08-21 07:01:12,0.06017361111111111,1,1,1,2
2023-10-18 11:42:32,58.63944444444444,29,75310,9425,84735
2023-08-21 14:20:06,2.659340277777778,1,5,3,8
2023-09-14 16:42:35,26.77983796296296,15,69,60,129
2023-08-21 09:11:21,2.5660416666666666,1,1,1,2
2023-08-25 15:13:35,6.89900462962963,39,14368,2844,17212
2023-09-22 15:42:11,35.01078703703703,99,42402,8588,50990
2023-08-18 21:30:30,0.21854166666666666,2,8,1,9
2023-08-18 20:01:36,0.17077546296296298,4,31,0,31
2023-09-12 11:50:42,25.080891203703704,7,81,28,109
2023-08-18 13:57:18,0.05503472222222222,1,11,9,20
2023-08-21 09:08:38,0.009363425925925926,1,998,8,1006
2023-08-21 11:40:04,3.133958333333333,2,3,2,5
2023-08-18 08:32:46,0.0828125,1,1,1,2
2023-08-18 05:58:59,0.04936342592592593,1,2,2,4
2023-09-08 19:13:34,21.793333333333333,4,49,13,62
2023-08-22 05:55:36,4.436678240740741,1,15,1,16
2023-08-17 18:48:58,0.12746527777777777,2,10,1,11
2023-08-17 16:56:35,0.05662037037037037,2,9,3,12
2023-08-17 15:44:02,0.02060185185185185,1,3,3,6
2023-08-18 10:40:40,0.8266319444444444,6,45,42,87
2023-08-18 08:17:44,0.7459953703703703,3,19,15,34
2023-08-17 13:30:46,0.02435185185185185,2,7,0,7
2023-08-18 11:39:23,0.9505439814814814,8,5843,4977,10820
2023-08-17 15:34:25,0.18564814814814815,2,3,0,3
2023-08-18 16:09:51,2.0285416666666665,7,37,34,71
2023-08-17 10:08:12,0.016307870370370372,1,9,9,18
2023-08-17 09:23:16,0.030289351851851852,1,3,0,3
2023-08-17 08:48:39,0.01480324074074074,1,1,2,3
2023-11-01 15:09:55,75.57342592592593,4,1012,24,1036
2023-08-28 12:58:23,11.29119212962963,10,7669,644,8313
2023-08-17 06:10:33,0.39140046296296294,1,1,1,2
2023-08-17 08:02:55,0.6119328703703704,3,6,6,12
2023-08-17 07:06:26,0.5927314814814815,1,3,3,6
2023-08-17 08:35:57,0.6658564814814815,2,3,3,6
2023-08-16 16:11:24,0.024270833333333332,1,1,1,2
2023-08-16 15:02:58,0.022002314814814815,1,1,1,2
2023-08-16 16:19:51,0.07729166666666666,1,6,0,6
2023-08-16 14:30:54,0.023055555555555555,2,30,4,34
2023-08-17 06:28:06,0.859537037037037,2,50,13,63
2023-08-16 09:48:24,0.015069444444444444,1,6,0,6
2023-08-30 13:16:17,14.236805555555556,5,141,69,210
2023-08-23 00:14:54,6.706597222222222,5,50,25,75
2023-08-29 09:03:52,13.520671296296296,10,1578,102,1680
2023-08-15 16:57:59,0.13387731481481482,1,1,1,2
2023-08-16 12:18:32,1.0037615740740742,2,279,73,352
2023-08-29 10:05:28,14.018518518518519,11,277,63,340
2023-08-16 06:03:23,0.8527430555555555,2,52,8,60
2023-08-15 09:11:29,0.08003472222222222,1,4,0,4
2023-08-15 06:44:22,0.25927083333333334,1,8,5,13
2023-08-15 06:52:20,0.30386574074074074,1,1,1,2
2023-08-15 06:52:31,0.30452546296296296,1,1,1,2
2023-08-22 06:22:46,11.14625,5,5246,1129,6375
2023-08-17 11:41:34,2.814375,5,29,10,39
2023-08-14 17:12:06,0.048935185185185186,1,1,1,2
2023-08-14 16:08:47,0.09439814814814815,3,2,4,6
2023-08-14 15:43:39,0.07032407407407408,5,14,13,27
2023-08-29 15:38:44,16.2878125,15,381,133,514
2023-08-14 15:00:57,0.09409722222222222,1,8,6,14
2023-08-14 13:22:15,0.01875,1,0,6,6
2023-08-14 14:41:47,0.2009027777777778,1,7,0,7
2023-08-14 13:44:34,0.34346064814814814,3,46,46,92
2023-08-13 17:26:40,0.2738425925925926,1,4,0,4
2023-08-21 11:09:34,8.090023148148148,6,30,20,50
2023-08-25 11:35:41,12.331655092592593,23,18881,2613,21494
2023-08-14 11:46:18,1.8665393518518518,1,3,1,4
2023-08-13 17:47:05,1.8907060185185185,1,1,1,2
2023-08-13 17:47:16,1.8908449074074074,1,1,1,2
2023-08-11 19:07:08,0.12762731481481482,1,19,75,94
2023-08-16 16:45:02,148.20527777777778,9,4499,2036,6535
2023-08-11 14:26:45,0.02193287037037037,1,3,2,5
2023-08-11 14:09:31,0.11766203703703704,2,133,23,156
2023-08-11 13:41:25,0.034930555555555555,3,3,3,6
2023-08-16 10:49:30,4.993657407407407,2,6,2,8
2023-08-11 12:16:01,0.0825,1,0,96,96
2023-08-17 05:58:35,6.851331018518518,5,421,94,515
2023-08-11 09:39:57,0.050659722222222224,6,16,13,29
2023-08-11 10:30:18,1.7351041666666667,2,969,3739,4708
2023-08-22 06:12:58,11.519178240740741,8,320,91,411
2023-08-11 12:40:52,0.18855324074074073,3,85,29,114
2023-08-10 15:13:40,0.03576388888888889,1,6,0,6
2023-08-16 17:04:20,6.148726851851852,6,193,77,270
2023-08-10 14:42:05,0.052222222222222225,1,1,1,2
2023-08-10 15:07:33,0.0896875,2,32,14,46
2023-08-15 15:47:48,5.128368055555556,11,78,54,132
2023-08-18 21:08:34,33.258541666666666,3,211,49,260
2023-08-10 11:25:01,0.019050925925925926,1,5,0,5
2023-08-18 12:27:16,8.142777777777777,3,6752,5114,11866
2023-08-17 15:21:56,7.346307870370371,7,36,23,59
2023-08-17 15:03:41,7.361203703703704,3,2,46,48
2023-08-10 09:50:13,0.6829976851851852,2,6,5,11
2023-08-09 17:51:51,0.018275462962962962,1,1,1,2
2023-08-10 09:54:27,0.7270601851851852,6,35,17,52
2023-08-09 16:41:22,0.049560185185185186,1,14,3,17
2023-08-10 09:42:34,0.91875,5,799,73,872
2023-08-09 16:28:03,0.19024305555555557,3,44,25,69
2023-08-10 08:53:22,1.9786226851851851,5,469,234,703
2023-08-09 12:15:06,0.024675925925925928,2,51,24,75
2023-08-09 12:07:12,0.10754629629629629,1,1,7,8
2023-08-09 10:09:09,0.045717592592592594,1,1,2,3
2023-08-09 07:31:25,0.01957175925925926,1,0,8,8
2023-08-09 08:46:06,0.0862962962962963,1,1,1,2
2023-08-09 11:50:13,0.23952546296296295,2,8,6,14
2023-08-09 12:13:34,0.25930555555555557,1,2,2,4
2023-08-17 15:19:54,8.752685185185186,3,74,53,127
2023-09-22 16:53:55,44.99591435185185,32,1108,834,1942
2023-08-10 07:13:52,1.4483912037037037,1,5,22,27
2023-08-08 17:05:41,0.039467592592592596,1,3,3,6
2023-08-09 10:48:32,0.8166319444444444,3,62,35,97
2023-08-08 15:15:35,0.00849537037037037,1,3,3,6
2023-08-08 14:27:24,0.06640046296296297,2,96,28,124
2023-08-08 12:53:03,0.03305555555555555,2,113,63,176
2023-08-23 16:25:28,15.224756944444444,4,65,36,101
2023-08-09 16:28:57,1.2706365740740742,7,126,141,267
2023-08-08 12:12:57,0.09246527777777777,1,1,0,1
2023-08-09 06:31:58,1.0051967592592592,3,1297,367,1664
2023-08-08 17:18:33,0.6702893518518519,4,65,34,99
2023-08-08 08:48:46,0.03715277777777778,2,37,15,52
2023-08-08 06:12:11,0.4200925925925926,2,38,0,38
2023-08-08 10:00:32,0.841412037037037,1,12,10,22
2023-08-08 08:49:21,0.9185069444444445,5,166,91,257
2023-08-08 09:16:00,0.9771643518518518,8,75,34,109
2023-08-07 10:32:34,2.094097222222222,1,2,2,4
2023-08-07 15:45:41,0.3092013888888889,3,10,5,15
2023-08-07 14:25:16,0.6951967592592593,2,12,5,17
2023-08-08 11:48:50,3.2427199074074076,4,12,6,18
2023-08-07 15:56:13,2.822210648148148,1,2,2,4
2023-09-14 14:10:35,40.89744212962963,111,3982,3529,7511
2023-09-14 14:59:09,41.03211805555556,9,211,189,400
2023-08-04 14:24:04,0.2665162037037037,2,83,9,92
2023-08-08 09:41:01,3.876574074074074,3,108,60,168
2023-08-04 12:10:31,0.031018518518518518,1,1,1,2
2023-08-04 11:42:06,0.19364583333333332,1,11,11,22
2023-08-03 21:17:31,0.0540625,1,1,1,2
2023-08-04 14:53:57,0.8733680555555555,1,12,0,12
2023-08-08 09:37:14,4.785856481481481,2,30,14,44
2023-08-03 21:17:07,0.18600694444444443,1,1,1,2
2023-08-07 14:38:25,3.909837962962963,1,0,58,58
2023-08-04 12:35:10,0.8385763888888889,5,92,89,181
2023-08-04 12:56:29,0.9834837962962963,9,422,206,628
2023-08-04 13:13:15,1.1698958333333334,16,140,71,211
2023-08-03 15:05:03,0.09303240740740741,2,4,4,8
2023-08-03 09:34:45,0.036585648148148145,3,7,6,13
2023-08-02 20:00:33,0.02837962962962963,1,0,2,2
2023-08-02 15:48:40,0.10241898148148149,1,2,0,2
2023-08-02 16:11:16,0.11483796296296296,6,48,8,56
2023-08-02 18:22:36,0.22385416666666666,19,216,205,421
2023-08-18 08:32:29,15.818842592592592,14,599,329,928
2023-08-02 12:53:05,0.0665625,1,0,4,4
2023-08-02 10:29:56,0.02141203703703704,1,4,4,8
2023-08-25 08:58:14,23.035046296296297,10,28141,8542,36683
2023-08-07 14:32:25,4.742847222222222,14,829,104,933
2023-08-02 12:43:55,0.7642245370370371,1,4,1,5
2023-08-09 12:29:07,8.763935185185185,8,475,72,547
2023-10-11 11:18:42,76.08108796296297,7,924,192,1116
2023-08-09 10:09:20,7.821446759259259,23,2451,963,3414
2023-08-02 07:29:00,0.6913310185185185,1,8,5,13
2023-09-06 12:37:28,55.05888888888889,3,45,42,87
2023-08-04 12:56:10,3.1228819444444444,11,74,579,653
2023-08-03 12:51:57,1.934375,1,5,2,7
2023-08-03 13:08:39,2.0158217592592593,6,14278,5031,19309
2023-08-03 13:12:08,2.0719791666666665,3,66,3,69
2023-08-01 10:21:50,0.02440972222222222,4,112,72,184
2023-08-01 11:33:13,0.08400462962962962,1,3,2,5
2023-08-02 09:37:28,1.0292824074074074,4,9,3,12
2023-08-04 12:55:58,3.1737962962962962,2,16,11,27
2023-08-17 15:08:06,16.37040509259259,36,10434,6925,17359
2023-08-01 08:56:52,0.6306018518518518,4,32,9,41
2023-07-31 18:13:16,0.17996527777777777,1,3,1,4
2023-07-31 17:35:33,0.14575231481481482,4,364,16,380
2023-07-31 15:32:06,0.0506712962962963,1,1,1,2
2023-08-03 10:01:10,2.938460648148148,5,17,17,34
2023-07-31 16:43:22,0.21724537037037037,2,17,9,26
2023-07-31 15:25:10,0.19069444444444444,1,3,1,4
2023-08-02 08:44:43,1.9513541666666667,2,7,1,8
2023-07-31 14:15:03,0.19679398148148147,1,5,0,5
2023-08-01 10:20:35,1.0625925925925925,2,4,2,6
2023-08-01 08:56:37,1.0075,2,5,4,9
2023-08-08 06:09:17,7.993738425925926,9,4986,2010,6996
2023-08-01 05:35:50,0.18579861111111112,1,4,1,5
2023-07-31 16:37:30,1.0073842592592592,1,6,6,12
2023-08-07 14:31:16,8.13670138888889,3,72,72,144
2023-08-07 16:02:15,8.779884259259259,16,228,166,394
2023-08-03 14:51:54,4.979907407407407,5,108,38,146
2023-07-28 18:52:52,0.32136574074074076,6,59,17,76
2023-07-31 10:21:11,2.7936921296296298,1,19,9,28
2023-08-02 09:17:31,0.6715509259259259,7,1304,737,2041
2023-07-28 15:00:10,0.044814814814814814,2,2,2,4
2023-07-28 14:45:09,0.04619212962962963,1,4,2,6
2023-07-28 17:50:16,3.000613425925926,4,28,27,55
2023-07-28 13:33:45,0.1902662037037037,3,116,116,232
2023-07-28 12:17:24,0.16293981481481482,1,10,0,10
2023-07-28 12:19:11,0.170625,1,1,3,4
2023-07-27 17:41:50,0.09315972222222223,1,53,0,53
2023-07-27 15:42:07,0.04071759259259259,4,64,27,91
2023-07-27 12:34:02,0.10777777777777778,1,1,1,2
2023-07-27 13:09:27,0.1838773148148148,2,5,3,8
2023-07-28 12:20:11,1.422175925925926,5,107,106,213
2023-07-27 12:43:18,0.22765046296296296,1,11,8,19
2023-08-02 10:55:57,6.452395833333333,8,4817,2282,7099
2023-07-28 12:28:05,1.6603125,8,17,37,54
2023-07-26 17:30:38,0.034166666666666665,1,29,419,448
2023-08-08 16:02:49,140.17596064814813,5,1556,1325,2881
2023-07-28 09:40:09,1.7749421296296297,3,301,276,577
2023-07-26 15:08:58,0.01625,1,2,2,4
2023-07-27 14:24:52,1.0094560185185186,5,56,17,73
2023-07-28 17:20:24,2.1631365740740742,1,9,6,15
2023-07-26 13:34:42,0.03121527777777778,1,3,1,4
2023-07-27 13:11:28,1.0697685185185186,2,9,9,18
2023-08-17 16:23:35,22.23491898148148,16,17874,10013,27887
2023-07-26 12:57:46,0.12094907407407407,1,3,4,7
2023-08-02 08:21:52,0.07806712962962963,3,62,16,78
2023-07-26 12:30:34,0.3938425925925926,2,2,1,3
2023-07-25 22:08:46,0.04604166666666667,2,11,7,18
2023-07-25 21:25:05,0.029027777777777777,1,1,1,2
2023-07-25 21:25:14,0.029282407407407406,1,1,1,2
2023-07-25 21:24:50,0.029305555555555557,1,1,1,2
2023-08-07 15:47:23,12.854224537037037,9,207,127,334
2023-07-27 17:24:57,387.33131944444443,81,2857,1758,4615
2023-08-07 19:07:29,13.040902777777777,14,161,101,262
2023-07-25 18:26:00,0.019305555555555555,1,13,8,21
2023-07-26 14:09:18,0.8783101851851852,1,70,1445,1515
2023-08-17 15:00:33,17.166087962962962,16,18976,10169,29145
2023-07-25 16:24:36,0.011643518518518518,2,3,3,6
2023-11-02 15:39:22,100.0074537037037,16,440,212,652
2023-07-25 15:23:09,0.02212962962962963,4,144,58,202
2023-07-26 13:10:00,0.9447106481481482,21,522,202,724
2023-08-18 11:26:27,23.89414351851852,26,19339,10324,29663
2023-07-25 12:11:57,0.016689814814814814,1,1,1,2
2023-08-18 17:08:04,30.21025462962963,62,30756,13090,43846
2023-07-25 12:04:49,0.048310185185185185,1,6,0,6
2023-07-25 12:30:14,0.0696412037037037,1,4,4,8
2023-07-25 11:34:11,0.08560185185185185,1,3,3,6
2023-07-25 12:09:02,0.35869212962962965,1,1,1,2
2023-07-25 12:02:34,0.38112268518518516,1,2,2,4
2023-08-10 20:06:30,16.970208333333332,50,14241,5491,19732
2023-07-25 11:56:05,0.729849537037037,2,110,109,219
2023-07-27 01:41:43,2.3351967592592593,1,53,54,107
2023-07-25 08:15:01,0.6448148148148148,2,18,0,18
2023-07-25 16:45:01,1.0072337962962963,9,115,43,158
2023-07-26 15:23:31,1.9907407407407407,2,127,42,169
2023-07-24 18:34:17,0.17895833333333333,2,23,15,38
2023-07-24 14:58:41,0.03612268518518519,1,1,1,2
2023-07-25 13:41:49,0.9872222222222222,3,47,3,50
2023-08-02 10:30:36,8.875729166666666,3,26,16,42
2023-07-24 14:53:10,0.049108796296296296,2,6,2,8
2023-07-25 10:12:30,0.8576967592592593,1,55,13,68
2023-07-28 12:14:28,3.9593402777777778,2,9995,2495,12490
2023-07-24 13:27:20,0.019178240740740742,2,77,3,80
2023-07-27 14:35:17,3.0828125,6,175,43,218
2023-07-24 12:42:39,0.09846064814814814,1,1,1,2
2023-07-24 13:12:39,0.13328703703703704,3,31,18,49
2023-07-24 12:31:45,0.1200925925925926,1,4,0,4
2023-07-25 20:10:07,1.4496296296296296,1,1,1,2
2023-07-25 12:20:38,1.1292476851851851,4,21,22,43
2023-07-24 13:37:58,1.9538194444444446,1,1,1,2
2023-08-08 11:56:34,23.977222222222224,6,594,331,925
2023-07-24 04:17:27,1.8698726851851852,4,12,7,19
2023-08-10 07:50:51,29.013506944444444,4,133,67,200
2023-07-24 14:08:48,9.710405092592593,5,227,192,419
2023-07-21 20:49:44,0.07008101851851851,1,0,0,0
2023-07-21 16:11:08,0.02039351851851852,1,4,4,8
2023-07-24 13:21:10,2.9140277777777777,5,34,32,66
2023-07-21 15:50:53,0.0165625,1,8,1,9
2023-07-21 14:30:17,0.017083333333333332,1,4,2,6
2023-07-21 14:47:51,0.07186342592592593,1,2,2,4
2023-07-21 13:42:06,0.054016203703703705,1,3,1,4
2023-08-17 06:03:17,34.52902777777778,8,31932,12752,44684
2023-07-21 12:22:49,0.1516898148148148,4,17,8,25
2023-07-25 14:19:43,4.245081018518518,6,9331,2303,11634
2023-08-07 06:37:29,28.666516203703704,9,32835,10356,43191
2023-09-14 15:00:53,55.41832175925926,6,193,97,290
2023-07-25 12:28:21,15.315416666666666,5,24092,6952,31044
2023-07-25 11:44:24,4.959988425925926,16,241,84,325
2023-07-21 19:39:28,0.9683796296296296,4,488,450,938
2023-07-21 13:41:36,0.7224074074074074,1,202,212,414
2023-07-21 13:41:57,0.7523958333333334,2,106,106,212
2023-07-21 12:32:34,0.8147800925925925,3,5,2,7
2023-08-09 16:24:30,30.06136574074074,23,50368,18253,68621
2023-07-20 16:30:11,0.010231481481481482,1,22,22,44
2023-07-20 16:29:23,0.03155092592592593,1,27,3,30
2023-07-20 16:17:39,0.030949074074074073,1,1,1,2
2023-08-17 16:34:47,29.31482638888889,37,24772,11904,36676
2023-07-20 12:25:39,0.026099537037037036,1,1,1,2
2023-07-20 11:43:49,0.01099537037037037,1,1,1,2
2023-07-21 12:16:57,1.126886574074074,2,15,9,24
2023-07-20 11:09:05,0.34717592592592594,3,8,16,24
2023-08-02 14:06:37,22.912511574074074,4,37,10,47
2023-07-20 19:19:35,0.5994791666666667,2,18,18,36
2023-08-23 12:07:46,34.495752314814816,3,41283,12371,53654
2023-07-19 20:57:41,0.16340277777777779,1,1,1,2
2023-07-21 12:28:55,1.8224305555555556,6,14,14,28
2023-07-25 14:07:00,5.95912037037037,3,29,8,37
2023-07-21 06:47:26,1.6768865740740742,3,11,7,18
2023-08-09 06:15:31,27.657916666666665,5,21910,9479,31389
2023-07-20 11:03:24,0.8905092592592593,5,65,420,485
2023-07-25 14:04:14,14.931539351851852,13,117,44,161
2023-07-20 13:01:38,1.072638888888889,1,1,2,3
2023-07-19 11:18:16,0.03293981481481482,2,3,3,6
2023-07-24 15:54:14,11.141319444444445,5,98,31,129
2023-07-19 12:13:14,0.1700347222222222,1,6,6,12
2023-07-19 11:30:02,0.1926388888888889,1,2,1,3
2023-07-19 12:26:27,0.23803240740740741,3,73,69,142
2023-07-25 11:43:22,14.753391203703703,6,242,68,310
2023-07-19 11:35:04,0.2614236111111111,1,1,1,2
2023-07-24 13:24:12,9.315949074074075,9,2044,766,2810
2023-07-19 11:17:35,0.5677199074074074,4,38,38,76
2023-07-19 07:49:52,0.4836226851851852,5,22,7,29
2023-07-26 12:58:26,7.824247685185185,10,9623,2406,12029
2023-07-18 19:18:32,0.18876157407407407,24,6981,1356,8337
2023-07-18 22:40:37,0.27686342592592594,2,593,71,664
2023-07-18 17:30:28,0.0834375,4,28,8,36
2023-07-18 17:24:36,0.109375,3,4,3,7
2023-07-18 19:05:27,0.23008101851851853,3,20,10,30
2023-07-18 20:07:02,0.3627546296296296,1,2,0,2
2023-07-24 13:23:34,15.242905092592592,6,153,57,210
2023-07-18 13:08:53,0.017951388888888888,1,0,2,2
2023-07-28 17:06:37,25.63775462962963,5,507,177,684
2023-07-18 11:45:01,0.04196759259259259,2,16,16,32
2023-07-18 12:20:33,0.46336805555555555,2,71,4,75
2023-07-18 11:39:08,0.09994212962962963,2,16,6,22
2023-07-18 17:33:42,0.46399305555555553,2,11,5,16
2023-08-04 17:36:58,17.609861111111112,3,39,39,78
2023-07-17 20:37:28,0.01733796296296296,1,0,832,832
2023-07-17 19:51:50,0.017037037037037038,1,2,0,2
2023-07-17 19:52:04,0.05375,1,7,7,14
2023-07-17 18:10:13,0.012233796296296296,1,2,2,4
2023-07-17 18:52:29,0.07386574074074075,6,4358,122,4480
2023-07-17 17:27:12,0.019664351851851853,2,1,5,6
2023-07-17 16:47:14,0.036145833333333335,1,6,6,12
2023-07-17 16:53:03,0.05918981481481481,4,31,2,33
2023-07-17 18:32:44,0.39636574074074077,22,1624,347,1971
2023-07-17 15:07:17,0.09414351851851852,2,4,4,8
2023-09-14 18:42:21,61.361296296296295,9,113,83,196
2023-07-17 14:58:51,0.11997685185185185,1,4,1,5
2023-07-20 14:09:41,3.290891203703704,11,7728,1379,9107
2023-07-17 18:46:00,2.6001041666666667,3,2,31,33
2023-07-17 11:17:17,2.4135648148148148,1,1,1,2
2023-07-26 12:40:38,11.769560185185185,3,153,10,163
2023-07-17 11:07:48,2.9313541666666665,2,1,3,4
2023-07-17 10:57:43,2.884872685185185,4,292,429,721
2023-07-14 18:43:20,0.909699074074074,5,311,122,433
2023-07-20 11:23:18,5.95306712962963,3,12,29,41
2023-09-08 11:49:40,56.32077546296296,1,7,4,11
2023-07-14 13:20:02,0.6808333333333333,1,0,1,1
2023-07-13 19:24:52,0.07457175925925925,1,2,2,4
2023-07-13 15:56:53,0.04539351851851852,1,1,1,2
2023-07-13 16:27:58,0.07516203703703704,2,6,68,74
2023-07-13 19:25:46,0.2064236111111111,4,14,13,27
2023-07-13 15:50:20,0.0719212962962963,2,40,1,41
2023-07-13 13:48:00,0.0966550925925926,2,8,7,15
2023-07-13 02:19:45,0.0075,1,1,1,2
2023-11-22 16:21:37,133.24693287037036,103,199641,45741,245382
2023-08-18 21:12:28,36.92542824074074,132,45115,20075,65190
2023-07-14 21:47:50,1.9761458333333333,2,1,2,3
2023-07-13 11:57:30,0.6138888888888889,1,6,6,12
2023-07-13 16:56:43,0.8404282407407407,1,1,1,2
2023-07-14 17:13:45,1.8834375,1,1,0,1
2023-07-13 15:46:54,1.7862847222222222,16,369,3346,3715
2023-07-13 20:57:21,1.0969675925925926,4,1019,3555,4574
2023-07-13 13:54:18,0.06025462962962963,1,3,0,3
2023-07-12 15:47:21,0.01712962962962963,1,0,35,35
2023-07-17 18:35:20,5.230335648148148,6,146,48,194
2023-07-12 14:01:51,0.06991898148148148,8,115,67,182
2023-07-12 11:50:26,0.09008101851851852,3,10,8,18
2023-07-26 13:07:22,0.02744212962962963,1,6,1,7
2023-07-12 11:06:18,0.07611111111111112,2,3,2,5
2023-07-20 11:02:45,8.189224537037036,9,805,25,830
2023-07-13 10:57:56,84.04751157407408,6,165871,98472,264343
2023-07-11 21:55:55,0.022476851851851852,1,1,1,2
2023-07-11 20:52:35,0.010081018518518519,1,6,6,12
2023-07-11 20:48:06,0.0516087962962963,2,13,7,20
2023-07-11 20:37:05,0.0490162037037037,9,23,16,39
2023-07-12 11:45:09,7.627800925925926,9,11813,885,12698
2023-07-12 09:49:12,0.6263310185185185,1,1,1,2
2023-07-12 14:38:26,0.8453819444444445,1,1,1,2
2023-07-11 20:08:15,0.008773148148148148,2,9,1,10
2023-07-11 16:40:22,0.0512037037037037,1,3,0,3
2023-08-07 16:18:44,27.05033564814815,26,25389,9039,34428
2023-11-10 13:49:10,122.2546875,93,15137,9919,25056
2023-07-11 13:04:51,0.7365046296296296,1,1,1,2
2023-07-11 15:21:29,0.9200231481481481,2,41,48,89
2023-07-10 16:57:27,0.0771412037037037,1,17,17,34
2023-07-12 11:21:31,1.8480902777777777,6,5313,285,5598
2023-07-25 19:02:49,17.385011574074074,41,28138,7877,36015
2023-07-24 14:34:20,16.19076388888889,12,21869,6826,28695
2023-07-11 15:29:48,3.103645833333333,2,30,5,35
2023-10-30 12:32:17,51.8865625,91,7075,2534,9609
2023-07-07 09:55:22,0.09886574074074074,1,3,0,3
2023-07-13 09:30:22,6.613263888888889,2,34,34,68
2023-07-06 18:12:17,0.07628472222222223,1,10,4,14
2023-07-06 14:30:23,0.055810185185185185,1,0,3,3
2023-07-21 23:24:00,15.597662037037036,1,88,362,450
2023-07-10 12:50:08,4.205277777777778,1,4,0,4
2023-07-06 09:21:28,0.1216087962962963,2,10,1,11
2023-07-06 09:26:37,1.1332291666666667,5,23,4,27
2023-07-07 02:33:55,1.0530902777777778,5,215,18,233
2023-07-11 18:55:05,5.90994212962963,1,4,2,6
2023-07-12 14:58:08,6.872604166666667,1,0,2,2
2023-07-05 17:28:47,0.05928240740740741,2,11,3,14
2023-07-05 14:49:10,0.12136574074074075,6,107,107,214
2023-07-07 17:11:38,2.2772685185185186,5,31,13,44
2023-07-21 12:19:28,16.15076388888889,3,135,124,259
2023-07-05 09:37:46,0.06710648148148148,1,2,1,3
2023-07-05 11:44:31,0.19148148148148147,1,3,3,6
2023-07-05 14:02:20,0.3076388888888889,5,23,6,29
2023-08-06 19:15:25,11.245335648148147,1,235,4,239
2023-07-13 15:47:30,8.946168981481481,9,10040,1228,11268
2023-08-29 08:09:46,55.61680555555556,19,714,344,1058
2023-07-04 19:47:58,0.1928125,3,7,11,18
2023-07-07 18:52:22,10.187476851851851,28,10871,3299,14170
2023-07-04 16:06:05,0.1066087962962963,2,280,276,556
2023-07-03 17:18:49,0.043368055555555556,1,6,1,7
2023-07-04 15:03:27,1.1301851851851852,2,28,119,147
2023-07-03 15:08:21,0.17630787037037038,1,3,1,4
2023-07-03 10:24:47,0.12703703703703703,1,2,2,4
2023-07-25 12:32:42,22.4059375,83,33768,12302,46070
2023-08-09 16:27:27,40.034189814814816,4,145,38,183
2023-07-11 13:02:21,9.409849537037037,59,4568,1266,5834
2023-07-04 00:51:43,2.2254745370370372,4,2655,20,2675
2023-07-13 11:36:17,11.744166666666667,8,12020,990,13010
2023-07-05 16:25:36,4.569224537037037,1,34,34,68
2023-07-04 23:03:14,4.1412962962962965,3,8,6,14
2023-07-10 21:49:31,10.244699074074074,1,2,1,3
2023-06-30 18:56:56,0.1947685185185185,8,3154,3095,6249
2023-06-30 22:04:04,0.36018518518518516,2,3,3,6
2023-06-30 15:30:34,0.09061342592592593,6,146,164,310
2023-07-03 14:21:22,3.0707407407407405,3,3,3,6
2023-06-30 14:54:54,0.19586805555555556,3,25,25,50
2023-07-06 09:33:25,6.014571759259259,5,35,51,86
2023-06-30 11:11:58,0.08107638888888889,2,3,3,6
2023-07-20 10:19:37,20.088159722222223,3,496,14,510
2023-12-07 06:05:00,183.4087847222222,91,65774,9333,75107
2023-06-30 18:27:27,0.5873495370370371,3,19,19,38
2023-06-29 18:17:35,0.16474537037037038,23,59,59,118
2023-07-17 11:04:10,37.12488425925926,5,972,222,1194
2023-06-29 18:37:45,0.1652199074074074,2,5,1,6
2023-06-29 14:55:21,0.028564814814814814,4,20,20,40
2023-06-29 12:14:44,0.00011574074074074075,1,5,5,10
2023-06-29 15:50:00,0.25167824074074074,7,108,4,112
2023-06-29 12:13:20,0.07702546296296296,1,9,9,18
2023-06-29 12:05:20,0.07331018518518519,2,6,6,12
2023-06-29 14:09:52,2.9784953703703705,2,145,761,906
2023-06-29 14:05:24,0.3974421296296296,2,346,0,346
2023-06-30 05:00:44,1.1271412037037036,12,67,21,88
2023-07-04 15:05:12,7.576319444444445,11,10804,3168,13972
2023-06-28 21:54:21,0.029050925925925924,1,0,1,1
2023-06-29 12:04:07,0.6291550925925926,1,1,1,2
2023-06-28 18:11:02,0.02079861111111111,1,10,10,20
2023-06-28 17:44:31,0.07164351851851852,3,30,2,32
2023-06-28 17:06:31,0.30699074074074073,2,13,24,37
2023-06-28 16:17:27,0.03215277777777778,1,14,0,14
2023-06-28 16:01:41,0.028796296296296296,5,8,8,16
2023-06-29 09:17:37,1.60625,6,893,874,1767
2023-07-20 14:13:14,28.184189814814815,21,109338,94205,203543
2023-06-28 14:36:17,0.035798611111111114,2,7,7,14
2023-06-28 14:36:57,0.09807870370370371,3,40,16,56
2023-06-28 16:02:14,0.23777777777777778,1,19,3,22
2023-06-28 12:01:22,0.2562847222222222,2,3,3,6
2023-06-28 01:35:15,0.008900462962962962,1,11,7,18
2023-06-27 19:34:36,0.023229166666666665,1,21,14,35
2023-06-27 19:38:14,0.05413194444444445,2,5,5,10
2023-06-29 08:17:27,1.675,2,4,4,8
2023-07-04 21:58:32,7.252893518518518,2,3,1,4
2023-06-27 15:41:56,0.010381944444444444,1,1,1,2
2023-06-27 17:21:19,0.08112268518518519,2,2,2,4
2023-07-11 12:36:32,13.918402777777779,82,2542,443,2985
2023-06-27 17:28:26,0.18875,2,2,2,4
2023-06-27 14:09:38,0.05403935185185185,1,1,0,1
2023-06-27 13:12:15,0.1799074074074074,2,14,9,23
2023-07-10 09:50:43,13.13076388888889,16,24464,5629,30093
2023-06-30 12:19:39,3.980138888888889,6,351,212,563
2023-06-27 18:45:41,10.935752314814815,15,355,1175,1530
2023-06-28 03:55:32,5.659166666666667,5,129,83,212
2023-06-26 18:26:09,0.03173611111111111,2,2,2,4
2023-06-26 17:43:07,0.022546296296296297,1,8,5,13
2023-06-28 12:54:37,1.9207060185185185,2,3,3,6
2023-07-11 19:43:02,15.291921296296296,2,8,3,11
2023-06-26 12:37:13,0.11681712962962963,2,5,3,8
2023-06-26 12:15:38,0.08747685185185185,3,10,6,16
2023-06-26 16:36:28,0.2827314814814815,5,19,10,29
2023-06-26 09:50:10,0.027256944444444445,1,1,0,1
2023-06-26 16:36:47,0.32002314814814814,6,274,153,427
2023-06-27 12:14:18,1.1634490740740742,2,6,2,8
2023-06-26 12:42:39,0.18461805555555555,1,1,1,2
2023-07-03 08:07:25,7.027685185185185,3,21,7,28
2023-06-27 14:07:06,35.80722222222222,13,481,38,519
2023-07-03 05:38:22,12.745752314814816,85,208827,186715,395542
2023-06-26 12:07:28,0.706087962962963,1,1,1,2
2023-06-27 12:33:22,2.2206712962962962,1,9,4,13
2023-06-27 09:46:39,2.688009259259259,2,11,4,15
2023-06-27 10:48:23,3.039270833333333,1,9,9,18
2023-06-26 09:59:08,2.4182175925925926,1,4,1,5
2023-06-26 09:59:43,2.6434953703703705,1,3,3,6
2023-06-23 18:09:34,0.12799768518518517,6,25,44,69
2023-06-23 12:33:57,0.09185185185185185,1,1,1,2
2023-06-23 11:35:05,0.06972222222222223,2,5,4,9
2023-06-23 13:00:53,0.16918981481481482,1,4,0,4
2023-06-23 12:21:08,0.34260416666666665,1,1,1,2
2023-06-23 00:38:54,0.08199074074074074,1,4,2,6
2023-06-27 12:18:42,4.847013888888889,4,84,20,104
2023-06-23 12:17:21,0.6426504629629629,5,109,142,251
2023-06-22 18:46:20,0.05337962962962963,1,3,1,4
2023-06-26 13:58:15,3.902037037037037,1,23,0,23
2023-06-23 12:27:50,0.2917476851851852,14,457,192,649
2023-06-22 14:49:14,0.017962962962962962,1,5,6,11
2023-06-22 21:16:35,0.5422569444444445,3,74,42,116
2023-06-22 14:38:02,0.1666087962962963,1,2,2,4
2023-06-22 14:11:27,0.2273148148148148,1,271,836,1107
2023-06-22 14:18:16,0.25175925925925924,1,2,2,4
2023-06-22 13:34:13,0.24862268518518518,1,17,1,18
2023-06-22 13:40:39,0.2824305555555556,5,97,92,189
2023-06-23 12:13:07,1.255787037037037,3,26,13,39
2023-06-27 09:43:11,5.763495370370371,8,1787,505,2292
2023-06-22 13:06:16,0.9942245370370371,10,74,81,155
2023-06-21 15:19:43,0.05832175925925926,1,6,14,20
2023-06-21 15:51:27,0.08576388888888889,1,13,25,38
2023-06-21 15:31:58,0.20603009259259258,6,48,6,54
2023-06-21 10:36:34,0.06201388888888889,1,1,1,2
2023-06-21 09:12:39,0.05219907407407407,1,1,1,2
2023-06-26 11:58:36,5.174189814814815,10,5458,650,6108
2023-06-21 11:24:41,0.732037037037037,2,2,1,3
2023-06-21 00:34:20,0.0584837962962963,1,2,2,4
2023-06-21 00:21:13,0.10172453703703704,1,1,1,2
2023-06-22 18:28:25,1.914236111111111,7,276,177,453
2023-06-20 16:35:45,0.009212962962962963,1,8,1,9
2023-06-20 16:29:31,0.02744212962962963,3,6,4,10
2023-06-20 22:07:48,0.2697337962962963,7,90906,89095,180001
2023-06-20 15:54:55,0.029155092592592594,1,1,1,2
2023-06-20 16:07:34,0.13722222222222222,5,14,14,28
2023-06-20 16:22:00,0.30564814814814817,4,23,16,39
2023-06-20 17:18:52,0.36040509259259257,3,12,10,22
2023-06-20 12:43:10,0.9054976851851851,17,144,63,207
2023-06-20 13:01:18,0.8107986111111111,1,1,0,1
2023-06-20 11:59:22,0.931886574074074,9,30,9,39
2023-06-19 17:59:36,0.16693287037037038,3,19,14,33
2023-06-19 14:02:06,0.019386574074074073,1,1,0,1
2023-06-19 14:23:30,0.08200231481481482,1,2,2,4
2023-06-19 13:06:05,0.03297453703703704,2,4,4,8
2023-06-19 10:48:53,0.11909722222222222,2,3,3,6
2023-06-19 10:50:20,0.05296296296296296,1,2,0,2
2023-06-20 17:19:19,1.3310532407407407,3,10,2,12
2023-06-19 10:54:03,0.14679398148148148,1,10,0,10
2023-06-19 16:17:30,0.6290046296296297,2,14,7,21
2023-06-27 11:15:49,9.203090277777777,10,195136,180749,375885
2023-06-19 16:12:56,1.8023842592592592,1,1,1,2
2023-06-20 17:39:52,2.8818865740740742,7,224,74,298
2023-06-21 10:14:41,4.676643518518518,7,354,236,590
2023-06-19 11:51:25,1.8054398148148147,2,4,2,6
2023-06-20 16:26:08,3.490300925925926,2,45,2,47
2023-06-19 16:26:55,2.871064814814815,1,2,2,4
2023-06-16 19:14:03,0.04607638888888889,1,15,0,15
2023-06-20 11:49:06,3.807002314814815,1,8,3,11
2023-06-20 10:43:53,3.8682523148148147,3,18,17,35
2023-06-16 16:03:13,0.10206018518518518,5,23,21,44
2023-06-16 14:43:19,0.06599537037037037,1,2,1,3
2023-06-16 16:01:22,0.2563888888888889,3,15,14,29
2023-06-19 13:49:01,3.5897800925925925,5,103,25,128
2023-06-16 14:55:43,2.813738425925926,7,99,23,122
2023-06-15 17:01:12,0.04383101851851852,1,1,1,2
2023-06-21 17:24:12,6.110335648148149,19,494,221,715
2023-06-23 09:01:37,7.821701388888889,9,109,1,110
2023-06-15 14:45:50,0.11034722222222222,1,1,1,2
2023-06-16 13:43:44,1.0683796296296297,7,44,304,348
2023-06-16 13:40:34,1.0635069444444445,5,19382,4874,24256
2023-06-15 16:31:39,0.1882175925925926,1,9,6,15
2023-06-15 13:17:09,0.06753472222222222,2,5,4,9
2023-06-26 17:38:29,11.275358796296297,1,1,1,2
2023-06-15 13:36:19,0.15480324074074073,3,31,5,36
2023-06-15 11:33:37,0.10309027777777778,1,1,1,2
2023-06-15 12:29:33,0.15439814814814815,5,49,9,58
2023-06-15 15:48:02,0.7847569444444444,3,4,4,8
2023-06-15 15:31:48,0.8198032407407407,1,1,1,2
2023-06-15 11:30:24,0.6831828703703704,1,2663,2478,5141
2023-06-16 14:40:49,2.0421064814814813,19,77,226,303
2023-06-14 23:10:27,0.30234953703703704,15,3980,266,4246
2023-06-14 16:44:10,0.09935185185185186,2,16,47,63
2023-06-14 14:06:32,0.02417824074074074,1,23,3,26
2023-06-20 11:57:08,6.01394675925926,3,35,11,46
2023-06-14 10:08:32,789.1809143518518,7,1000697,138426,1139123
2023-06-14 15:05:41,0.25581018518518517,3,53,10,63
2023-06-14 12:25:24,0.18307870370370372,1,11,0,11
2023-06-15 08:41:57,1.1000578703703703,3,11,8,19
2023-06-27 17:33:56,13.95744212962963,1,2,5,7
2023-06-13 18:33:27,0.04790509259259259,2,17,2,19
2023-06-13 17:57:51,0.033541666666666664,3,5,3,8
2023-06-13 17:19:41,0.08325231481481482,6,24,3,27
2023-06-13 19:01:06,0.15645833333333334,5,160,10,170
2023-06-13 19:19:16,0.1965625,3,47,25,72
2023-06-21 15:05:00,8.057893518518519,15,100843,94116,194959
2023-06-13 13:28:08,0.06319444444444444,1,25,12,37
2023-06-13 14:18:36,0.11140046296296297,1,20,27,47
2023-06-13 16:59:21,0.2397337962962963,3,32,6,38
2023-06-13 16:46:05,0.23021990740740741,2,7,7,14
2023-06-14 14:02:36,1.1914930555555556,2,52,9,61
2023-06-13 13:07:00,0.16408564814814816,1,5,0,5
2023-06-15 09:39:21,2.0601736111111113,11,36,85,121
2023-06-14 10:23:56,1.1462037037037036,2,3,2,5
2023-06-15 10:39:33,2.223171296296296,2,0,10,10
2023-06-15 10:28:48,2.265324074074074,3,8,6,14
2023-06-13 15:38:40,3.655335648148148,7,257,24,281
2023-06-12 19:27:11,0.024189814814814813,1,3,2,5
2023-06-14 16:24:53,2.1794560185185183,14,50,32,82
2023-06-12 16:14:15,0.020023148148148148,2,12,2,14
2023-06-12 16:18:05,0.024016203703703703,5,48,46,94
2023-06-12 17:26:18,0.08575231481481481,2,115,316,431
2023-06-12 15:31:07,0.04293981481481481,1,0,1,1
2023-06-13 12:28:15,0.9296875,1,2,1,3
2023-06-12 15:06:21,0.051875,4,26,12,38
2023-06-12 15:49:56,0.09804398148148148,2,43,18,61
2023-06-12 13:21:27,0.04372685185185185,1,5,1,6
2023-06-12 13:37:13,0.12854166666666667,3,7,7,14
2023-06-12 09:39:05,0.02634259259259259,1,13,0,13
2023-06-12 17:10:32,0.37744212962962964,1,1,1,2
2023-06-12 12:51:10,0.1995486111111111,1,0,1,1
2023-06-12 14:43:58,0.4596527777777778,2,4,4,8
2023-06-15 12:50:41,3.4327430555555556,2,2,2,4
2023-06-12 13:10:49,0.7977662037037037,1,4,0,4
2023-06-19 10:43:58,8.926087962962963,2,51,51,102
2023-06-10 04:53:12,0.24516203703703704,1,0,0,0
2023-06-13 18:04:22,4.058506944444445,12,77,91,168
2023-06-09 16:27:46,0.06702546296296297,1,1,1,2
2023-06-09 15:59:44,0.10159722222222223,1,2,2,4
2023-06-09 14:22:10,0.04415509259259259,2,4,2,6
2023-06-10 07:47:38,0.8754282407407408,2,13,4,17
2023-06-09 12:11:01,0.038738425925925926,1,2,2,4
2023-06-09 11:41:14,0.052662037037037035,2,33,0,33
2023-06-13 17:23:30,4.307650462962963,8,694,44,738
2023-06-09 12:24:54,0.13181712962962963,4,13,3,16
2023-06-09 14:30:21,0.30765046296296295,2,16,6,22
2023-06-09 11:32:17,0.38666666666666666,1,1,1,2
2023-06-09 13:07:09,0.6866550925925926,1,13,0,13
2023-06-09 14:49:03,0.7681597222222222,3,46,3,49
2023-06-09 13:21:00,0.7231597222222222,1,13,0,13
2023-06-09 13:03:11,0.7291666666666666,1,6,0,6
2023-07-20 17:46:53,43.93900462962963,117,138050,104358,242408
2023-06-13 14:04:28,38.089560185185185,18,104,104,208
2023-06-08 14:21:42,0.012546296296296297,2,9,5,14
2023-06-09 12:20:05,0.9500115740740741,2,11,6,17
2023-06-08 14:11:02,0.025729166666666668,1,2,2,4
2023-06-29 13:49:00,21.019224537037037,154,14125,4618,18743
2023-06-19 10:34:21,10.889664351851852,1,1,1,2
2023-06-08 13:19:08,0.02542824074074074,1,5,0,5
2023-06-08 16:21:09,0.20655092592592592,2,13,0,13
2023-06-20 15:01:57,12.18,1,157,4,161
2023-06-08 13:38:31,0.26034722222222223,4,27,13,40
2023-06-12 12:56:49,4.26974537037037,5,234,155,389
2023-06-08 15:13:58,0.4429050925925926,2,59,5,64
2023-06-08 14:14:28,0.6639351851851852,2,5,5,10
2023-06-09 14:31:58,1.7620023148148147,2,4,4,8
2023-06-28 05:22:39,20.49931712962963,10,163,191,354
2023-06-07 20:21:51,0.20190972222222223,7,18,18,36
2023-06-07 19:31:33,0.08483796296296296,7,3,4,7
2023-07-17 16:53:25,41.102094907407405,182,20598,10354,30952
2023-09-01 09:50:07,86.81002314814815,145,30497,13681,44178
2023-06-07 15:55:48,0.005405092592592592,1,1,1,2
2023-06-16 14:38:24,8.977048611111112,7,20,95,115
2023-06-07 15:33:40,0.009664351851851851,1,36,6,42
2023-06-07 15:38:57,0.07704861111111111,2,16,5,21
2023-06-07 14:18:13,0.04041666666666666,2,2,1,3
2023-06-07 13:07:34,0.015324074074074073,1,4,1,5
2023-06-07 12:30:55,0.028171296296296295,2,10,3,13
2023-06-07 15:23:07,0.20881944444444445,6,28,39,67
2023-06-07 16:38:05,0.3291203703703704,3,2,1,3
2023-06-07 11:27:07,0.5450810185185185,2,5,6,11
2023-06-07 20:34:54,1.1077199074074073,3,138,6,144
2023-06-06 17:35:25,0.014328703703703703,1,6,0,6
2023-06-06 17:30:19,0.012280092592592592,1,1,1,2
2023-06-06 17:04:39,0.028055555555555556,1,14,12,26
2023-06-06 16:17:43,0.007395833333333333,1,1,1,2
2023-06-06 16:02:56,0.014780092592592593,1,38,0,38
2023-06-06 15:31:05,0.022037037037037036,1,2,0,2
2023-06-06 17:29:57,0.15056712962962962,3,19,9,28
2023-06-08 12:54:57,1.9592476851851852,1,2,2,4
2023-06-07 13:27:47,1.1297916666666667,4,1992,386,2378
2023-06-09 07:36:19,2.937777777777778,4,10414,1126,11540
2023-06-07 11:29:19,1.2828125,2,7,2,9
2023-06-06 13:51:45,0.5623958333333333,1,3,3,6
2023-06-21 10:42:21,15.537766203703704,3,3645,874,4519
2023-06-09 17:34:08,3.8388078703703705,7,655,149,804
2023-06-06 17:34:58,0.9140856481481482,3,43,15,58
2023-06-06 13:12:46,0.7375694444444445,5,35,23,58
2023-06-12 15:23:37,6.887384259259259,4,101,319,420
2023-06-06 18:31:00,1.0805324074074074,2,7,3,10
2023-06-05 18:00:28,0.09090277777777778,1,1,1,2
2023-06-06 13:26:10,0.9141087962962963,1,2,0,2
2023-06-05 15:08:15,0.05607638888888889,1,2,33,35
2023-06-08 16:19:08,1.4021412037037038,3,12,10,22
2023-06-05 16:12:46,0.14516203703703703,3,8,8,16
2023-06-05 14:29:33,0.08172453703703704,3,8,3,11
2023-07-18 14:34:07,49.06056712962963,25,2338,748,3086
2023-06-07 19:33:14,2.394710648148148,4,2448,504,2952
2023-06-05 12:28:10,0.17327546296296295,2,30,26,56
2023-06-05 15:53:45,0.8262847222222223,1,0,3,3
2023-06-05 11:10:31,1.9944328703703704,1,2,2,4
2023-06-12 15:07:15,9.2959375,6,8171,1385,9556
2023-06-05 15:47:30,2.3563657407407406,2,5,5,10
2023-06-06 13:08:28,3.4109375,6,535,122,657
2023-06-06 13:08:46,3.4244560185185184,4,63,26,89
2023-06-05 15:10:47,2.726354166666667,2,23250,9731,32981
2023-06-02 20:23:45,0.007997685185185186,1,1,1,2
2023-07-24 12:57:25,53.80140046296296,13,774,762,1536
2023-06-07 13:13:02,4.922905092592592,1,1,2,3
2023-06-06 18:31:15,5.0212615740740745,11,7236,616,7852
2023-06-02 10:35:55,0.01125,1,2,0,2
2023-06-22 12:48:49,20.109502314814815,2,10,3,13
2023-06-02 12:53:49,0.16547453703703704,1,4,1,5
2023-06-02 14:27:00,0.8765162037037038,2,2469,299,2768
2023-06-01 20:10:53,0.1408912037037037,2,5,2,7
2023-06-01 15:58:11,0.0011226851851851851,1,1,1,2
2023-06-01 20:10:25,0.21770833333333334,1,96,63,159
2023-06-01 14:54:50,0.001851851851851852,1,1,1,2
2023-06-01 15:15:01,0.028530092592592593,1,1,1,2
2023-06-01 14:54:01,0.019282407407407408,1,2,2,4
2023-06-02 14:28:53,1.0122222222222221,4,57,34,91
2023-06-01 14:25:44,0.01810185185185185,1,2,2,4
2023-06-01 13:07:58,0.17769675925925926,1,6,0,6
2023-06-01 14:10:16,0.32796296296296296,1,2,2,4
2023-06-01 17:21:23,0.7844097222222223,11,120,79,199
2023-05-31 19:31:29,0.028449074074074075,1,22,0,22
2023-05-31 19:32:22,0.047997685185185185,1,19,1,20
2023-05-31 18:10:14,0.020011574074074074,1,39,33,72
2023-05-31 17:34:55,0.049930555555555554,1,0,13,13
2023-05-31 16:02:06,0.014664351851851852,4,25,13,38
2023-05-31 17:44:27,0.09762731481481482,4,5,7,12
2023-05-31 15:30:40,0.017638888888888888,2,2,2,4
2023-05-31 15:36:56,0.022569444444444444,1,7,0,7
2023-09-18 18:28:37,108.18231481481482,250,549419,463275,1012694
2023-06-01 12:36:45,0.9158333333333334,1,4,3,7
2023-05-31 14:49:43,0.03436342592592593,2,7,7,14
2023-05-31 13:47:47,0.03549768518518519,2,4,4,8
2023-05-31 15:40:23,0.11947916666666666,2,9,5,14
2023-06-15 12:09:31,15.796331018518519,2,4,5,9
2023-05-31 14:40:08,0.22523148148148148,3,67,41,108
2023-05-31 11:39:51,0.18756944444444446,1,1,0,1
2023-05-31 09:32:28,0.19337962962962962,2,1,2,3
2023-06-12 12:59:18,12.485243055555555,4,19574,8976,28550
2023-05-31 16:01:54,0.8451157407407407,1,7,0,7
2023-05-31 13:42:30,0.8309837962962963,8,66,49,115
2023-05-30 17:26:38,0.027430555555555555,4,20,16,36
2023-05-30 14:53:40,0.03570601851851852,1,4,4,8
2023-05-30 14:23:21,0.018020833333333333,1,1,1,2
2023-05-30 15:12:14,0.07158564814814815,4,768,10,778
2023-06-02 16:32:34,3.3036226851851853,2,4,1,5
2023-05-30 18:36:19,0.3995023148148148,1,1,0,1
2023-05-30 14:50:42,0.2680787037037037,7,3196,48,3244
2023-07-03 06:50:28,35.01498842592593,5,244,109,353
2023-06-05 16:02:04,10.176226851851851,7,1111,820,1931
2023-05-30 12:08:45,0.9136689814814815,1,11,10,21
2023-05-31 08:24:00,3.321597222222222,3,117,53,170
2023-06-02 09:30:25,5.9030555555555555,29,8693,976,9669
2023-05-26 19:09:06,0.01425925925925926,3,3,2,5
2023-05-26 19:51:16,0.053020833333333336,2,32,4,36
2023-05-31 09:38:21,4.6511458333333335,1,4,4,8
2023-05-31 14:52:35,5.025393518518518,2,12,2,14
2023-05-26 14:47:52,-0.34662037037037036,1,3,1,4
2023-05-31 11:54:26,4.932141203703703,1,6,6,12
2023-05-26 12:30:33,0.15184027777777778,2,198,60,258
2023-05-26 12:36:33,0.19758101851851853,1,1,1,2
2023-05-26 18:24:58,0.5437615740740741,3,6,5,11
2023-06-05 15:19:59,10.715509259259258,1,4,2,6
2023-05-26 12:33:17,0.6505555555555556,1,3,6,9
2023-05-25 20:16:13,0.1012962962962963,1,1,1,2
2023-05-25 20:16:01,0.10304398148148149,1,1,1,2
2023-06-06 17:30:53,12.102511574074073,17,264,243,507
2023-05-30 14:08:08,4.9679166666666665,7,107,30,137
2023-05-25 20:37:33,0.24484953703703705,1,1,1,2
2023-05-30 13:06:59,5.031099537037037,3,15,15,30
2023-05-25 20:10:25,0.3559375,4,20,11,31
2023-05-25 13:38:09,0.07310185185185185,1,4,3,7
2023-05-25 14:06:14,0.20981481481481482,3,26194,10595,36789
2023-05-25 11:48:49,0.31157407407407406,1,1,1,2
2023-05-30 10:05:58,5.719293981481481,3,3,3,6
2023-05-24 20:19:45,0.1749189814814815,1,2,53,55
2023-05-25 13:38:22,0.9204513888888889,5,176,44,220
2023-05-24 16:31:26,0.055324074074074074,1,2,2,4
2023-05-24 15:20:50,0.031099537037037037,1,0,3,3
2023-05-24 14:59:03,0.035833333333333335,8,8,8,16
2023-05-24 19:40:19,0.8905787037037037,4,135,6,141
2023-05-24 15:34:21,0.7222916666666667,1,4,3,7
2023-05-31 16:12:27,8.00912037037037,1,77,62,139
2023-05-23 18:47:47,0.11782407407407407,1,1,0,1
2023-05-23 16:25:44,0.020474537037037038,1,8,0,8
2023-05-23 15:32:57,0.01976851851851852,1,2,1,3
2023-05-23 18:50:40,0.2081712962962963,4,77,53,130
2023-06-01 17:17:27,9.159490740740742,12,67188,62668,129856
2023-05-23 15:36:50,0.23171296296296295,2,9,3,12
2023-05-24 12:47:44,1.1200578703703703,2,8,11,19
2023-05-23 12:48:38,0.11646990740740741,1,4,4,8
2023-05-24 19:51:09,2.0335300925925925,4,12,6,18
2023-05-23 09:28:09,0.2503009259259259,1,1,1,2
2023-05-23 09:31:30,0.001851851851851852,1,1,1,2
2023-05-23 09:31:55,0.0021527777777777778,1,1,1,2
2023-05-22 18:49:32,0.006261574074074074,1,115,98,213
2023-05-23 15:42:11,0.8817939814814815,5,147,49,196
2023-05-24 20:09:13,2.1204976851851853,3,63,177,240
2023-05-23 09:43:12,0.7574884259259259,5,51,20,71
2023-05-22 19:26:52,0.16967592592592592,2,44,4,48
2023-05-22 15:22:54,0.05453703703703704,2,4,3,7
2023-05-22 17:42:35,0.16899305555555555,3,99,105,204
2023-06-14 16:57:24,23.15454861111111,139,10553,8827,19380
2023-05-22 13:39:47,0.08450231481481481,3,10,2,12
2023-05-22 13:28:26,0.2899305555555556,1,1,1,2
2023-06-13 09:42:44,22.366377314814816,5,21050,9640,30690
2023-05-23 11:57:59,1.9124421296296297,6,15,13,28
2023-05-23 13:54:40,2.3547569444444445,1,147,2,149
2023-05-22 13:30:46,1.9094444444444445,2,16,8,24
2023-05-22 16:20:39,1.9895138888888888,2,4,10,14
2023-05-20 04:53:11,0.008449074074074074,1,3,3,6
2023-05-25 13:35:11,5.500173611111111,1,6,0,6
2023-05-22 16:58:55,2.7453935185185183,1,2,2,4
2023-05-24 10:52:45,15.766712962962963,66,22350,5946,28296
2023-05-19 18:31:56,0.06837962962962962,1,14,1,15
2023-05-24 12:52:53,4.853229166666667,9,2913,2627,5540
2023-05-19 16:50:11,0.04939814814814815,3,7,7,14
2023-05-19 14:36:15,0.016261574074074074,1,18,0,18
2023-05-19 16:48:35,0.1529513888888889,1,1,1,2
2023-05-19 14:12:25,0.1350347222222222,2,7,2,9
2023-05-19 20:10:19,0.44039351851851855,3,31,7,38
2023-05-19 15:50:07,0.3044560185185185,2,4,1,5
2023-06-26 09:23:58,5.095752314814815,7,7207,3803,11010
2023-06-13 16:51:37,25.849895833333335,5,89,424,513
2023-06-14 13:39:02,26.884085648148147,7,146,131,277
2023-05-18 18:14:43,0.014583333333333334,1,9,11,20
2023-05-18 18:06:50,0.02515046296296296,1,17,7,24
2023-05-24 12:57:52,5.90269675925926,1,6,6,12
2023-05-18 16:17:17,0.036145833333333335,5,8,3,11
2023-05-18 15:28:23,0.07041666666666667,2,54,43,97
2023-05-18 13:07:11,0.03898148148148148,1,2,2,4
2023-06-07 10:56:57,19.98457175925926,1,1,2,3
2023-05-18 15:29:05,0.8135069444444445,8,194,19,213
2023-06-23 12:50:38,36.17603009259259,9,57,15,72
2023-05-18 12:54:23,0.18435185185185185,1,5,1,6
2023-05-23 18:50:28,5.453414351851852,1,27,8,35
2023-05-18 15:14:25,0.31824074074074077,5,25,15,40
2023-05-18 17:14:28,0.8032175925925926,3,7,1,8
2024-01-03 18:01:06,230.84429398148148,56,15593,11469,27062
2023-05-18 15:09:56,0.7819097222222222,2,132,4,136
2023-05-18 10:04:52,0.6507638888888889,2,65,3,68
2023-05-18 13:46:40,0.8328240740740741,4,25,27,52
2023-05-17 17:48:19,0.031203703703703702,1,1,1,2
2023-05-24 12:13:24,6.829270833333333,7,203,526,729
2023-05-18 10:34:34,0.7547569444444444,1,0,1,1
2023-05-17 17:08:12,0.04853009259259259,1,2,2,4
2023-05-17 16:14:30,0.019282407407407408,3,20,20,40
2023-05-18 12:52:17,0.8957060185185185,1,305,2,307
2023-05-18 18:22:30,1.2366666666666666,3,22,27,49
2023-05-17 15:07:37,0.004722222222222222,1,15,2,17
2023-05-17 16:04:52,0.10060185185185185,1,123,606,729
2023-05-17 16:42:56,0.19267361111111111,1,16,1,17
2023-05-17 13:00:08,0.4260069444444444,1,1,1,2
2023-05-17 08:43:02,0.25702546296296297,1,1,1,2
2023-05-19 11:41:51,2.5879166666666666,1,12,10,22
2023-05-17 10:25:29,0.5279976851851852,1,1,2,3
2023-05-16 19:18:32,0.016631944444444446,1,1,1,2
2023-05-19 16:44:25,3.004097222222222,6,16,13,29
2023-05-23 07:27:37,6.651481481481482,1,5,1,6
2023-05-16 17:10:43,0.06288194444444445,3,3,2,5
2023-05-17 12:26:50,0.8672569444444445,4,31,7,38
2023-05-16 18:23:11,0.13604166666666667,3,76,26,102
2023-05-16 18:28:20,0.14430555555555555,3,88,5,93
2023-05-16 21:35:12,0.3111921296296296,1,1,1,2
2023-05-16 13:59:19,0.035486111111111114,1,9,0,9
2023-05-16 14:12:22,0.04666666666666667,1,2,2,4
2023-05-16 17:54:35,0.20793981481481483,1,2,5,7
2023-05-19 09:03:08,2.9227314814814815,2,2,2,4
2023-05-16 10:14:55,0.017939814814814815,1,1,1,2
2023-05-16 12:49:25,0.14130787037037038,3,10,5,15
2023-05-16 21:29:03,0.6041782407407408,3,90,21,111
2023-05-22 09:53:14,6.392164351851852,2,4,2,6
2023-05-16 17:21:42,0.9207523148148148,4,21,12,33
2023-05-17 12:27:44,1.8318287037037038,3,4,4,8
2023-05-15 14:46:58,0.01269675925925926,1,4,0,4
2023-05-17 15:16:03,2.04806712962963,1,2,2,4
2023-05-16 10:10:54,0.8717939814814815,2,2,2,4
2023-05-15 12:28:37,0.015,1,3,16,19
2023-05-15 12:17:09,0.01693287037037037,1,2,2,4
2023-05-15 12:15:43,0.027939814814814813,1,1,1,2
2023-05-15 12:31:53,0.0893287037037037,1,1,1,2
2023-05-15 12:08:45,0.08681712962962963,2,16,4,20
2023-05-16 13:55:44,1.2027199074074073,2,18,16,34
2023-05-15 09:38:44,0.05569444444444444,2,5,4,9
2023-05-22 19:45:50,10.039224537037038,10,221,102,323
2023-05-15 11:04:16,0.30516203703703704,1,1,1,2
2023-05-16 19:14:12,1.6631018518518519,1,1,4,5
2023-05-16 09:54:20,1.8466087962962963,9,62,65,127
2023-05-15 09:35:55,2.4656712962962963,1,0,1,1
2024-04-19 17:31:44,342.9082175925926,111,2152,928,3080
2023-05-12 19:58:15,0.19489583333333332,2,3,3,6
2023-05-16 13:18:59,3.964814814814815,1,2,2,4
2023-05-12 13:35:37,0.03582175925925926,1,7,8,15
2023-05-12 14:35:15,0.19011574074074075,3,18,5,23
2023-05-12 10:11:21,0.018275462962962962,1,0,2,2
2023-05-12 11:37:38,0.12184027777777778,1,1,5,6
2023-05-16 19:46:54,0.03914351851851852,1,2,0,2
2023-05-17 13:05:08,5.3593981481481485,1,20,13,33
2023-07-17 12:51:20,66.36333333333333,4,31,4,35
2023-05-24 12:48:32,12.396122685185185,1,1,1,2
2023-05-12 15:29:14,0.7893402777777778,1,5,5,10
2023-05-15 16:22:10,3.8792824074074073,1,5,5,10
2023-05-23 18:37:35,11.996967592592593,5,8529,1727,10256
2023-05-11 19:31:59,0.01678240740740741,1,14,22,36
2023-05-11 18:38:12,0.004618055555555556,1,2,2,4
2023-05-11 18:31:28,0.007789351851851852,1,1,1,2
2023-05-11 17:26:49,0.058854166666666666,1,2,0,2
2023-05-11 18:25:52,0.12430555555555556,2,27,3,30
2023-05-11 18:13:05,0.1235300925925926,1,3,1,4
2023-05-11 18:26:20,0.1417824074074074,1,11,11,22
2023-05-12 15:47:40,1.136261574074074,1,4,4,8
2023-05-11 19:28:09,0.3268402777777778,5,23,25,48
2023-05-11 12:50:04,0.08568287037037037,1,1,1,2
2023-05-24 09:57:56,12.986527777777777,1,55,42,97
2023-05-11 12:54:02,0.1178587962962963,1,2,2,4
2023-05-11 10:43:19,0.052037037037037034,1,8,0,8
2023-05-11 10:45:33,0.07157407407407407,1,1,1,2
2023-05-11 15:14:07,0.30819444444444444,8,91,29,120
2023-05-11 10:12:13,0.6583101851851851,1,1,1,2
2023-05-10 19:10:06,0.03753472222222222,1,0,99,99
2023-05-10 19:09:57,0.040462962962962964,1,1,1,2
2023-05-12 18:29:50,2.043391203703704,3,102,67,169
2023-05-10 20:00:49,0.1406712962962963,4,461,371,832
2023-05-16 12:59:54,5.88462962962963,3,51,31,82
2023-05-10 15:58:21,0.02451388888888889,7,27,24,51
2023-05-11 12:54:23,0.9031828703703704,4,6,6,12
2023-05-10 15:13:43,0.005069444444444444,1,1,3,4
2023-05-10 15:03:53,0.021886574074074076,2,45,47,92
2023-05-10 13:36:16,0.007222222222222222,2,5,6,11
2023-05-10 14:21:09,0.04640046296296296,2,4,4,8
2023-05-10 13:25:08,0.026412037037037036,2,3,2,5
2023-05-11 09:04:07,0.9037268518518519,2,8,0,8
2023-05-11 07:32:23,0.8551851851851852,4,11431,819,12250
2023-05-10 12:55:26,0.07862268518518518,10,403,130,533
2023-05-23 13:16:34,13.096412037037037,4,7,7,14
2023-05-09 20:58:40,0.06435185185185185,1,1,2,3
2023-05-09 19:26:15,0.0025578703703703705,1,178,287,465
2023-05-10 11:45:11,0.7051967592592593,1,1,1,2
2023-05-10 11:45:34,0.7770601851851852,1,2,2,4
2023-05-31 09:46:23,27.07008101851852,37,42835,12723,55558
2023-05-09 17:05:14,0.12045138888888889,10,119,57,176
2023-05-24 16:03:25,15.06730324074074,49,616,4485,5101
2023-05-09 14:51:43,0.035659722222222225,1,136,0,136
2023-05-09 13:19:38,0.1615162037037037,1,1,1,2
2023-05-09 13:20:11,0.2573958333333333,1,3,3,6
2023-05-09 12:58:21,0.249375,1,5,3,8
2023-05-22 16:57:45,13.558773148148148,12,60,38,98
2023-05-08 22:36:23,0.04576388888888889,3,6,6,12
2023-05-24 10:53:28,15.767210648148149,5,18499,2675,21174
2023-05-08 18:56:42,0.020127314814814813,1,2,2,4
2023-05-10 00:37:57,5.365081018518518,250,12460,5612,18072
2023-05-09 17:04:28,1.0905671296296295,4,36,5,41
2023-06-21 15:48:22,44.11975694444445,37,815,384,1199
2023-05-08 13:47:08,0.0428125,1,2,2,4
2023-05-07 23:06:25,0.2185763888888889,2,3,3,6
2023-05-07 22:52:44,0.43841435185185185,2,2,2,4
2023-09-14 17:02:37,127.23989583333334,120,216621,127525,344146
2023-05-08 09:45:40,1.7369560185185184,2,15,5,20
2023-05-05 17:23:47,15.416168981481482,6,400,12,412
2023-05-31 09:12:08,27.046296296296298,15,30789,11323,42112
2023-05-05 15:36:15,0.1610763888888889,1,2,2,4
2023-05-30 13:49:48,28.94849537037037,5,275,81,356
2023-06-02 11:43:55,28.039675925925927,3,33023,10880,43903
2023-05-11 17:52:23,6.294027777777778,11,11504,1434,12938
2023-05-31 13:59:31,26.190543981481483,16,70,57,127
2023-05-06 15:41:08,1.3228703703703704,1,22,14,36
2023-05-31 08:40:47,27.024525462962963,13,30714,11316,42030
2023-05-08 11:35:04,3.485497685185185,1,1,1,2
2023-05-05 17:22:49,163.2820023148148,7,794,23,817
2023-05-04 17:47:07,0.00015046296296296297,1,3,390,393
2023-05-19 17:14:17,15.017696759259259,4,20008,2527,22535
2023-05-31 08:12:49,27.005104166666666,11,30605,11196,41801
2023-05-04 13:58:38,0.08189814814814815,1,2,2,4
2023-05-31 06:57:52,26.953055555555554,8,30587,11174,41761
2023-05-04 14:31:19,0.16899305555555555,3,7,6,13
2023-05-04 13:56:45,0.4341087962962963,1,1,1,2
2023-05-04 13:56:28,0.4310185185185185,1,1,1,2
2023-05-05 15:29:20,1.5580092592592591,2,33,12,45
2023-05-05 15:52:20,1.7137152777777778,3,27,8,35
2023-05-04 17:36:23,0.8968981481481482,5,63,21,84
2023-05-03 19:50:42,0.08505787037037037,1,6,9,15
2023-05-03 17:04:49,0.015925925925925927,1,0,2,2
2023-05-12 16:06:16,9.060347222222223,4,23,20,43
2023-05-03 13:43:18,0.06258101851851852,3,17,14,31
2023-05-03 13:29:56,0.08484953703703704,1,2,4,6
2023-05-03 14:49:54,0.40175925925925926,3,93,46,139
2023-05-03 13:24:50,0.19086805555555555,3,5,8,13
2023-05-03 13:36:30,0.19832175925925927,1,2,1,3
2023-05-03 14:21:27,0.24,2,11,7,18
2023-05-03 09:21:59,0.04636574074074074,1,1,1,2
2023-05-03 02:02:39,0.027210648148148147,1,4,1,5
2023-05-03 13:53:00,0.8119675925925925,2,26,11,37
2023-05-03 15:04:59,1.0134837962962964,5,513,152,665
2023-05-04 13:57:32,1.997638888888889,4,934,262,1196
2023-05-02 15:20:03,0.09650462962962963,6,51,50,101
2023-05-02 13:35:57,0.03961805555555555,3,1523,177,1700
2023-05-04 17:17:13,2.960150462962963,12,737,172,909
2023-05-16 13:22:57,14.495034722222222,4,2646,678,3324
2023-05-03 16:47:37,1.2661689814814814,3,10,7,17
2023-05-03 16:32:42,3.918483796296296,5,3769,257,4026
2023-05-02 00:15:11,0.031145833333333334,1,1,1,2
2023-05-01 13:44:48,0.021296296296296296,3,31,15,46
2023-05-01 13:14:17,0.14663194444444444,1,1,1,2
2023-05-03 14:50:34,2.2557060185185187,6,22853,2586,25439
2023-05-01 12:54:57,0.5199537037037038,1,1,1,2
2023-05-01 13:36:42,0.7621064814814815,1,1,1,2
2023-05-02 13:32:42,1.991064814814815,1,3,1,4
2023-05-15 17:27:42,15.246377314814815,2,100,79,179
2023-05-02 12:22:31,2.7699305555555553,2,70,64,134
2023-05-02 00:11:57,4.340775462962963,1,142,2,144
2023-05-05 15:36:56,0.5478472222222223,3,537,76,613
2023-05-02 13:28:00,3.5274305555555556,6,299,114,413
2023-05-04 14:15:15,12.98818287037037,24,24102,2987,27089
2023-05-03 19:59:19,12.227118055555556,20,23509,2832,26341
2023-05-07 22:55:04,9.006585648148148,4,5378,826,6204
2023-04-29 09:53:30,0.666724537037037,4,79,92,171
2023-05-02 17:40:41,4.072534722222223,1,2,0,2
2023-04-28 13:24:29,1.9265856481481483,2,72,551,623
2023-05-01 13:50:06,5.251921296296296,6,647,105,752
2023-04-28 13:28:02,0.21917824074074074,1,2,2,4
2023-04-28 20:25:34,0.13677083333333334,3,55,19,74
2023-04-28 15:00:13,0.33274305555555556,1,15,1,16
2023-04-28 19:53:58,0.6253703703703704,2,8,4,12
2023-05-02 13:23:17,4.648125,1,2,0,2
2023-04-27 22:07:02,0.23248842592592592,2,8,8,16
2023-05-04 09:15:07,19.744814814814816,8,622,587,1209
2023-05-02 13:25:47,10.95383101851852,13,21656,2627,24283
2023-04-27 16:26:17,0.07247685185185185,10,171,67,238
2023-04-27 14:21:01,129.17775462962962,4,194195,26920,221115
2023-05-30 13:28:44,33.08417824074074,18,7714,1573,9287
2023-04-28 16:24:51,1.2685416666666667,2,0,4,4
2023-04-27 09:48:03,0.02556712962962963,1,1,1,2
2023-04-27 12:22:05,0.14825231481481482,2,3,2,5
2023-04-26 21:55:01,0.17346064814814816,1,1,1,2
2023-05-01 15:05:40,13.931516203703703,1,426,2,428
2023-04-26 15:44:13,0.031574074074074074,1,1,1,2
2023-04-28 13:17:31,1.9398958333333334,2,165,66,231
2023-04-27 12:06:12,0.9539930555555556,1,190,2,192
2023-04-26 16:45:06,12.165243055555555,9,16016,1536,17552
2023-04-26 16:29:25,0.2691087962962963,2,4,5,9
2023-04-27 15:08:26,1.277939814814815,6,147,22,169
2023-04-25 21:58:46,0.02445601851851852,1,1,1,2
2023-05-17 14:45:15,21.723391203703702,3,22116,3099,25215
2023-04-28 11:27:28,2.6886805555555555,3,15,4,19
2023-04-28 13:20:33,3.9035532407407407,6,303,75,378
2023-04-26 18:39:36,1.2107407407407407,1,3,3,6
2023-04-25 13:20:36,0.023773148148148147,1,1,1,2
2023-05-09 18:34:49,112.16204861111112,95,1083,974,2057
2023-04-25 12:00:28,0.06771990740740741,3,30,5,35
2023-04-25 12:56:22,0.19947916666666668,1,2,2,4
2023-05-19 13:14:14,27.04803240740741,49,4108,1212,5320
2023-04-25 07:52:19,0.6779976851851852,2,7,6,13
2023-04-24 16:02:05,0.034270833333333334,1,1,1,2
2023-04-25 07:59:17,0.7028009259259259,1,2,0,2
2023-04-24 19:19:06,0.19729166666666667,1,22,2,24
2023-04-24 16:25:14,0.14802083333333332,2,3,3,6
2023-04-26 17:13:21,2.2106481481481484,8,2223,196,2419
2023-04-24 13:31:51,4.0154861111111115,4,3620,280,3900
2023-04-24 12:00:30,0.015578703703703704,1,2,2,4
2023-05-30 13:27:40,36.08412037037037,14,35448,11849,47297
2023-04-24 12:05:56,0.038125,1,3,0,3
2023-04-26 16:19:17,2.2339930555555556,2,64,26,90
2023-04-24 13:27:31,0.1952662037037037,3,18,8,26
2023-04-24 18:54:56,5.379664351851852,4,211,116,327
2023-04-24 13:28:52,1.2666203703703705,1,2,2,4
2023-04-26 11:56:15,7.8377893518518515,8,651,95,746
2023-04-26 11:54:59,3.472939814814815,1,279,2,281
2023-04-24 13:27:50,1.6078819444444445,2,6,1,7
2024-03-04 17:49:02,358.1575578703704,159,273429,51316,324745
2023-05-02 17:07:31,10.138113425925926,1,3,2,5
2023-04-25 13:17:56,3.0695023148148146,2,66,66,132
2023-04-22 00:01:26,0.1552199074074074,1,2,0,2
2023-04-24 12:45:23,2.7972337962962963,13,126,26,152
2023-04-21 15:22:07,0.04086805555555555,2,41,41,82
2023-04-26 19:36:00,5.281342592592592,7,457,471,928
2023-04-21 19:41:18,0.2634837962962963,9,91,52,143
2023-04-21 13:53:25,0.05378472222222222,2,23,11,34
2023-04-24 13:27:04,3.049664351851852,10,59,57,116
2023-04-21 11:51:29,0.11465277777777778,2,18,7,25
2023-04-21 13:54:31,0.21747685185185187,3,17,11,28
2023-04-21 09:22:23,0.06832175925925926,1,1,1,2
2023-05-17 14:46:55,28.705578703703704,9,631,47,678
2023-04-21 08:22:55,0.013020833333333334,1,4,0,4
2023-04-21 14:04:45,0.29376157407407405,4,17,2,19
2023-04-21 09:19:15,0.11168981481481481,1,14,0,14
2023-04-27 16:10:03,6.416782407407408,20,19298,2098,21396
2023-04-21 18:36:36,0.6783680555555556,2,7,4,11
2023-04-21 09:23:16,0.5528240740740741,1,1,1,2
2023-04-20 18:24:00,1.0076273148148147,17,5386,842,6228
2023-04-20 18:49:47,0.03822916666666667,1,4,0,4
2023-04-20 16:30:15,0.039247685185185184,3,4,4,8
2023-04-21 13:16:45,0.9145601851851852,5,34,43,77
2023-04-21 13:38:33,0.937974537037037,2,5691,636,6327
2023-04-21 15:10:10,1.0093287037037038,3,18,23,41
2023-04-20 12:11:18,0.012418981481481482,1,2,2,4
2023-04-20 12:08:04,0.07353009259259259,2,11,14,25
2023-04-21 14:23:54,1.1905439814814816,3,7,3,10
2023-04-20 10:22:42,0.04497685185185185,1,6,4,10
2023-04-20 09:23:13,0.017719907407407406,1,9,9,18
2023-04-20 12:01:08,0.16648148148148148,2,6,5,11
2023-05-04 17:00:16,14.399837962962962,5,395,8,403
2023-04-21 16:09:41,1.5395138888888888,2,13,13,26
2023-04-20 12:51:02,0.4311689814814815,1,21,12,33
2023-04-20 18:46:42,0.7182986111111112,1,21,2,23
2023-04-21 14:35:43,1.564548611111111,1,0,1,1
2023-04-20 11:18:29,0.46600694444444446,1,36,20,56
2023-04-21 15:42:03,1.7361574074074073,1,8,6,14
2023-04-20 12:52:54,0.7368171296296296,5,10,2,12
2023-04-19 18:42:29,0.014780092592592593,1,15,6,21
2023-04-19 18:37:17,0.01685185185185185,1,3,4,7
2023-04-19 18:27:20,0.13886574074074073,1,6,5,11
2023-04-19 14:03:57,0.013194444444444444,1,56,57,113
2023-04-19 12:58:53,0.21002314814814815,1,4,0,4
2023-04-20 10:58:53,1.0243981481481481,3,3943,123,4066
2023-04-19 12:10:41,0.12577546296296296,1,2,2,4
2023-04-19 12:54:28,0.2871412037037037,1,2,0,2
2023-04-18 23:31:59,0.09420138888888889,1,2,0,2
2023-04-18 18:25:03,0.036238425925925924,6,19,8,27
2023-04-20 17:27:25,1.973425925925926,68,15716,2562,18278
2023-04-20 14:50:32,1.9139583333333334,1,35,8,43
2023-04-24 13:02:21,6.531261574074074,1,444,4,448
2023-04-18 17:54:18,0.07956018518518519,1,5,4,9
2023-04-25 12:51:05,45.22127314814815,14,49062,6174,55236
2023-04-20 14:05:36,2.306412037037037,3,4970,542,5512
2023-04-21 10:04:15,2.805636574074074,6,386,115,501
2023-04-18 16:51:33,0.09248842592592593,1,4,4,8
2023-04-24 11:49:05,5.922592592592593,4,152,20,172
2023-04-20 09:01:56,1.8397453703703703,3,168,266,434
2023-04-18 14:04:52,0.16539351851851852,2,6,4,10
2023-04-18 13:41:42,0.23828703703703705,1,12,0,12
2023-06-02 09:37:02,45.10917824074074,28,49397,15765,65162
2023-04-17 19:33:02,0.018125,2,406,405,811
2023-04-18 17:46:12,14.083101851851852,10,184,125,309
2023-04-17 18:22:13,0.0003935185185185185,1,66,98,164
2023-04-17 17:54:20,0.03337962962962963,7,10,23,33
2023-04-17 16:28:49,0.01951388888888889,1,2,2,4
2023-04-25 16:38:51,8.078587962962963,1,453,2,455
2023-04-17 15:30:18,0.04189814814814815,1,407,2,409
2023-04-17 15:11:53,0.14251157407407408,1,2,7,9
2023-04-17 10:41:55,0.0440162037037037,5,6,13,19
2023-04-19 17:27:37,2.5735995370370373,1,199,38,237
2023-05-09 17:04:11,22.803078703703704,31,15184,2950,18134
2023-04-18 13:11:30,1.8562731481481483,1,21,21,42
2023-04-28 15:01:33,12.044791666666667,19,15411,2691,18102
2023-04-24 14:18:21,8.021030092592593,1,373,2,375
2023-04-21 20:13:06,5.887523148148148,3,47,11,58
2023-05-11 09:07:44,25.701689814814817,4,33,25,58
2023-04-17 14:18:39,1.8318402777777778,1,5,4,9
2023-04-24 13:03:03,9.100347222222222,1,416,2,418
2023-04-14 23:08:41,0.10703703703703704,1,4,0,4
2023-04-17 16:31:21,2.9749074074074073,1,1,3,4
2023-04-14 18:12:48,0.04783564814814815,2,5,5,10
2023-04-17 15:45:20,3.010775462962963,3,45,32,77
2023-04-14 16:45:14,0.06212962962962963,1,8,3,11
2023-04-14 14:18:44,0.023101851851851853,2,9,4,13
2023-04-14 10:53:45,0.06737268518518519,2,4,8,12
2023-04-14 15:18:15,0.25349537037037034,2,2,2,4
2023-04-14 09:26:46,0.026643518518518518,1,2,2,4
2023-04-14 08:57:26,0.025,1,1,1,2
2023-04-14 08:40:40,0.027789351851851853,1,2,2,4
2023-05-10 18:22:57,26.488819444444445,6,22667,2851,25518
2023-04-24 17:02:19,10.776631944444444,1,386,2,388
2023-04-17 19:09:46,10.133333333333333,27,289,373,662
2023-04-13 19:32:30,0.01931712962962963,1,5,1,6
2023-04-13 18:51:14,12.184861111111111,14,165,108,273
2023-04-13 16:23:55,0.03409722222222222,2,4,4,8
2023-04-13 17:19:39,0.3120833333333333,4,581,159,740
2023-04-13 15:23:00,0.06416666666666666,6,21,25,46
2023-04-13 21:45:23,0.40706018518518516,3,22,14,36
2023-04-13 16:08:23,0.18334490740740741,1,8,8,16
2023-04-13 13:52:16,0.21056712962962962,4,11,7,18
2023-04-13 10:00:37,0.2624768518518519,1,2,2,4
2023-04-13 06:19:19,0.4071296296296296,2,3,2,5
2023-04-13 06:17:07,0.510787037037037,1,3,2,5
2023-04-12 15:42:50,0.14960648148148148,4,65737,6547,72284
2023-04-12 16:25:25,0.19212962962962962,4,109,107,216
2023-04-12 14:20:26,0.10927083333333333,1,8,8,16
2023-04-12 16:10:05,0.28724537037037035,7,37,28,65
2023-04-12 11:11:13,0.08710648148148148,1,1,1,2
2023-04-12 11:31:27,0.5657060185185185,1,1,0,1
2023-04-12 15:25:46,0.7159375,1,4,4,8
2023-04-20 09:58:53,9.507407407407408,7,11959,1663,13622
2023-04-11 15:59:16,0.09743055555555556,1,3,3,6
2023-04-13 10:50:31,2.2856828703703704,2,10,0,10
2023-04-11 13:06:17,0.3879050925925926,1,6,0,6
2023-04-17 15:36:29,12.993020833333333,6,137,105,242
2023-04-11 12:41:53,0.6750810185185185,2,66,13,79
2023-04-11 13:32:20,0.8222337962962963,3,16,9,25
2023-04-10 16:22:53,0.022662037037037036,1,26,0,26
2023-05-12 10:52:32,37.873449074074074,50,55972,12361,68333
2023-04-11 13:06:54,1.1622800925925927,2,3,2,5
2023-04-10 12:04:57,1.1270023148148147,1,1,0,1
2023-04-10 12:04:14,1.298113425925926,1,4,0,4
2023-04-21 13:41:30,12.774444444444445,1,1,1,2
2023-04-10 15:52:23,2.0599305555555554,3,176,7,183
2023-04-13 15:04:49,5.099085648148148,1,432,6,438
2023-04-11 08:00:34,2.9317939814814813,1,3,3,6
2023-04-10 12:53:53,2.289814814814815,1,1,1,2
2023-04-15 09:35:08,7.320532407407407,2,31,3,34
2023-04-07 21:04:55,0.034652777777777775,1,52,0,52
2023-04-10 12:49:43,2.7157060185185187,3,39,7,46
2023-04-11 13:26:32,3.71994212962963,1,2,2,4
2023-04-07 18:15:20,0.01597222222222222,1,18,0,18
2023-04-07 19:08:44,0.05505787037037037,1,34,70,104
2023-04-07 18:12:36,0.07998842592592592,2,2,1,3
2023-04-24 15:24:36,2.887696759259259,7,65,46,111
2023-04-14 01:40:36,6.441770833333333,10,495,104,599
2023-04-19 19:01:49,12.17332175925926,184,23525,11476,35001
2023-04-07 15:29:23,0.06914351851851852,2,3,3,6
2023-04-07 15:13:05,0.36780092592592595,4,44,1,45
2023-04-07 12:46:24,0.14828703703703705,1,3,3,6
2023-04-07 18:12:57,0.3845486111111111,4,34,19,53
2023-04-10 13:06:52,3.444328703703704,1,1,1,2
2023-04-06 20:53:00,0.07334490740740741,4,225,47,272
2023-04-06 17:12:52,0.03189814814814815,1,5,5,10
2023-04-12 10:44:29,5.7715625,1,6,3,9
2023-04-06 16:53:00,0.03181712962962963,1,37,0,37
2023-04-06 16:09:24,0.016134259259259258,1,2,2,4
2023-04-06 15:48:51,0.04349537037037037,1,1,1,2
2023-05-31 09:43:13,55.47189814814815,32,1874,360,2234
2023-06-06 16:11:31,96.9775,33,1012,347,1359
2023-04-12 16:46:42,6.150497685185186,5,7,7,14
2023-05-03 16:23:10,27.230486111111112,3,14,5,19
2023-04-06 12:00:30,0.09541666666666666,1,6,3,9
2023-04-06 15:56:07,0.09971064814814815,4,84,33,117
2023-04-19 12:53:48,13.210868055555556,5,13,12,25
2023-04-07 12:23:56,1.5799652777777777,5,3,0,3
2023-04-05 17:43:15,0.027430555555555555,2,11,23,34
2023-04-05 18:37:18,0.12184027777777778,2,172,21,193
2023-04-05 13:56:21,0.023668981481481482,2,6,6,12
2023-04-05 11:53:19,0.005590277777777777,1,5,2,7
2023-04-05 12:16:00,0.031782407407407405,2,9,7,16
2023-04-05 12:13:27,0.0744675925925926,2,2,1,3
2023-04-06 12:29:58,1.1110648148148148,1,1,1,2
2023-04-05 13:28:39,0.18185185185185185,1,6,6,12
2023-04-05 14:03:06,0.2151273148148148,4,43,28,71
2023-04-05 13:32:17,0.25417824074074075,1,626,26,652
2023-04-14 11:26:44,13.294340277777778,24,8745,842,9587
2023-04-05 08:57:47,1.6303125,6,40,16,56
2023-04-10 08:57:22,5.568425925925926,54,6024,2708,8732
2023-04-04 13:28:58,0.08841435185185186,1,2,0,2
2023-04-04 15:29:43,0.19622685185185185,2,5,4,9
2023-04-04 13:26:46,0.11053240740740741,1,1,1,2
2023-04-17 11:41:53,13.33144675925926,1,2,2,4
2023-04-04 08:03:14,0.5924305555555556,2,82,61,143
2023-04-03 19:26:36,0.04178240740740741,1,1,2,3
2023-04-06 12:50:16,36.835902777777775,11,418,104,522
2023-04-04 20:59:54,1.2072337962962962,8,251,23,274
2023-04-03 18:03:41,0.09325231481481482,4,95,52,147
2023-04-04 13:20:13,0.8985532407407407,1,20,37,57
2023-04-03 16:03:57,0.030914351851851853,1,3,1,4
2023-04-03 15:55:38,0.03864583333333333,4,26,8,34
2023-04-17 11:39:54,13.857731481481482,1,344,2,346
2023-04-07 12:12:35,3.912650462962963,1,142,3,145
2023-04-03 15:10:50,0.04699074074074074,6,39,26,65
2023-04-03 16:04:25,0.22148148148148147,4,23,8,31
2023-04-05 15:43:48,2.240474537037037,12,1359,185,1544
2023-04-13 13:01:15,11.94181712962963,14,157,174,331
2023-04-03 14:06:53,0.22811342592592593,1,2,2,4
2023-04-03 09:41:40,0.060069444444444446,1,1,1,2
2023-07-11 13:04:05,229.76372685185186,79,3642,1390,5032
2023-04-03 17:49:39,1.1800925925925927,2,14,10,24
2023-04-03 15:00:27,1.0912268518518518,1,1,0,1
2023-04-03 14:28:40,1.0946527777777777,1,2,2,4
2023-04-03 13:17:02,2.87625,1,27,0,27
2023-04-07 15:28:00,97.11445601851852,1,241,0,241
2023-04-03 14:04:38,2.808946759259259,4,139,22,161
2023-04-06 15:45:55,5.113171296296296,3,174,77,251
2023-04-04 13:05:04,3.834525462962963,18,310,115,425
2023-03-31 19:38:35,0.14765046296296297,3,32,33,65
2023-05-19 08:33:11,49.72871527777778,35,1771,1514,3285
2023-03-31 14:50:33,0.007627314814814815,1,1,1,2
2023-04-03 10:06:25,33.722118055555555,5,318,54,372
2023-04-06 22:55:20,6.5378125,1,6,3,9
2023-04-04 17:01:32,4.357777777777778,1,1,1,2
2023-04-04 01:05:31,4.083784722222222,3,8,4,12
2023-04-04 14:21:58,4.994965277777778,2,41,12,53
2023-03-31 12:17:40,0.9536921296296297,1,1,1,2
2023-03-30 15:04:12,0.10472222222222222,1,3,3,6
2023-03-31 07:09:41,0.8109953703703704,4,10,10,20
2023-03-30 14:54:02,0.1409490740740741,2,20,36,56
2023-03-30 13:36:07,0.2301851851851852,1,4,4,8
2023-03-30 13:02:17,0.12855324074074073,1,15,11,26
2023-03-30 10:30:19,0.03844907407407407,1,2,0,2
2023-03-30 10:29:11,0.6050347222222222,2,42,19,61
2023-03-29 18:36:40,130.85181712962964,4,26,16,42
2023-03-29 18:07:07,0.030428240740740742,1,2,2,4
2023-03-29 18:05:42,0.032372685185185185,1,8,2,10
2023-03-29 17:45:06,0.018796296296296297,1,1,1,2
2023-03-29 17:15:38,0.01357638888888889,1,9,7,16
2023-03-29 16:59:14,0.038425925925925926,1,1,6,7
2023-03-30 11:00:13,0.8042824074074074,8,320,97,417
2023-03-29 15:40:46,0.00917824074074074,1,1,1,2
2023-04-03 13:20:03,4.9318634259259255,3,145,12,157
2023-03-29 14:59:42,0.010300925925925925,1,4,2,6
2023-03-29 13:09:57,0.12068287037037037,2,151,43,194
2023-03-29 13:13:01,0.09991898148148148,4,5,6,11
2023-03-31 14:07:36,2.1891666666666665,19,243,148,391
2023-03-29 14:16:24,0.17194444444444446,1,333,136,469
2023-03-29 13:46:31,1.0108449074074075,1,4,1,5
2023-03-29 13:35:31,1.093773148148148,2,4,0,4
2023-03-28 14:42:07,0.2193402777777778,1,26,17,43
2023-04-04 10:50:34,7.228564814814815,4,53,30,83
2023-03-28 13:09:17,0.5846875,1,7,8,15
2023-03-28 00:23:56,0.07805555555555556,1,1,1,2
2023-03-27 17:04:28,0.012650462962962962,1,1,1,2
2023-04-03 13:07:32,10.077395833333334,23,15107,2419,17526
2023-03-27 15:39:27,0.022835648148148147,2,18,15,33
2023-03-27 15:12:43,2.7667824074074074,3,13,1,14
2023-03-27 14:55:55,0.17028935185185184,2,10018,1736,11754
2023-03-27 15:38:08,1.809236111111111,8,164,46,210
2023-03-30 19:06:36,3.525451388888889,5,457,360,817
2023-03-27 13:48:50,0.357962962962963,2,86,0,86
2023-03-27 13:20:57,0.8667824074074074,2,3,1,4
2023-03-27 14:48:24,4.15269675925926,6,168,184,352
2023-03-27 13:24:26,1.086863425925926,1,1,1,2
2023-03-28 13:17:03,3.529259259259259,6,4029,356,4385
2023-03-27 14:34:53,2.9630092592592594,1,20,7,27
2023-03-24 20:23:28,0.03037037037037037,2,10,4,14
2023-03-24 19:46:42,0.037939814814814815,1,2,2,4
2023-03-31 20:18:44,8.808240740740741,28,1142,549,1691
2023-03-24 18:45:03,0.10428240740740741,2,8,8,16
2023-03-24 14:54:06,0.03337962962962963,3,14,13,27
2023-03-24 18:09:02,0.17054398148148148,2,2,0,2
2023-03-27 14:11:15,3.0089467592592594,1,6,1,7
2023-03-24 13:29:06,0.6229513888888889,2,17,23,40
2023-03-24 11:04:51,0.6383217592592593,2,3,3,6
2023-03-24 11:33:17,0.8150462962962963,1,27,2,29
2023-03-24 11:32:19,0.7395717592592592,1,1,2,3
2023-03-29 11:21:09,5.828125,12,13870,1937,15807
2023-03-23 15:14:12,0.06108796296296296,1,1,1,2
2023-03-23 14:26:51,0.1723726851851852,2,5,2,7
2023-03-23 17:15:52,0.726712962962963,3,8,4,12
2023-03-23 15:31:33,0.5802199074074074,3,14549,1684,16233
2023-03-23 01:35:04,0.05127314814814815,5,45,60,105
2023-03-27 14:47:35,4.901504629629629,18,446,298,744
2023-03-23 17:00:23,1.1228125,4,72,23,95
2023-03-22 19:02:25,0.3300578703703704,7,130,62,192
2023-03-27 17:07:53,6.215451388888889,8,6004,753,6757
2023-03-22 15:57:09,0.02488425925925926,1,3,3,6
2023-03-22 15:20:49,0.053668981481481484,2,41,44,85
2023-04-04 12:53:07,12.935428240740741,10,22510,3486,25996
2023-03-22 13:22:08,0.018425925925925925,1,1,0,1
2023-03-22 15:00:21,0.11086805555555555,2,72,59,131
2023-03-23 09:34:43,0.9434722222222223,2,1373,548,1921
2023-03-23 16:27:13,1.4964814814814815,2,5490,481,5971
2023-03-22 12:07:49,0.6848726851851852,1,8,14,22
2023-03-21 20:32:43,0.07438657407407408,1,1,1,2
2023-03-22 00:00:34,0.21434027777777778,2,48,21,69
2023-03-21 21:21:34,0.11930555555555555,1,4,4,8
2023-03-21 17:07:31,0.03394675925925926,1,110,0,110
2023-03-22 10:46:57,0.8300925925925926,1,32,16,48
2023-03-21 15:16:18,0.030983796296296297,2,140,74,214
2023-03-21 18:22:01,0.1913425925925926,4,62,150,212
2023-03-22 10:42:40,1.1121643518518518,2,53,1,54
2023-03-30 13:16:04,1.2402430555555555,1,11,3,14
2023-03-23 14:34:18,2.817789351851852,3,73,69,142
2023-07-11 15:07:59,112.90854166666666,13,664,418,1082
2023-03-20 17:54:01,0.039699074074074074,1,5,3,8
2023-03-20 18:18:55,0.09909722222222223,3,9,7,16
2023-03-23 18:14:18,3.1779166666666665,9,5099,1745,6844
2023-03-20 17:07:32,0.08496527777777778,1,21,21,42
2023-03-20 15:30:47,0.0225,2,6,2,8
2023-03-23 12:45:13,2.9128125,4,6157,746,6903
2023-03-20 15:24:18,0.023275462962962963,1,2,1,3
2023-03-20 14:26:50,0.03326388888888889,1,1,1,2
2023-03-21 12:27:30,0.9754166666666667,3,254,40,294
2023-03-21 12:12:57,0.979525462962963,3,7,1,8
2023-03-20 12:00:06,0.037835648148148146,1,1,1,2
2023-03-22 10:19:27,1.976863425925926,1,145,0,145
2023-04-06 07:53:03,16.896898148148146,4,272,30,302
2023-03-20 12:17:32,0.9487731481481482,1,4,4,8
2023-05-01 13:17:27,81.07292824074074,18,254,61,315
2023-03-20 13:17:35,1.8430324074074074,1,4,1,5
2023-03-20 13:16:08,6.150787037037037,10,7439,1425,8864
2023-03-22 19:18:57,4.593715277777778,5,6114,680,6794
2023-03-21 10:16:08,3.4680671296296297,5,6,5,11
2023-03-20 20:06:16,3.0802893518518517,4,69,12,81
2023-03-20 15:30:37,2.90056712962963,4,61,61,122
2023-03-27 14:37:47,9.932997685185185,3,80,26,106
2023-03-17 17:56:32,0.10046296296296296,1,6,6,12
2023-03-17 15:54:28,0.005324074074074074,1,0,9,9
2023-03-17 14:27:13,0.011585648148148149,1,2,2,4
2023-03-17 15:07:55,0.05361111111111111,2,5,6,11
2023-03-17 12:27:15,0.09488425925925927,1,9,0,9
2023-03-17 14:30:18,0.19020833333333334,2,541,379,920
2023-03-17 08:43:19,0.05421296296296296,1,2,2,4
2023-03-17 09:40:06,0.1419212962962963,1,1,1,2
2023-03-16 22:57:26,0.01943287037037037,1,2,1,3
2023-03-17 12:55:16,0.7548958333333333,2,8,6,14
2023-03-22 04:35:47,5.440335648148148,8,3094,550,3644
2023-04-18 16:36:57,32.93333333333333,13,24071,2648,26719
2023-03-17 13:39:27,0.8967824074074074,8,254,99,353
2023-03-16 16:08:06,0.03148148148148148,2,3,3,6
2023-03-16 15:18:06,0.018020833333333333,2,2,1,3
2023-03-17 12:36:23,0.9703703703703703,4,166,14,180
2023-03-16 21:59:23,0.402037037037037,7,31,23,54
2023-03-16 13:21:59,0.2637731481481482,5,31,18,49
2023-03-16 10:41:48,0.05550925925925926,1,1,1,2
2023-03-17 13:28:18,2.214560185185185,2,6,3,9
2023-03-16 11:48:52,0.29685185185185187,1,1,1,2
2023-03-16 04:52:40,0.04164351851851852,2,4,5,9
2023-03-17 18:02:56,1.6088541666666667,1,20,3,23
2023-03-15 18:13:39,0.01425925925925926,2,10,2,12
2023-03-15 17:37:23,0.02693287037037037,1,7,40,47
2023-03-15 16:27:19,0.061585648148148146,1,3,3,6
2023-03-16 12:00:08,0.9192592592592592,7,1111,779,1890
2023-04-06 16:08:14,0.3004398148148148,4,348,11,359
2023-04-12 12:01:19,28.138414351851853,24,28730,4870,33600
2023-03-14 17:45:46,0.0178125,1,2,2,4
2023-03-14 21:30:44,0.2543634259259259,1,10,14,24
2023-03-14 21:30:33,0.3014351851851852,1,1,2,3
2023-03-14 15:43:44,0.07467592592592592,4,42,13,55
2023-03-14 13:55:19,0.17244212962962963,4,1797,12,1809
2023-03-14 11:09:37,0.06292824074074074,3,412,0,412
2023-03-14 09:13:17,0.11140046296296297,1,2,2,4
2023-03-15 19:54:39,6.892141203703703,10,5777,497,6274
2023-03-14 17:22:03,0.8260763888888889,6,42,25,67
2023-03-13 20:34:01,0.07421296296296297,5,20,28,48
2023-03-13 18:12:12,0.019467592592592592,1,1,1,2
2023-03-13 15:26:51,0.012638888888888889,1,7,7,14
2023-03-13 19:50:51,0.22777777777777777,1,2,2,4
2023-03-13 21:21:16,0.2941898148148148,1,41,23,64
2023-03-13 18:46:01,0.21994212962962964,5,48,8,56
2023-03-13 14:57:17,5.959675925925926,5,171,26,197
2023-03-13 14:06:19,0.032476851851851854,1,7,2,9
2023-03-13 14:05:12,0.040671296296296296,1,6,5,11
2023-03-13 13:52:35,0.03340277777777778,1,6,5,11
2023-03-13 13:49:23,0.03891203703703704,1,8,6,14
2023-03-13 14:45:48,0.07962962962962963,3,16,14,30
2023-03-13 13:50:03,0.04255787037037037,1,7,5,12
2023-03-13 14:03:22,0.0829513888888889,1,4,0,4
2023-03-13 13:24:35,0.8840856481481482,2,144,11,155
2023-03-13 14:02:04,277.15872685185184,20,1036850,152862,1189712
2023-03-13 19:00:26,2.0961689814814815,2,6,18,24
2023-03-27 19:00:17,16.47766203703704,11,25112,3433,28545
2023-03-13 19:52:42,2.6426041666666666,3,18,4,22
2023-03-13 19:51:41,2.8058449074074074,4,19,17,36
2023-03-15 20:11:15,4.904293981481482,3,39,15,54
2023-03-14 13:20:17,3.645138888888889,4,20,12,32
2023-03-10 21:08:22,0.009537037037037037,1,2,37,39
2023-04-04 15:05:23,24.913356481481483,57,5012,998,6010
2023-03-13 09:46:15,2.8370717592592594,6,176,100,276
2023-03-10 19:03:43,0.23074074074074075,4,18,16,34
2023-03-13 20:39:06,3.379085648148148,4,3593,3543,7136
2023-03-10 11:31:08,0.018645833333333334,1,7,5,12
2023-03-10 13:36:09,0.11049768518518518,5,30,24,54
2023-03-10 11:30:43,0.02953703703703704,3,16,14,30
2023-03-10 13:28:31,0.1555787037037037,1,12,12,24
2023-04-03 13:07:21,24.219155092592594,1,2,2,4
2023-03-10 13:56:43,0.2858449074074074,1,1,1,2
2023-04-26 12:35:30,48.04329861111111,7,360,43,403
2023-03-22 11:14:55,12.446956018518518,17,280,265,545
2023-03-10 12:44:46,0.4398611111111111,2,3,3,6
2023-03-10 19:46:35,0.9023842592592592,2,6,4,10
2023-03-13 18:11:19,3.913449074074074,7,114,51,165
2023-03-09 21:58:03,0.10430555555555555,3,11,4,15
2023-03-09 18:09:24,0.03449074074074074,2,12,0,12
2023-03-09 18:53:54,0.0987962962962963,1,185,60,245
2023-03-09 16:09:47,0.036550925925925924,1,28,28,56
2023-03-09 15:36:30,0.06017361111111111,4,27,5,32
2023-03-09 14:39:05,0.022835648148148147,3,7,3,10
2023-03-09 14:23:49,0.2046875,2,15,26,41
2023-03-09 12:44:58,0.3260300925925926,1,13,1,14
2023-03-09 12:43:50,0.33618055555555554,1,4,4,8
2023-03-22 00:00:05,12.871944444444445,2,13,4,17
2023-03-09 16:12:57,0.6281712962962963,3,6,4,10
2023-03-09 14:44:18,0.7432291666666667,5,15,11,26
2023-03-08 20:48:30,0.012789351851851852,2,2,0,2
2023-03-09 12:17:44,0.7210069444444445,5,26,22,48
2023-03-08 19:27:30,0.14835648148148148,6,559,88,647
2023-03-08 21:21:47,6.777939814814815,1,3,1,4
2023-03-09 17:35:44,1.0726967592592593,3,13,14,27
2023-03-10 15:50:30,2.006122685185185,1,24,7,31
2023-03-08 16:43:32,0.05246527777777778,1,2,0,2
2023-03-08 14:12:43,0.5517708333333333,1,1,1,2
2023-03-08 13:51:45,0.017719907407407406,3,12785,2143,14928
2023-03-09 11:12:17,0.9283101851851852,3,4411,670,5081
2023-03-27 17:42:00,20.388032407407408,118,47915,10505,58420
2023-03-08 12:56:48,0.09004629629629629,1,14,9,23
2023-03-08 11:54:43,0.05863425925925926,1,1,1,2
2023-03-08 19:21:38,0.46096064814814813,4,14,14,28
2023-03-08 12:54:30,0.4325462962962963,1,2,0,2
2023-03-09 19:31:58,1.9221412037037038,1,3,1,4
2023-03-07 21:31:14,0.2091550925925926,10,44,22,66
2023-03-14 09:03:03,6.748240740740741,20,606,208,814
2023-05-09 13:10:18,62.94819444444445,39,1908,1167,3075
2023-03-07 15:54:11,0.08998842592592593,2,9,3,12
2023-03-11 13:03:36,3.9714467592592593,3,1,2,3
2023-03-08 11:47:56,0.9865625,4,8,6,14
2023-03-07 13:20:40,0.06506944444444444,2,6,6,12
2023-03-07 13:23:37,0.1329050925925926,1,25,0,25
2023-03-07 03:20:15,0.33034722222222224,5,61,12,73
2023-03-07 12:35:50,0.7457291666666667,1,3,3,6
2023-03-13 23:09:38,7.225208333333334,19,111,39,150
2023-03-06 17:44:53,0.016446759259259258,1,7,6,13
2023-03-06 17:44:32,0.018726851851851852,1,8,6,14
2023-03-06 17:43:53,0.020694444444444446,1,6,5,11
2023-03-06 17:43:25,0.02525462962962963,1,7,5,12
2023-03-06 17:42:53,0.028854166666666667,1,7,5,12
2023-03-06 17:07:32,0.016493055555555556,1,8,2,10
2023-03-07 12:34:05,0.8414699074074075,3,53,4,57
2023-03-07 11:14:10,0.8740740740740741,3,27,10,37
2023-03-07 16:32:08,1.0830324074074074,8,226,73,299
2023-03-06 16:41:01,0.09806712962962963,1,3,3,6
2023-03-14 08:23:49,10.589351851851852,8,117,93,210
2023-03-08 14:00:55,2.2987152777777777,11,33353,5654,39007
2023-03-06 14:55:32,5.2811111111111115,3,140,100,240
2023-03-06 15:20:11,0.6113078703703704,1,13,0,13
2023-03-07 11:59:23,1.7873611111111112,4,37,18,55
2023-03-06 08:15:45,1.7484375,1,2,2,4
2023-03-06 14:56:41,1.5497685185185186,1,7,5,12
2023-03-06 14:33:45,1.8228125,1,3,0,3
2023-03-06 18:13:43,2.0405208333333333,3,37,25,62
2023-03-04 15:44:34,0.8108912037037037,1,6,5,11
2023-03-04 15:44:07,0.8121759259259259,1,6,5,11
2023-03-04 15:43:33,0.8134143518518518,1,14,10,24
2023-03-04 15:42:58,0.8147222222222222,1,7,5,12
2023-03-08 16:59:32,4.884305555555556,10,120,97,217
2023-03-13 15:58:30,9.863425925925926,2,44,44,88
2023-03-06 14:22:28,2.8360185185185185,6,14,16,30
2023-03-06 16:57:41,3.894814814814815,12,908,249,1157
2023-03-03 19:21:14,0.07184027777777778,1,5,7,12
2023-04-24 16:34:31,52.009166666666665,3,16,10,26
2023-03-03 16:57:40,0.06174768518518518,1,9,4,13
2023-03-03 17:42:19,0.1595138888888889,7,71,14,85
2023-03-03 14:34:21,0.029780092592592594,4,37,27,64
2023-03-03 16:57:25,0.16150462962962964,12,1064,496,1560
2023-03-03 13:43:03,0.012569444444444444,1,1,1,2
2023-04-05 13:36:05,33.126863425925926,4,16,10,26
2023-03-03 13:47:10,0.1607060185185185,2,11,2,13
2023-03-03 13:35:09,0.17657407407407408,1,2,1,3
2023-03-03 11:50:22,0.11885416666666666,2,8,7,15
2023-03-03 11:49:50,0.10520833333333333,2,7,5,12
2023-03-03 16:51:54,0.402025462962963,2,10,12,22
2023-03-03 11:49:28,0.2612615740740741,1,7,5,12
2023-03-03 13:44:00,0.46936342592592595,2,4,1,5
2023-03-02 20:23:06,0.029907407407407407,2,25,7,32
2023-03-03 00:18:11,0.19087962962962962,1,6,4,10
2023-03-03 13:43:45,0.7828587962962963,4,30,18,48
2023-03-02 18:16:04,0.00863425925925926,1,6,0,6
2023-03-03 05:18:19,0.5010763888888888,3,769,216,985
2023-03-02 17:20:35,0.11752314814814815,9,70,11,81
2023-03-02 16:14:51,0.1158912037037037,5,33,9,42
2023-03-02 13:49:27,0.10740740740740741,1,44,44,88
2023-03-02 18:46:22,1.7250694444444445,9,84,88,172
2023-03-02 13:07:26,9.877071759259259,2,3,3,6
2023-03-02 09:46:04,0.09402777777777778,2,5376,374,5750
2023-05-30 08:23:33,89.76578703703704,134,221065,36492,257557
2023-03-02 12:43:19,0.6248726851851852,2,18,8,26
2023-03-02 15:55:37,0.8423611111111111,3,159,24,183
2023-03-01 20:52:27,0.0509375,2,1,1,2
2023-03-01 19:41:27,0.07690972222222223,2,17,5,22
2023-03-01 19:10:04,0.07629629629629629,2,14,12,26
2023-03-01 16:57:06,0.03934027777777778,2,47,6,53
2023-03-02 08:45:42,0.9612962962962963,6,218,322,540
2023-03-01 16:59:21,0.07524305555555555,1,2,3,5
2023-03-02 07:47:21,0.7717824074074074,1,1,1,2
2023-03-01 18:00:48,13.067581018518519,13,1196,124,1320
2023-03-01 13:26:26,0.03640046296296296,1,0,4,4
2023-03-01 12:49:56,0.047060185185185184,2,80,10,90
2023-03-02 17:07:45,7.283541666666666,20,166395,31966,198361
2023-03-02 13:52:00,1.1605439814814815,3,53,42,95
2023-03-01 13:05:54,0.1533912037037037,1,2,1,3
2023-04-04 16:41:13,34.32378472222222,6,52285,7433,59718
2023-03-01 11:41:58,0.16033564814814816,2,14,10,24
2023-03-01 12:47:18,0.5336805555555556,11,247,247,494
2023-03-01 16:52:50,0.7766898148148148,1,18,0,18
2023-03-01 10:25:33,0.5770138888888889,3,15,13,28
2023-03-01 16:53:30,0.24179398148148148,8,312,13,325
2023-03-30 09:04:12,29.69732638888889,3,29,86,115
2023-03-10 12:15:26,9.797071759259259,5,51,16,67
2023-03-01 10:11:04,0.7581944444444444,6,17,9,26
2023-03-02 14:48:08,2.1410300925925925,1,0,3,3
2023-03-02 19:43:36,2.336053240740741,5,102,26,128
2023-02-28 11:56:26,0.04324074074074074,1,7,5,12
2023-02-28 14:09:45,0.19225694444444444,3,12356,1686,14042
2023-03-02 15:41:16,2.26125,3,562,213,775
2023-03-02 15:40:57,2.2624421296296298,4,564,216,780
2023-03-02 15:40:35,2.2652314814814813,3,562,213,775
2023-02-28 12:55:48,0.48060185185185184,2,2,2,4
2023-03-04 15:45:54,5.715324074074074,5,12987,1189,14176
2023-03-16 14:56:27,16.77321759259259,7,15,17,32
2023-02-28 15:23:08,3.8025810185185187,11,375,68,443
2023-02-27 18:38:44,0.005023148148148148,1,3,3,6
2023-02-28 07:10:30,0.5563541666666667,1,1,1,2
2023-04-18 09:12:31,54.78667824074074,38,680,466,1146
2023-02-28 16:12:45,1.307824074074074,5,64,65,129
2023-02-28 12:46:34,1.0794791666666668,2,570,218,788
2023-02-28 14:42:56,1.2711921296296296,4,498,60,558
2023-02-28 12:47:05,1.1402314814814816,4,577,225,802
2023-02-27 14:49:32,0.2252662037037037,2,7,5,12
2023-03-07 20:19:40,34.477662037037035,10,284,236,520
2023-03-01 14:21:08,2.316736111111111,5,631,250,881
2023-02-28 14:54:08,1.3817824074074074,6,6,11,17
2023-02-27 21:25:06,1.925474537037037,4,562,215,777
2023-03-01 12:41:36,19.063819444444444,5,7698,1020,8718
2023-02-27 07:36:36,2.108252314814815,2,19,19,38
2023-02-28 15:12:43,3.8795254629629627,5,1074,246,1320
2023-02-28 12:24:44,3.7553935185185185,1,2,1,3
2023-02-28 18:41:34,4.091770833333333,24,211,212,423
2023-02-27 12:31:29,2.901261574074074,1,12,12,24
2023-02-24 15:55:38,0.04296296296296296,1,10,2,12
2023-02-27 11:43:57,2.896053240740741,2,13,6,19
2023-08-21 15:35:00,178.09990740740741,78,14577,9293,23870
2023-02-27 15:31:56,3.142453703703704,2,60,35,95
2023-02-27 07:19:20,2.837638888888889,1,1,1,2
2023-02-28 21:24:15,4.539189814814815,2,7,4,11
2023-02-27 07:57:57,3.0753703703703703,1,7,1,8
2023-02-24 15:37:22,0.6181712962962963,5,31,21,52
2023-03-22 18:13:21,26.807511574074073,73,39108,6954,46062
2023-02-23 21:22:26,0.04694444444444444,3,7,3,10
2023-03-02 17:08:43,6.916377314814815,7,190,129,319
2023-02-24 10:39:25,0.6860185185185185,4,204,58,262
2023-03-24 12:17:28,43.615636574074074,66,79032,13411,92443
2023-02-24 08:59:19,0.6926736111111111,1,1,1,2
2023-09-29 15:42:58,218.0788310185185,19,1997,1031,3028
2023-02-24 11:36:55,0.9331597222222222,6,23,18,41
2023-02-24 11:21:01,0.9905902777777778,1,13,15,28
2023-02-24 08:19:07,0.8997800925925926,3,21,18,39
2023-03-07 15:20:21,12.207164351851851,9,17112,2580,19692
2023-02-24 08:48:08,1.0182986111111112,2,17,11,28
2023-02-23 08:17:01,0.07803240740740741,1,24,27,51
2023-02-23 08:40:53,0.5684606481481481,1,3,0,3
2023-02-27 11:33:34,4.8037731481481485,5,12102,1528,13630
2023-02-23 08:41:29,0.7489467592592592,4,4,4,8
2023-03-01 18:23:31,9.356921296296296,23,17885,3651,21536
2023-02-27 07:18:15,4.764131944444444,6,34,32,66
2023-02-23 09:50:38,0.8652083333333334,1,44,14,58
2023-02-25 19:30:54,3.3666550925925924,8,736,183,919
2023-02-23 08:48:20,0.9937615740740741,3,9,7,16
2023-02-22 10:09:05,0.6156828703703704,3,13,1,14
2023-02-22 08:21:26,0.6607407407407407,1,1,1,2
2023-02-22 13:32:35,0.9175462962962962,1,10,0,10
2023-02-22 13:15:15,0.9622800925925926,5,10,8,18
2023-02-22 09:57:35,1.5180787037037038,3,2,3,5
2023-02-23 08:28:18,3.2649421296296297,4,22,3,25
2023-02-22 09:55:12,0.9520717592592592,1,4,7,11
2023-02-22 09:51:00,1.0073032407407407,1,0,1,1
2023-02-21 10:37:49,0.5815046296296297,3,7,4,11
2023-02-21 08:39:15,0.5228472222222222,1,11,1,12
2023-02-23 16:51:19,2.8847222222222224,6,52,30,82
2023-02-28 16:28:59,7.947951388888889,9,12489,1729,14218
2023-02-21 15:35:12,3.8636805555555553,6,15374,406,15780
2023-02-21 08:38:26,0.8336689814814815,3,44,1,45
2023-02-22 10:16:57,1.8481712962962964,3,53,19,72
2023-02-21 06:01:37,0.6994907407407407,1,0,13,13
2023-02-22 08:39:19,1.9618171296296296,3,85,9,94
2023-02-24 07:20:53,3.9183680555555553,6,8198,1289,9487
2023-02-20 20:21:42,0.4609837962962963,1,1,0,1
2023-02-20 16:23:39,0.291875,1,1,1,2
2023-04-03 14:32:36,42.785868055555554,1,12,8,20
2023-02-22 08:14:54,2.521122685185185,1,971,955,1926
2023-02-20 12:21:59,1.1230555555555555,3,605,71,676
2023-02-28 17:21:48,34.24975694444444,11,82819,16320,99139
2023-03-14 09:08:15,35.58513888888889,21,96263,19501,115764
2023-02-17 17:09:38,0.25708333333333333,1,1,1,2
2023-02-17 17:04:12,0.2795023148148148,1,1,1,2
2023-02-23 14:08:26,12.80494212962963,3,29,18,47
2023-02-17 10:32:15,0.5673726851851851,9,12,10,22
2023-02-16 14:10:25,0.028969907407407406,1,2,2,4
2023-05-09 13:14:02,82.2737037037037,1,2,2,4
2023-02-16 14:23:43,0.37211805555555555,1,1,1,2
2023-04-14 05:11:02,57.002349537037034,29,62986,6347,69333
2023-02-16 16:57:19,0.6277777777777778,1,1,0,1
2023-02-16 15:00:46,0.65125,1,1,1,2
2023-02-16 16:32:33,0.770775462962963,5,86,140,226
2023-02-15 20:57:25,0.047511574074074074,1,39,10,49
2023-02-21 05:59:52,5.434537037037037,2,3,3,6
2023-02-15 20:16:47,0.11258101851851852,1,10,7,17
2023-02-15 16:00:51,0.023796296296296298,1,12,21,33
2023-02-17 20:22:40,2.2186226851851854,14,119,101,220
2023-02-15 14:17:27,0.9958217592592593,3,14,23,37
2023-02-16 14:18:26,1.0857060185185186,1,28,28,56
2023-02-15 09:59:42,0.06013888888888889,2,10,6,16
2023-02-15 16:34:02,0.34530092592592593,2,4,4,8
2023-02-14 21:12:23,0.10678240740740741,3,4,9,13
2023-02-14 19:00:30,0.015196759259259259,1,1,1,2
2023-02-14 15:57:28,0.020497685185185185,1,13,10,23
2023-02-14 19:39:33,0.21861111111111112,5,673,675,1348
2023-02-16 17:44:28,2.168252314814815,8,212,172,384
2023-02-14 14:16:22,0.12611111111111112,1,57,66,123
2023-02-16 14:20:00,2.2316203703703703,4,34,34,68
2023-02-15 14:18:48,1.2762962962962963,1,13,4,17
2023-02-14 21:11:38,0.788599537037037,4,56,13,69
2023-02-24 07:30:33,10.38167824074074,7,20,12,32
2023-02-13 21:40:34,0.023726851851851853,4,3,2,5
2023-02-13 19:53:26,0.03037037037037037,2,14,33,47
2023-02-14 20:02:19,1.0629976851851852,1,0,2,2
2023-02-13 19:37:49,0.0528587962962963,1,20,16,36
2023-02-13 21:23:01,0.2369675925925926,2,21,9,30
2023-02-14 10:46:46,0.9107291666666667,3,96,30,126
2023-02-13 15:11:16,0.10883101851851852,1,2,2,4
2023-02-13 14:34:23,0.12067129629629629,1,2,0,2
2023-02-27 10:43:45,13.986793981481481,17,17555,1706,19261
2023-02-14 08:43:07,0.9001273148148148,3,20,3,23
2023-02-13 15:18:51,0.18416666666666667,2,4,2,6
2023-02-13 15:44:27,0.277650462962963,4,12,8,20
2023-02-13 15:09:01,0.3396527777777778,1,1,1,2
2023-02-14 18:00:02,1.4991550925925925,2,18,18,36
2023-02-13 18:05:32,0.9847337962962963,2,545,4,549
2023-02-13 15:27:24,0.9104282407407407,1,4,0,4
2023-02-13 18:12:14,1.5487962962962962,2,7,6,13
2023-02-13 15:22:29,1.479074074074074,1,2,2,4
2023-02-20 08:23:47,8.442881944444444,5,14373,1624,15997
2023-02-24 07:47:34,12.557928240740742,7,25629,3014,28643
2023-02-13 17:04:50,2.033703703703704,5,942,259,1201
2023-02-17 08:44:02,5.949490740740741,25,11107,2064,13171
2023-02-13 15:21:50,2.5746759259259258,1,1,1,2
2023-02-13 15:11:40,2.6925694444444446,4,42,122,164
2023-02-10 22:28:25,0.05543981481481482,1,1,0,1
2023-02-13 18:29:12,2.9558680555555554,11,142,38,180
2023-03-02 12:30:39,19.72710648148148,8,369,204,573
2023-02-13 12:24:23,3.039722222222222,8,387,301,688
2023-03-09 18:13:24,27.013472222222223,2,519,3,522
2023-02-10 18:17:02,0.06296296296296296,2,7,2,9
2023-02-10 17:37:06,0.00681712962962963,1,0,1,1
2023-02-14 14:47:33,3.959490740740741,1,0,22,22
2023-02-14 14:47:44,3.971539351851852,1,2,2,4
2023-02-20 13:37:11,27.034212962962965,28,60626,14912,75538
2023-02-10 14:44:51,0.06553240740740741,4,29,3,32
2023-02-13 15:12:08,3.141273148148148,3,3,12,15
2023-02-10 14:53:55,0.7015856481481482,1,5,0,5
2023-02-21 16:28:33,11.907291666666667,10,85,85,170
2023-02-09 20:49:55,1.9369097222222222,3,4263,442,4705
2023-02-09 19:15:11,0.004085648148148148,2,3,2,5
2023-02-10 09:58:30,0.6386342592592592,1,2,1,3
2023-02-10 21:57:28,1.2103587962962963,10,7,54,61
2023-02-09 20:44:03,0.16516203703703702,1,13,1,14
2023-02-09 14:46:15,0.09884259259259259,1,13,0,13
2023-04-23 17:03:06,115.00133101851851,34,3259,1337,4596
2023-02-09 14:28:56,13.806666666666667,2,17,8,25
2023-02-09 14:06:22,0.27390046296296294,1,3,3,6
2023-02-09 14:46:41,0.30193287037037037,1,1,0,1
2023-02-10 14:16:24,1.378125,3,4036,244,4280
2023-02-09 11:10:14,1.9827546296296297,2,102,67,169
2023-02-10 17:09:22,1.9025,12,4116,318,4434
2023-02-08 19:35:15,0.07065972222222222,1,4,0,4
2023-02-08 17:31:11,0.030358796296296297,3,25,4,29
2023-02-13 14:24:56,4.937337962962963,16,9199,1400,10599
2023-02-08 16:41:55,0.03605324074074074,1,12,71,83
2023-02-28 18:40:58,20.186712962962964,44,6773,1425,8198
2023-02-08 18:36:21,0.3443171296296296,1,4,0,4
2023-02-10 17:22:12,2.3048842592592593,7,888,360,1248
2023-02-08 14:39:52,0.21599537037037037,1,2,2,4
2023-02-08 14:25:07,0.47717592592592595,1,1,1,2
2023-02-08 17:32:41,0.7698379629629629,1,1,0,1
2023-02-10 17:44:20,2.7917708333333335,4,150,10,160
2023-02-08 13:00:52,0.6111805555555555,1,2,1,3
2023-02-10 18:19:39,2.846840277777778,3,98,429,527
2023-02-07 21:45:59,0.014895833333333334,1,2,2,4
2023-02-07 21:45:38,0.032268518518518516,1,2,0,2
2023-02-07 21:43:19,0.19137731481481482,6,69,14,83
2023-02-10 14:44:15,2.8400810185185184,2,6,9,15
2023-02-07 20:00:50,1.1861458333333332,10,3221,4000,7221
2023-02-07 17:27:31,0.1071875,4,26,832,858
2023-02-07 14:39:25,0.03648148148148148,1,1,1,2
2023-02-07 15:44:43,0.10574074074074075,3,7,3,10
2023-02-07 17:27:06,0.1910763888888889,6,42,33,75
2023-02-07 14:31:33,0.1842939814814815,1,1,1,2
2023-02-07 14:09:27,0.22270833333333334,1,1,1,2
2023-02-10 16:31:50,3.354699074074074,1,3,0,3
2023-02-07 18:51:46,0.7719097222222222,2,4,2,6
2023-02-06 23:27:14,0.054907407407407405,1,1,1,2
2023-02-06 23:10:56,0.14327546296296295,9,1533,2688,4221
2023-02-10 09:26:17,3.5813888888888887,15,142,91,233
2023-02-07 00:34:34,0.2080787037037037,1,4,2,6
2023-02-06 18:19:18,0.03480324074074074,2,16,12,28
2023-02-17 18:26:37,11.06505787037037,2,2,2,4
2023-02-07 11:18:24,0.7799074074074074,2,183,196,379
2023-02-09 12:52:30,2.916516203703704,1,68,20,88
2023-02-06 16:33:21,0.13091435185185185,2,5,15,20
2023-03-24 19:45:58,60.08649305555556,21,113732,19820,133552
2023-02-06 14:43:56,0.17043981481481482,2,14,6,20
2023-02-06 16:36:13,0.6401736111111112,1,15,10,25
2023-02-08 18:48:46,2.9496296296296296,15,68,59,127
2023-02-06 09:43:08,0.6227777777777778,2,2,2,4
2023-02-10 14:12:57,5.185023148148148,7,7943,4586,12529
2023-02-06 17:25:50,1.9268402777777778,6,606,29,635
2023-02-06 14:26:23,1.8164120370370371,1,4,4,8
2023-02-06 15:44:48,2.185775462962963,2,81,19,100
2023-02-07 16:49:31,0.3142013888888889,8,284,20,304
2023-02-06 14:24:19,2.2938194444444444,1,5,2,7
2023-02-07 15:19:20,3.7145949074074074,3,9,9,18
2023-02-07 00:39:14,3.147291666666667,3,147,12,159
2023-02-03 20:32:48,0.028310185185185185,1,1,1,2
2023-02-10 21:54:41,7.100671296296296,6,450,449,899
2023-02-03 21:01:25,0.08709490740740741,2,3,3,6
2023-02-07 08:51:36,3.604560185185185,6,219,189,408
2023-02-09 15:52:11,9.128668981481482,70,6363,2893,9256
2023-02-03 14:12:29,0.21292824074074074,1,1,1,2
2023-02-03 17:57:02,0.44381944444444443,1,3,1,4
2023-02-13 15:20:19,10.54474537037037,6,34,33,67
2023-02-09 20:46:26,7.009548611111111,14,322,168,490
2023-02-03 12:31:14,0.6883217592592593,1,15,6,21
2023-02-03 19:07:42,0.9799189814814815,16,247,82,329
2023-02-03 16:57:34,0.9611458333333334,7,30,31,61
2023-03-02 17:12:19,28.222997685185184,19,1257,867,2124
2023-02-02 16:41:23,0.03373842592592593,2,5,2,7
2023-02-17 17:57:06,15.089178240740742,3,35283,6865,42148
2023-02-06 19:25:41,4.173194444444444,4,35,7,42
2023-02-02 18:51:54,0.16082175925925926,1,1,1,2
2023-02-02 14:29:58,0.03733796296296296,2,9,9,18
2023-02-02 13:58:53,0.03193287037037037,1,3,3,6
2023-02-02 15:29:14,3.1135069444444445,4,8110,692,8802
2023-03-13 10:11:32,39.054351851851855,34,3671,1898,5569
2023-02-06 14:27:34,4.297835648148149,3,20,4,24
2023-02-02 14:20:53,0.5706134259259259,1,2,0,2
2023-02-02 18:06:27,0.7319212962962963,1,9,0,9
2023-02-15 18:35:14,13.967708333333333,8,499,972,1471
2023-02-20 08:06:24,38.610104166666666,18,383,282,665
2023-02-01 21:50:39,0.23358796296296297,6,99,83,182
2023-02-01 18:51:47,14.584097222222223,27,61290,13042,74332
2023-02-02 18:03:32,1.2194328703703703,20,83,51,134
2023-03-22 15:53:53,52.234155092592594,160,99654,18078,117732
2023-02-01 14:47:25,0.25168981481481484,5,38,27,65
2023-02-01 13:03:01,0.7641550925925926,1,2,2,4
2023-02-03 12:41:16,2.762048611111111,5,5,67,72
2023-02-01 15:22:05,0.9543518518518519,5,42,16,58
2023-01-31 15:49:34,0.02508101851851852,1,11,0,11
2023-01-31 14:05:23,0.11611111111111111,1,5,0,5
2023-02-27 10:46:02,27.00644675925926,14,53675,8998,62673
2023-01-31 14:13:13,0.18336805555555555,2,17,5,22
2023-01-31 14:23:47,0.16174768518518517,3,6,18,24
2023-01-31 16:32:26,0.053252314814814815,2,100,6,106
2023-02-03 13:53:16,6.510509259259259,8,9460,1047,10507
2023-01-30 16:19:30,0.02732638888888889,1,1,1,2
2023-02-16 19:59:28,17.239618055555557,227,56614,20879,77493
2023-02-03 10:24:02,3.8993171296296296,9,136,132,268
2023-01-30 20:48:05,0.33493055555555556,1,2,2,4
2023-01-30 15:55:00,0.21261574074074074,3,24,12,36
2023-01-30 09:37:57,0.1077199074074074,1,2,3,5
2023-01-30 14:23:56,1.2635300925925925,1,2,1,3
2023-01-30 15:03:19,1.3911342592592593,1,0,3,3
2023-01-30 21:50:58,1.7260532407407407,1,396,0,396
2023-01-30 14:38:15,1.497824074074074,1,3,3,6
2023-02-15 14:24:57,17.82675925925926,30,5529,3195,8724
2023-01-31 11:33:18,2.822395833333333,4,85,58,143
2023-01-30 17:53:54,2.129884259259259,3,38,68,106
2023-02-02 14:33:05,5.655405092592592,6,8414,958,9372
2023-01-30 22:01:36,2.9889467592592593,6,133,72,205
2023-02-08 16:36:44,14.870138888888889,12,787,517,1304
2023-01-27 18:19:29,0.9773611111111111,7,703,336,1039
2023-01-27 15:20:25,0.08202546296296297,4,6,8,14
2023-01-31 12:54:17,4.070231481481481,21,185,133,318
2023-01-27 17:09:50,0.31015046296296295,5,81,60,141
2023-02-01 08:21:53,5.301909722222222,8,222,43,265
2023-01-27 15:13:13,0.5875578703703703,1,1,1,2
2023-02-02 19:45:36,6.993206018518518,17,906,382,1288
2023-01-27 09:43:19,0.6861111111111111,3,206,206,412
2023-01-31 15:35:39,4.970393518518518,16,4,136,140
2023-01-27 15:35:17,1.010324074074074,3,5,6,11
2023-01-26 16:06:05,0.018252314814814815,1,6,3,9
2023-01-26 16:16:38,0.17502314814814815,1,2,2,4
2023-01-26 13:50:09,0.18640046296296298,1,3,0,3
2023-01-26 14:33:47,0.19894675925925925,2,38,0,38
2023-01-26 11:07:08,0.09934027777777778,1,2,2,4
2023-01-26 18:34:40,0.807349537037037,1,1,1,2
2023-01-25 19:46:08,0.029583333333333333,1,5,2,7
2023-01-25 21:49:23,0.18498842592592593,3,37,40,77
2023-01-26 10:31:31,0.7606018518518518,5,56,52,108
2023-01-25 16:33:40,1.0073726851851852,7,33,19,52
2023-01-26 15:56:42,0.051215277777777776,1,3,3,6
2023-01-25 15:36:32,0.08087962962962963,2,2,1,3
2023-02-24 10:07:52,29.938449074074075,13,311,20,331
2023-01-25 16:28:29,0.165,1,1,1,2
2023-01-25 17:25:59,0.2072337962962963,1,4,4,8
2023-01-25 16:27:03,0.2745023148148148,4,7,7,14
2023-01-25 15:09:16,0.2416087962962963,4,11,7,18
2023-01-25 14:46:10,0.22893518518518519,1,134,8,142
2023-02-20 10:25:28,42.33068287037037,56,452857,381371,834228
2023-02-02 15:39:23,8.781377314814815,15,162,87,249
2023-01-24 19:48:24,0.03314814814814815,3,6,5,11
2023-01-24 21:32:32,0.16150462962962964,1,9,9,18
2023-01-24 17:54:34,0.02931712962962963,1,1,1,2
2023-01-25 09:14:19,0.6812384259259259,2,24,5,29
2023-01-24 17:14:39,0.026354166666666668,2,76,2,78
2023-01-24 15:07:50,0.11496527777777778,1,1,1,2
2023-01-24 18:27:57,0.36180555555555555,1,10,3,13
2023-01-24 10:18:48,0.03984953703703704,1,1,1,2
2023-01-24 15:37:10,0.5673842592592593,1,1,1,2
2023-01-30 21:48:04,7.040694444444444,7,40,23,63
2023-01-24 18:04:43,0.8864236111111111,8,62,22,84
2023-01-23 19:23:20,0.049837962962962966,3,30,13,43
2023-02-10 14:15:17,17.841041666666666,5,30771,8163,38934
2023-01-24 13:37:49,0.8440277777777778,1,8,8,16
2023-01-23 17:51:24,0.08581018518518518,2,55,12,67
2023-01-23 16:21:44,0.038287037037037036,1,117,3,120
2023-03-02 13:17:22,37.912893518518516,10,80904,15296,96200
2023-04-27 09:03:42,79.97209490740741,14,116732,15494,132226
2023-01-23 15:27:26,0.0990162037037037,1,1,0,1
2023-01-23 18:32:50,0.29065972222222225,4,2133,1066,3199
2023-01-24 15:49:30,1.1228703703703704,6,7659,4838,12497
2023-01-23 14:34:14,0.07153935185185185,4,9,11,20
2023-01-25 12:09:44,2.0602430555555555,17,8401,5289,13690
2023-01-23 11:13:51,0.020787037037037038,1,6,6,12
2023-01-23 19:19:57,0.3640162037037037,2,7,4,11
2023-01-23 14:19:28,0.7697453703703704,2,13,2,15
2023-01-23 14:38:31,1.190162037037037,2,243,1,244
2023-01-31 14:51:36,9.97482638888889,26,175,114,289
2023-01-23 14:28:00,2.0055092592592594,4,8,4,12
2023-01-25 11:34:44,4.106377314814814,4,122,40,162
2023-01-23 14:54:46,2.387048611111111,1,1,0,1
2023-01-21 01:46:12,0.003298611111111111,1,1,0,1
2023-01-23 19:33:19,2.8980787037037037,6,2970,2362,5332
2023-01-20 22:16:42,0.028425925925925927,3,19,28,47
2023-01-23 18:32:16,3.126550925925926,6,282,30,312
2023-02-21 05:58:55,31.462766203703705,20,68674,13927,82601
2023-01-20 20:33:44,0.14997685185185186,2,8,0,8
2023-01-23 17:21:33,4.058912037037037,3,144,98,242
2023-01-23 10:16:24,2.7364699074074075,2,17,4,21
2023-01-24 09:41:17,3.7158564814814814,1,6,1,7
2023-01-20 16:37:12,0.02318287037037037,2,7,7,14
2023-01-20 14:35:01,0.0253125,1,1,1,2
2023-01-20 14:16:00,0.12842592592592592,2,6,6,12
2023-01-20 14:54:34,0.19270833333333334,4,12,9,21
2023-01-20 14:22:10,0.35333333333333333,1,1,2,3
2023-01-20 15:38:16,0.7010300925925926,1,1,1,2
2023-01-20 17:58:08,0.9569560185185185,5,211,137,348
2023-01-20 18:19:59,0.9636574074074075,4,49,218,267
2023-01-20 09:31:40,0.6817245370370371,6,3627,305,3932
2023-01-19 16:43:43,2.1913541666666667,4,23,23,46
2023-01-20 09:15:26,0.7403587962962963,2,2,2,4
2023-01-23 18:45:28,4.1171875,4,130,73,203
2023-01-19 14:46:08,0.04052083333333333,1,0,0,0
2023-01-19 16:36:39,0.10666666666666667,1,6,5,11
2023-01-19 13:26:14,0.011747685185185186,1,2,2,4
2023-01-20 12:50:02,1.733252314814815,8,211,87,298
2023-01-19 12:16:28,0.006678240740740741,2,2,2,4
2023-01-19 12:51:00,0.04408564814814815,1,33,33,66
2023-01-19 15:21:09,0.15359953703703705,1,6,6,12
2023-01-19 15:25:56,44.11924768518519,76,64282,9187,73469
2023-01-19 16:53:28,0.32481481481481483,3,569,172,741
2023-01-19 13:43:37,0.8192824074074074,7,77,21,98
2023-01-19 19:16:16,1.0130439814814816,3,32,27,59
2023-01-18 17:53:06,0.013171296296296296,2,3,3,6
2023-01-19 09:15:08,0.6877893518518519,1,1,1,2
2024-05-01 15:39:55,468.97572916666667,1,1,1,2
2023-01-18 16:17:36,0.0018981481481481482,1,1,1,2
2024-05-01 15:40:55,468.97648148148147,1,1,1,2
2024-05-01 17:16:26,469.0428703703704,1,1,1,2
2024-05-01 15:40:19,468.97613425925925,1,1,1,2
2023-01-18 16:16:44,0.0014236111111111112,1,1,1,2
2024-05-01 19:14:57,469.12518518518516,2,678353,164072,842425
2024-05-01 17:37:56,469.05782407407406,1,1,1,2
2023-01-18 15:54:25,0.08616898148148149,4,6,4,10
2023-01-20 13:11:01,0.8471527777777778,28,210,233,443
2023-01-18 14:43:55,0.4428587962962963,2,3,3,6
2023-01-18 14:05:26,0.7012268518518519,3,5,5,10
2023-01-18 16:14:01,0.8093865740740741,4,105,95,200
2023-01-20 15:41:33,2.863287037037037,3,108,52,160
2023-01-19 15:14:58,29.09803240740741,3,129,142,271
2023-01-17 16:36:47,0.04497685185185185,1,2,2,4
2023-01-17 16:29:23,0.06275462962962963,1,6,6,12
2023-01-18 14:24:54,1.0949537037037036,3,44,48,92
2023-01-17 13:42:53,0.1005787037037037,1,2,0,2
2023-01-18 14:41:29,1.3246296296296296,1,6,2,8
2023-01-26 10:15:26,9.63511574074074,3,229,114,343
2023-01-17 12:18:57,27.96752314814815,3,5,5,10
2023-01-17 14:08:00,0.9755555555555555,4,175,3,178
2023-01-17 14:04:08,1.065752314814815,2,4,4,8
2023-01-16 14:12:43,0.02701388888888889,2,2,0,2
2023-01-16 14:09:53,0.13777777777777778,1,0,3,3
2023-01-16 14:37:39,2.870439814814815,3,50,16,66
2023-01-16 14:04:28,0.19913194444444443,8,56,22,78
2023-01-17 14:06:04,1.5864814814814814,1,6,9,15
2023-01-15 09:56:31,0.8904398148148148,1,1,1,2
2023-01-16 13:26:57,2.1233680555555554,1,0,5,5
2023-01-17 18:04:32,3.486435185185185,9,254,81,335
2023-01-15 10:03:31,1.613587962962963,1,1,1,2
2023-01-17 14:24:41,3.8396412037037035,5,83,20,103
2023-01-17 17:23:49,5.018263888888889,4,171,383,554
2023-01-16 08:39:36,2.673020833333333,1,2,2,4
2023-01-16 14:29:51,3.0972916666666666,1,10,0,10
2023-01-20 11:18:11,6.9695833333333335,2,160,262,422
2023-01-18 09:43:06,4.976469907407408,1,1,0,1
2023-01-13 15:21:35,0.2641435185185185,3,3,3,6
2023-01-13 09:03:19,0.6669907407407407,1,9,0,9
2023-03-07 20:36:39,70.2422800925926,181,119621,28248,147869
2023-01-17 14:23:48,5.528182870370371,5,21,12,33
2023-01-17 17:23:22,6.001574074074074,12,449,141,590
2023-01-11 16:51:41,0.13724537037037038,1,1,1,2
2023-01-18 09:08:19,7.008877314814815,4,222,44,266
2023-01-12 09:01:18,1.0321296296296296,2,7,6,13
2023-01-10 18:24:10,0.7570254629629629,1,2,2,4
2023-01-18 14:40:24,8.612719907407408,6,58,51,109
2023-02-02 19:41:27,23.967789351851852,14,539,246,785
2023-01-11 13:22:27,1.7800462962962964,1,1,0,1
2023-01-16 14:06:36,6.9465972222222225,1,1,1,2
2023-01-12 09:03:14,1.6492476851851852,1,26,1,27
2023-01-14 08:25:05,5.4124537037037035,11,180,113,293
2023-01-09 17:12:14,1.251875,3,5,8,13
2023-01-08 09:55:23,0.007951388888888888,1,1,1,2
2023-01-08 09:03:01,0.03571759259259259,1,1,1,2
2023-01-18 12:49:40,11.313622685185186,21,3793,772,4565
2023-01-16 14:02:09,9.17798611111111,1,17,1,18
2023-01-07 09:13:26,0.1329050925925926,1,8,8,16
2023-01-17 17:20:09,10.938819444444444,19,556,313,869
2023-01-08 11:33:25,1.7795370370370371,1,0,1,1
2023-01-10 17:43:22,4.080775462962963,12,87,45,132
2023-01-06 12:23:16,0.3958333333333333,1,1,1,2
2023-01-12 16:52:55,6.744479166666666,10,101,91,192
2023-01-19 01:23:36,13.163935185185185,2,2,2,4
2023-01-06 12:19:43,0.7080092592592593,1,1,1,2
2023-04-27 17:52:28,112.1911574074074,19,189941,29237,219178
2023-01-05 18:02:10,0.16284722222222223,1,6,6,12
2023-01-18 10:24:38,12.851041666666667,7,370,21,391
2023-02-22 06:50:14,97.7928125,44,140660,29370,170030
2023-01-05 11:38:38,0.01597222222222222,1,6,6,12
2023-01-13 19:01:54,8.810115740740741,6,229,1127,1356
2023-01-04 20:36:42,0.005231481481481481,1,1,1,2
2023-01-04 20:36:33,0.005185185185185185,1,1,1,2
2023-01-05 11:52:58,0.6501041666666667,2,29,17,46
2023-01-05 12:30:25,0.6887384259259259,2,82,26,108
2023-01-05 15:41:37,0.8288773148148149,2,224,184,408
2023-01-04 19:01:52,0.021006944444444446,1,1,1,2
2023-01-04 20:59:24,0.10722222222222222,3,84,85,169
2023-01-04 18:33:16,0.017858796296296296,1,1,1,2
2023-01-04 20:26:57,0.09967592592592593,2,12,12,24
2023-01-04 20:28:33,0.13277777777777777,4,3,5,8
2023-01-12 12:32:05,7.905474537037037,8,0,34,34
2023-01-04 17:05:36,0.04331018518518519,1,2,5,7
2023-01-04 17:04:34,0.08979166666666667,1,1,1,2
2023-01-05 13:30:33,1.0640625,1,2,2,4
2023-01-04 18:23:21,7.103472222222222,8,472,606,1078
2023-01-14 18:47:32,10.410752314814815,4,6948,1550,8498
2023-01-03 20:16:12,0.11961805555555556,2,4,4,8
2023-01-03 16:16:52,0.018819444444444444,1,4,4,8
2023-01-05 16:24:56,2.0508912037037037,1,45,3,48
2023-01-03 15:10:59,0.017094907407407406,1,1,1,2
2023-01-31 09:43:11,45.50402777777778,58,7379,1580,8959
2023-01-03 15:19:38,0.04415509259259259,6,27,12,39
2023-01-03 16:25:09,0.1250925925925926,2,88,19,107
2023-01-03 12:56:02,0.06978009259259259,1,18,17,35
2023-02-08 14:19:07,36.168946759259256,1,8,7,15
2023-02-06 14:20:43,34.27427083333333,8,144,141,285
2023-01-03 14:33:12,0.36040509259259257,3,22,5,27
2023-01-09 17:17:16,6.558634259259259,2,6,4,10
2023-01-06 12:22:20,3.6105439814814817,4,10695,1181,11876
2023-01-19 18:06:00,17.169560185185187,53,17420,3872,21292
2023-01-12 17:04:22,13.893043981481481,4,90,57,147
2023-01-17 13:07:38,15.060219907407408,2,18,10,28
2023-01-03 10:54:57,1.0144097222222221,1,0,207,207
2023-01-04 14:01:08,39.23146990740741,1,0,3,3
2023-01-03 14:43:26,38.28893518518519,2,2,5,7
2023-01-03 10:53:33,2.1193055555555556,1,1,1,2
2022-12-31 06:13:39,0.4481134259259259,2,66,17,83
2022-12-31 05:55:12,0.45792824074074073,1,1,1,2
2023-01-04 18:51:54,5.026261574074074,1,1860,26,1886
2023-01-18 09:05:24,18.733414351851852,1,243,0,243
2023-01-26 13:10:03,71.01931712962963,1,538,0,538
2022-12-30 08:44:10,0.04351851851851852,1,1,1,2
2023-01-08 09:21:41,9.08337962962963,14,11855,3077,14932
2023-02-10 14:32:07,42.94324074074074,21,3423,375,3798
2023-01-06 12:27:30,8.005555555555556,3,65023,12567,77590
2022-12-30 07:37:37,0.8027083333333334,2,4,4,8
2022-12-29 07:36:28,0.017013888888888887,1,614,13,627
2022-12-29 07:12:40,425.38444444444445,2,14,14,28
2023-01-02 10:25:44,4.664965277777778,6,186,1183,1369
2022-12-30 07:35:01,1.6382291666666666,2,332505,39905,372410
2023-01-04 13:36:38,6.908738425925926,26,1034,448,1482
2022-12-29 07:18:04,0.9518518518518518,1,1,1,2
2022-12-29 07:19:25,1.5733449074074075,6,20,10,30
2022-12-28 10:05:26,0.8152893518518518,1,1,1,2
2023-01-23 13:41:43,27.306527777777777,5,85,73,158
2023-04-12 11:33:20,49.9925462962963,113,70150,12071,82221
2023-01-04 16:59:11,8.85113425925926,1,1,1,2
2022-12-27 07:49:16,0.6541087962962963,1,5,5,10
2022-12-27 07:26:14,0.8885648148148149,1,1,1,2
2023-01-03 11:29:02,9.579050925925927,12,125,26,151
2022-12-26 07:06:24,1.668761574074074,1,1,1,2
2022-12-31 06:22:27,6.715358796296297,7,46,35,81
2022-12-23 18:55:17,0.06890046296296297,1,1,1,2
2023-01-04 09:15:45,11.694398148148148,4,7848,1775,9623
2022-12-24 07:07:07,0.7711921296296296,1,1,1,2
2022-12-26 09:01:04,3.554409722222222,4,25,16,41
2023-01-05 12:24:32,13.711354166666666,9,21,21,42
2023-01-17 16:42:34,26.12787037037037,5,39,2,41
2022-12-23 13:39:43,1.1855902777777778,2,170,170,340
2022-12-23 06:30:48,0.8996064814814815,1,2,2,4
2022-12-23 06:30:58,1.056863425925926,1,39,2,41
2023-01-04 14:29:48,13.692222222222222,4,485,112,597
2022-12-22 07:06:50,0.4878125,1,2,2,4
2022-12-23 09:18:46,1.6443634259259259,10,98,75,173
2022-12-21 17:40:14,0.014189814814814815,1,1,1,2
2022-12-27 17:37:26,6.14025462962963,9,56,9,65
2022-12-22 17:52:54,1.327349537037037,2,8,3,11
2022-12-21 13:29:13,0.1504398148148148,2,12,5,17
2023-01-03 13:37:40,0.9076273148148148,1,0,16,16
2022-12-21 10:51:24,0.1127662037037037,1,20,4,24
2023-01-25 09:16:32,35.71828703703704,9,355,264,619
2022-12-21 13:04:08,0.9158680555555555,1,1,1,2
2022-12-20 13:40:45,0.022847222222222224,2,6,6,12
2022-12-21 10:34:31,0.9982523148148148,1,13,12,25
2022-12-20 15:46:44,0.22152777777777777,1,0,12,12
2022-12-21 15:34:31,1.3875462962962963,6,23,26,49
2022-12-20 08:18:00,0.32108796296296294,4,5,5,10
2022-12-20 16:42:26,0.821412037037037,3,6,4,10
2022-12-20 08:16:27,0.5105439814814815,1,1,1,2
2022-12-28 07:24:54,8.509421296296296,2,1,1,2
2022-12-20 09:09:35,0.6330208333333334,1,0,11,11
2022-12-20 10:23:36,0.7114236111111111,2,48,48,96
2023-01-23 11:15:47,45.12196759259259,16,782,164,946
2022-12-21 09:09:50,1.9191319444444443,4,40,30,70
2023-01-04 19:13:41,16.379247685185184,15,22531,2234,24765
2022-12-21 17:18:34,2.3010532407407407,2,11,6,17
2022-12-22 10:11:20,3.0104166666666665,10,128,67,195
2023-02-07 16:35:31,50.301458333333336,8,80881,17024,97905
2022-12-19 16:25:16,0.7422453703703704,2,3,3,6
2022-12-21 12:23:45,3.520046296296296,7,55,18,73
2023-01-18 16:21:20,85.66297453703703,12,68356,14339,82695
2022-12-21 19:18:46,5.147002314814815,3,15274,259,15533
2022-12-19 09:37:15,2.7882291666666665,2,31,27,58
2022-12-23 13:36:47,7.0102314814814815,4,251,30,281
2022-12-21 15:28:43,5.13818287037037,3,7,4,11
2022-12-16 12:25:37,0.11747685185185185,3,19,24,43
2022-12-19 08:37:20,2.9726157407407405,1,3,1,4
2022-12-16 17:23:47,0.35030092592592593,2,3,3,6
2023-01-16 17:37:08,153.3484837962963,112,280081,57637,337718
2022-12-20 18:26:52,4.79318287037037,3,9,4,13
2022-12-16 11:46:59,0.5707060185185185,1,6,1,7
2022-12-15 20:35:28,0.11805555555555555,1,5,0,5
2022-12-20 18:13:56,5.028206018518518,2,42,40,82
2022-12-16 13:10:07,0.8326851851851852,1,4,2,6
2023-01-23 13:48:31,38.85629629629629,8,549,350,899
2022-12-15 18:47:04,0.09880787037037037,2,63,66,129
2022-12-19 11:43:07,3.9616666666666664,1,30,44,74
2022-12-15 17:46:00,0.26157407407407407,1,2,2,4
2022-12-15 17:47:05,0.2958912037037037,1,1,1,2
2022-12-15 17:46:44,0.2991435185185185,2,13,16,29
2023-01-25 19:04:33,62.93232638888889,180,171893,42977,214870
2022-12-15 10:16:38,0.6677662037037037,1,1,1,2
2022-12-14 18:35:28,0.09729166666666667,3,258,43,301
2023-01-23 17:25:41,4.043541666666667,15,2338,2366,4704
2022-12-16 13:22:47,1.9941319444444445,7,152,108,260
2022-12-14 14:26:07,0.2334837962962963,1,2,2,4
2022-12-14 16:30:36,0.2970138888888889,1,1,2,3
2022-12-15 09:05:55,1.0073263888888888,2,10,2,12
2022-12-15 17:26:58,1.6298842592592593,4,21,16,37
2022-12-13 21:25:48,0.11200231481481482,1,3,0,3
2023-01-14 08:49:37,31.641875,6,85,206,291
2022-12-14 14:36:05,0.9121296296296296,4,459,87,546
2022-12-14 10:37:30,0.9153356481481482,1,3,3,6
2022-12-13 18:08:30,0.060335648148148145,1,3,28,31
2022-12-13 17:25:56,6.65349537037037,6,2372,137,2509
2022-12-12 18:25:27,0.021006944444444446,2,5,2,7
2022-12-12 19:02:16,0.08387731481481482,1,3,3,6
2022-12-13 12:51:08,0.8298032407407407,3,8,2,10
2022-12-12 16:14:04,0.049039351851851855,2,4,0,4
2022-12-12 18:13:10,0.15127314814814816,2,3,3,6
2022-12-12 14:37:44,0.058298611111111114,1,5,2,7
2022-12-12 14:39:13,0.06355324074074074,1,5,0,5
2022-12-13 13:55:08,1.119525462962963,1,0,2,2
2023-01-03 20:18:25,30.662453703703704,35,33553,4024,37577
2023-01-03 14:59:08,22.97939814814815,4,47,2,49
2023-02-15 18:10:30,51.31482638888889,250,93231,24512,117743
2022-12-19 18:59:34,9.140995370370371,17,78,50,128
2022-12-12 14:43:44,1.9424305555555557,1,1,1,2
2022-12-12 14:22:08,2.9220023148148146,2,726,48,774
2022-12-12 15:07:53,2.357083333333333,1,1,2,3
2022-12-21 08:39:10,12.757546296296296,103,23110,4108,27218
2022-12-14 14:38:44,4.769189814814815,2,38,66,104
2022-12-12 18:12:56,3.052986111111111,1,2,0,2
2022-12-12 17:43:46,3.1409375,4,66,48,114
2022-12-13 12:42:37,3.8716550925925928,3,14,6,20
2022-12-09 18:51:35,0.14501157407407408,2,5,2,7
2022-12-09 15:46:32,0.051215277777777776,3,3,3,6
2022-12-14 10:17:11,4.830810185185185,1,1,14,15
2022-12-09 12:24:00,0.010833333333333334,1,14,14,28
2022-12-14 13:41:41,5.130416666666667,4,9,34,43
2022-12-09 10:10:00,0.6526273148148148,1,11,1,12
2022-12-12 19:04:57,4.140046296296297,1,16,12,28
2022-12-08 17:51:55,0.05790509259259259,4,21,18,39
2022-12-08 17:34:40,0.5013194444444444,1,5,4,9
2022-12-13 10:59:58,4.811701388888889,20,225,93,318
2022-12-08 16:19:11,0.04928240740740741,1,1,1,2
2022-12-08 15:26:10,0.03059027777777778,1,7,7,14
2022-12-08 16:39:33,0.09715277777777778,4,49,16,65
2022-12-08 16:15:11,0.09078703703703704,1,1,1,2
2022-12-09 08:14:53,0.7942708333333334,5,34,14,48
2022-12-08 16:15:43,0.16618055555555555,1,1,1,2
2022-12-08 16:14:54,0.1827314814814815,1,1,1,2
2022-12-12 17:16:14,4.801608796296296,2,8,6,14
2022-12-08 14:33:08,0.7976273148148149,2,16,15,31
2022-12-08 15:55:48,0.8812268518518519,4,27,17,44
2022-12-08 11:41:34,0.8117129629629629,2,6,4,10
2022-12-08 13:56:00,0.9304398148148149,3,27,21,48
2022-12-07 14:57:40,0.04344907407407408,1,3,3,6
2022-12-13 16:06:59,6.079710648148148,12,476,87,563
2022-12-07 16:44:13,0.12170138888888889,2,7,3,10
2022-12-07 14:30:57,0.026261574074074073,3,9,2,11
2022-12-07 14:35:38,0.060833333333333336,2,4,10,14
2023-01-16 08:39:14,56.78938657407407,75,3894,2173,6067
2023-01-17 16:18:56,41.20503472222222,12,336,65,401
2022-12-07 16:01:55,0.24291666666666667,18,1125,225,1350
2022-12-07 14:46:49,0.2969675925925926,1,2,2,4
2022-12-07 14:51:02,0.29583333333333334,1,1,1,2
2022-12-06 23:28:59,0.023391203703703702,1,4,4,8
2022-12-08 16:18:53,1.796736111111111,4,77,22,99
2022-12-06 20:46:41,0.010416666666666666,1,1,1,2
2022-12-06 21:23:07,0.05797453703703704,1,0,2,2
2022-12-06 20:18:59,0.034525462962962966,1,30,0,30
2023-01-17 18:06:20,41.95155092592593,6,13,5,18
2022-12-08 19:10:41,2.1602199074074075,6,63,19,82
2022-12-07 14:46:12,0.9537847222222222,2,16,10,26
2022-12-21 11:46:04,14.929918981481482,2,6,2,8
2023-01-17 14:50:09,42.09439814814815,70,32315,5304,37619
2022-12-06 15:14:03,7.238090277777777,6,22050,8581,30631
2022-12-06 12:32:47,0.38712962962962966,1,4,4,8
2022-12-06 12:36:25,0.4057060185185185,1,14,6,20
2022-12-06 22:25:27,0.9360763888888889,1,16,1,17
2022-12-05 23:33:56,0.016585648148148148,1,1,1,2
2022-12-08 15:05:43,2.750150462962963,2,73,77,150
2022-12-06 17:16:17,0.8896180555555555,1,13,4,17
2022-12-06 12:54:40,6.242743055555556,4,201,43,244
2022-12-05 19:02:57,0.04693287037037037,6,302,115,417
2022-12-05 18:45:22,0.05670138888888889,2,24,4,28
2022-12-06 14:48:50,0.8930902777777778,4,4,11,15
2022-12-05 17:04:33,0.04524305555555556,1,0,24,24
2022-12-05 17:23:36,0.0717824074074074,2,30,30,60
2022-12-06 12:44:18,0.5716550925925926,1,28,21,49
2022-12-09 10:48:34,3.8983680555555558,10,706,400,1106
2022-12-05 14:54:05,0.11712962962962963,1,10,32,42
2022-12-05 15:50:38,5.909641203703703,3,18323,7509,25832
2022-12-05 13:53:49,0.09590277777777778,2,30,30,60
2022-12-05 15:07:26,0.15033564814814815,1,2,0,2
2022-12-05 15:06:39,0.16240740740740742,1,2,0,2
2022-12-05 12:57:34,0.1166087962962963,1,4,4,8
2023-01-19 08:31:08,48.424421296296295,80,18100,9939,28039
2022-12-07 17:05:39,37.91858796296296,36,37607,10455,48062
2022-12-12 14:23:24,8.853981481481481,18,658,29,687
2022-12-08 19:55:22,5.045868055555555,10,11100,1552,12652
2022-12-12 15:38:57,9.010798611111111,11,13991,2098,16089
2022-12-05 19:49:43,2.8490277777777777,2,25,50,75
2022-12-05 16:43:28,2.8533333333333335,2,6,7,13
2022-12-05 20:28:44,3.0303819444444446,3,155,131,286
2022-12-05 16:43:04,2.8931944444444446,1,5,5,10
2022-12-05 16:42:29,2.901122685185185,1,1,1,2
2022-12-05 13:00:06,2.7614236111111112,1,2,2,4
2022-12-02 18:27:47,0.04179398148148148,1,1,1,2
2022-12-05 14:12:10,2.842928240740741,3,0,19,19
2022-12-06 12:37:02,3.973402777777778,1,42,6,48
2022-12-05 14:10:18,3.1140856481481483,1,5,0,5
2022-12-07 10:03:39,7.068483796296296,99,10194,2524,12718
2022-12-05 17:25:14,3.5024652777777776,3,9,9,18
2022-12-05 14:08:32,3.326701388888889,1,2,0,2
2022-12-05 16:23:15,12.516400462962963,9,491,760,1251
2022-12-07 18:23:17,5.913703703703704,1,2,0,2
2022-12-05 15:56:17,3.8812962962962962,10,117,100,217
2022-12-06 15:54:40,4.944039351851852,4,89,89,178
2022-12-05 18:10:54,4.033530092592593,17,351,263,614
2022-12-02 14:03:30,2.050289351851852,6,189,22,211
2022-12-01 17:19:37,0.10572916666666667,1,6,1,7
2022-12-01 15:50:00,0.18010416666666668,1,1,1,2
2022-12-09 09:42:02,7.968414351851852,15,785,688,1473
2022-12-01 15:53:24,0.23261574074074073,2,2,2,4
2022-12-01 15:49:05,0.23631944444444444,1,1,1,2
2022-12-01 15:52:13,0.24645833333333333,1,12,0,12
2022-12-01 15:38:42,0.2608564814814815,1,1,1,2
2022-12-01 17:04:19,0.36211805555555554,1,25,3,28
2022-12-01 17:03:17,0.3537037037037037,1,1,1,2
2022-12-05 16:39:09,4.460127314814815,2,40,3,43
2022-12-01 17:58:45,0.7094444444444444,3,5,4,9
2022-12-01 17:22:23,0.6990856481481481,1,4,4,8
2022-11-30 20:42:17,0.014814814814814815,1,9,0,9
2022-11-30 18:48:19,0.07508101851851852,1,1,1,2
2022-11-30 18:49:34,0.09181712962962962,1,3,0,3
2022-11-30 20:03:47,0.1604398148148148,2,6,6,12
2022-11-30 15:41:19,0.06194444444444445,1,8,8,16
2022-11-30 14:47:54,0.05721064814814815,6,27,11,38
2022-12-01 10:52:18,1.001886574074074,1,2,2,4
2022-11-30 13:58:02,0.316724537037037,1,3,2,5
2022-11-30 14:50:56,0.848587962962963,2,498,459,957
2022-11-30 16:10:45,0.8466666666666667,2,53,73,126
2022-11-29 19:58:30,0.030648148148148147,1,19,6,25
2022-11-30 09:55:43,0.6526388888888889,2,3,1,4
2022-11-30 09:55:07,0.6596527777777778,1,2,2,4
2022-11-30 14:07:28,0.8379976851851851,1,2,2,4
2022-11-30 13:43:47,1.2921412037037037,1,3,1,4
2022-11-29 18:30:26,0.06921296296296296,1,1,1,2
2022-11-29 16:35:13,0.015046296296296295,1,1,1,2
2022-11-30 16:10:56,1.0942361111111112,1,2,2,4
2022-11-30 10:46:02,0.9444675925925926,2,0,7,7
2022-11-29 14:58:55,0.19859953703703703,1,156,49,205
2022-12-02 08:05:45,2.940659722222222,3,10,9,19
2022-12-07 08:42:38,8.007893518518518,18,1175,391,1566
2023-02-20 08:17:40,83.41965277777778,125,175241,37836,213077
2022-11-29 16:34:09,13.865532407407407,2,11,7,18
2022-11-29 14:46:10,0.7962037037037037,2,178,169,347
2022-11-29 13:38:23,0.8711689814814815,8,120,96,216
2022-11-28 20:14:34,0.14483796296296297,5,119,6,125
2022-11-28 16:08:57,0.16842592592592592,1,3,3,6
2022-11-28 10:13:34,0.024120370370370372,1,1,1,2
2022-11-28 09:41:29,0.024108796296296295,1,3,3,6
2022-11-28 14:44:04,10.549155092592592,22,1250,1236,2486
2023-01-20 08:35:43,177.94600694444443,34,276574,46682,323256
2022-11-28 14:20:14,2.8053819444444446,1,1,1,2
2022-11-26 00:04:01,0.23413194444444443,2,2,2,4
2022-11-28 10:02:59,2.710636574074074,1,3,3,6
2022-11-25 17:02:11,0.03023148148148148,1,1,1,2
2022-11-25 19:28:01,0.28278935185185183,4,14686,1991,16677
2023-01-04 08:18:58,42.05710648148148,114,128416,30008,158424
2022-11-28 13:56:09,3.2794791666666665,1,1,1,2
2022-11-28 13:54:36,3.3548726851851853,1,21,20,41
2022-11-28 18:23:26,3.9589351851851853,1,1,1,2
2022-11-28 16:46:02,3.9753935185185183,1,377,131,508
2022-12-06 09:47:31,11.794108796296296,14,548,283,831
2022-11-28 13:19:29,3.9875,2,28,22,50
2022-11-28 13:45:01,4.299560185185185,1,34,14,48
2022-12-08 20:47:35,14.980104166666667,4,310,51,361
2023-01-30 09:39:44,44.79290509259259,9,308,296,604
2022-11-29 10:38:01,5.583009259259259,4,531,248,779
2022-11-30 11:56:32,6.6430439814814815,5,43,21,64
2022-11-29 15:02:40,5.861122685185185,16,375,82,457
2022-12-05 15:12:04,11.872581018518519,40,30255,9271,39526
2022-11-23 20:07:01,0.12190972222222222,1,2,2,4
2022-11-23 20:09:21,0.22631944444444443,1,22,1,23
2022-11-25 10:20:45,1.928761574074074,3,72,12,84
2022-11-23 13:24:57,0.0809375,1,2,1,3
2022-11-23 14:51:50,0.15577546296296296,5,120,26,146
2022-11-23 13:31:08,0.09704861111111111,1,1,1,2
2022-11-28 16:20:25,5.220787037037037,10,136,62,198
2022-11-23 12:47:59,0.0862962962962963,2,24,1,25
2022-11-23 17:16:27,0.3496875,3,9,1,10
2022-11-23 12:40:35,0.18649305555555556,1,1,1,2
2022-12-12 14:39:21,19.682129629629628,6,31169,9441,40610
2022-11-22 17:56:05,0.02815972222222222,1,4,3,7
2022-11-30 12:55:15,7.832129629629629,2,20,6,26
2022-12-15 18:27:21,23.105451388888888,20,1093,1132,2225
2022-11-22 17:26:56,0.08179398148148148,2,10,7,17
2022-11-28 17:10:24,6.118113425925926,2,13,1,14
2022-11-22 15:41:50,0.06296296296296296,1,3,0,3
2022-11-28 13:24:44,6.006851851851851,20,441,393,834
2022-11-22 12:56:24,0.0787962962962963,1,12,1,13
2022-11-22 16:00:08,0.22138888888888889,1,10,10,20
2022-11-22 13:06:00,0.10672453703703703,1,1,0,1
2022-11-22 13:15:42,0.1205787037037037,1,1,1,2
2022-11-23 14:35:44,1.2157523148148148,7,71,34,105
2022-11-30 18:22:23,18.221944444444443,123,29626,4894,34520
2022-11-28 15:06:26,6.5678935185185185,6,585,163,748
2022-11-21 21:44:34,0.06515046296296297,2,32,26,58
2022-11-22 11:47:13,0.7791435185185185,1,1,1,2
2022-11-21 16:20:27,0.04217592592592593,2,15,11,26
2022-11-22 15:38:38,1.0204282407407408,3,6,2,8
2022-11-21 14:36:50,0.15898148148148147,3,17,15,32
2022-11-28 19:33:50,8.355185185185185,16,1615,933,2548
2022-12-12 14:25:53,21.65273148148148,4,38035,9871,47906
2022-11-28 15:21:43,7.605370370370371,3,41,0,41
2022-11-23 20:06:29,2.944560185185185,8,181620,25253,206873
2022-11-22 16:11:18,3.1143171296296295,4,54,57,111
2022-11-21 14:44:55,2.1027893518518517,1,9,9,18
2022-11-21 14:08:35,2.677534722222222,2,38,7,45
2022-11-21 17:33:37,2.8627430555555557,6,260,79,339
2022-11-28 15:35:53,10.159814814814816,6,99,33,132
2022-11-18 17:24:35,0.026516203703703705,1,2,2,4
2022-11-18 16:33:26,0.01806712962962963,1,2,2,4
2022-11-18 17:38:48,0.10291666666666667,2,23,9,32
2022-11-18 11:57:16,0.006759259259259259,1,2,2,4
2022-11-18 17:29:24,0.9138425925925926,2,40,40,80
2022-11-18 20:06:25,1.0743171296296297,1,48,58,106
2022-12-19 08:30:17,45.58986111111111,31,7581,450,8031
2022-11-21 09:12:26,3.643171296296296,5,10,10,20
2022-11-18 07:57:42,0.6628009259259259,1,2,2,4
2022-11-18 07:57:07,0.6695717592592593,2,2,1,3
2022-11-17 14:59:22,0.01255787037037037,1,2,17,19
2022-11-17 19:49:47,0.22211805555555555,1,5,2,7
2022-11-21 17:24:33,4.150034722222222,1,6,1,7
2023-01-03 13:17:19,48.22358796296297,88,66222,8217,74439
2022-11-17 14:13:33,0.13577546296296297,2,12,10,22
2022-11-17 14:55:00,0.2035648148148148,1,9,5,14
2022-11-22 16:07:19,5.3284375,8,73,74,147
2022-11-17 14:21:07,0.5478587962962963,1,1,1,2
2022-11-16 20:57:07,0.05704861111111111,1,0,2,2
2022-11-22 15:41:00,5.894224537037037,52,12811,1698,14509
2022-11-17 07:16:37,0.5996296296296296,4,58,40,98
2022-11-18 14:57:28,1.9847800925925927,3,163,285,448
2022-12-20 15:46:51,34.04126157407408,4,31,12,43
2022-11-17 11:16:14,0.8891203703703704,4,90,308,398
2022-11-17 12:34:47,0.9124189814814815,2,14,30,44
2022-11-16 14:51:05,0.032476851851851854,1,26,27,53
2022-11-17 09:55:56,0.8487268518518518,2,34,11,45
2022-11-16 17:20:06,0.1658564814814815,2,3,2,5
2022-11-16 16:14:49,0.12474537037037037,2,32,11,43
2022-11-16 16:08:52,0.13456018518518517,1,1,0,1
2022-11-16 16:15:02,0.21305555555555555,2,34,11,45
2022-11-16 13:43:37,0.11450231481481482,1,2,8,10
2022-11-16 16:15:26,0.22208333333333333,2,31,9,40
2022-11-16 16:22:00,0.2371412037037037,3,30,7,37
2022-11-16 15:57:47,0.228125,1,15,0,15
2022-11-16 16:15:34,0.24875,2,20,5,25
2022-11-16 15:57:09,0.2412037037037037,1,15,0,15
2022-11-16 15:45:42,0.24546296296296297,1,18,0,18
2022-11-16 16:16:20,0.27512731481481484,2,18,6,24
2022-11-17 10:59:59,1.0594097222222223,2,18,4,22
2022-11-16 16:17:41,0.11383101851851851,3,47,12,59
2022-11-16 15:56:55,0.27849537037037037,2,25,1,26
2022-11-16 16:09:58,0.2967939814814815,2,17,5,22
2022-11-16 16:09:45,0.3016666666666667,3,11,20,31
2022-11-21 13:46:55,7.9765625,8,174144,25020,199164
2022-11-16 17:18:46,0.9046990740740741,5,77,24,101
2022-11-15 18:28:01,0.03560185185185185,2,10,9,19
2022-11-16 08:51:21,0.6591203703703704,1,16,0,16
2022-11-16 08:51:32,0.667037037037037,2,15,2,17
2022-11-16 08:52:35,0.6753009259259259,3,18,2,20
2022-11-16 08:52:45,0.6937962962962962,2,16,1,17
2022-11-16 08:51:13,0.7029513888888889,3,23,19,42
2022-11-16 08:51:04,0.7659259259259259,4,43,18,61
2022-11-15 14:45:21,0.023773148148148147,1,2,1,3
2022-11-15 15:00:16,0.06081018518518518,1,2,2,4
2022-11-15 16:58:43,0.1615625,5,26,7,33
2022-11-17 12:33:44,2.047523148148148,8,84,38,122
2022-11-18 11:24:26,3.010787037037037,4,119,37,156
2022-11-17 14:43:20,2.162233796296296,12,236,78,314
2022-11-15 14:12:41,0.14221064814814816,1,2,2,4
2022-11-15 14:21:16,0.17550925925925925,1,3,3,6
2022-11-16 08:51:45,0.9979745370370371,12,65,44,109
2022-11-15 14:40:07,0.5696064814814815,1,1,1,2
2022-11-18 18:08:27,3.866840277777778,21,3457,391,3848
2022-11-21 13:30:16,11.790856481481482,10,880,250,1130
2022-11-16 16:53:40,1.9249421296296296,19,124,118,242
2022-11-15 18:47:10,1.079363425925926,5,44,11,55
2022-11-14 18:34:12,0.1154513888888889,1,72,27,99
2023-03-01 09:49:22,121.13288194444445,10,225121,47111,272232
2022-11-14 17:05:20,0.06909722222222223,1,2,0,2
2022-12-12 18:12:13,28.180868055555557,94,59072,20716,79788
2022-11-14 15:42:49,0.07172453703703703,1,1,1,2
2022-11-15 10:52:58,0.9509953703703704,1,99,63,162
2022-11-15 09:46:35,0.9664236111111111,8,213,63,276
2022-11-14 17:56:53,0.32278935185185187,1,1,1,2
2022-11-14 17:51:34,0.35270833333333335,1,2,0,2
2022-11-14 17:36:58,0.383900462962963,1,46,0,46
2023-01-04 15:34:58,23.04898148148148,4,28202,3369,31571
2022-11-15 00:13:41,0.6904282407407407,4,690,264,954
2022-11-15 14:10:20,1.8600115740740741,2,6,6,12
2022-11-15 18:26:46,2.184571759259259,4,37,18,55
2022-11-14 17:53:03,1.3005092592592593,1,1,1,2
2022-11-15 15:08:59,100.12681712962963,31,251666,39416,291082
2022-11-21 13:44:18,9.201655092592592,3,545,4,549
2022-11-14 17:09:21,2.4103125,1,428,2,430
2022-11-15 14:20:22,3.944652777777778,2,2,1,3
2022-11-14 17:04:25,3.1764467592592593,2,2,2,4
2022-11-15 10:06:02,3.907164351851852,6,85,9,94
2022-11-11 16:56:00,0.3053125,1,23,25,48
2022-11-15 16:33:09,4.896168981481481,12,38,43,81
2022-11-11 09:14:49,0.6705439814814815,1,1,1,2
2022-11-10 16:47:59,0.013541666666666667,3,10,11,21
2022-11-10 15:02:25,0.012986111111111111,1,6,2,8
2022-11-15 10:04:59,4.84431712962963,9,8726,637,9363
2022-11-30 10:24:03,36.797974537037035,32,9529,6884,16413
2022-11-10 15:30:39,0.18302083333333333,1,14,10,24
2022-11-10 14:25:31,0.1903587962962963,1,80,14,94
2022-11-10 15:04:52,0.23789351851851853,3,15,3,18
2022-11-15 18:26:08,5.5267939814814815,6,35,6,41
2022-12-08 21:22:44,28.889537037037037,18,6848,339,7187
2022-11-14 06:04:27,136.9358564814815,9,97,214,311
2022-11-15 08:14:55,5.6246875,6,54,20,74
2022-11-09 17:57:28,0.030428240740740742,1,2,2,4
2022-11-11 10:36:18,1.8115046296296295,8,34,40,74
2022-11-10 10:33:38,0.8275694444444445,4,87,28,115
2022-11-17 05:40:47,7.661400462962963,6,143,95,238
2022-11-09 19:58:57,0.3269444444444444,2,2,1,3
2022-11-09 14:53:01,0.12429398148148148,2,2,2,4
2022-11-09 16:31:05,0.2007175925925926,3,124,77,201
2022-11-16 06:07:47,1.7763657407407407,11,1373,412,1785
2022-11-15 00:18:13,5.552199074074074,1,6,6,12
2022-11-09 14:21:53,0.18372685185185186,1,9,3,12
2022-11-08 15:37:24,0.039189814814814816,1,8,2,10
2022-11-09 13:51:13,0.9877314814814815,2,81,7,88
2022-11-09 10:34:36,0.08167824074074075,2,235,31,266
2022-11-09 17:31:22,1.2997106481481482,2,7,0,7
2022-11-10 19:29:20,2.4080324074074073,14,39967,18853,58820
2022-11-09 15:40:16,1.8114583333333334,1,13,5,18
2022-11-08 18:53:05,0.9337847222222222,2,6,6,12
2022-11-14 12:39:18,6.729039351851852,24,255,255,510
2022-11-08 19:54:42,1.0334375,18,1479,231,1710
2022-11-07 22:59:47,0.16961805555555556,1,5,0,5
2022-11-07 18:57:40,0.060381944444444446,1,4,4,8
2022-11-14 21:32:51,7.275671296296296,8,103,46,149
2022-11-07 15:31:27,0.04895833333333333,1,1,1,2
2022-11-15 15:00:37,8.83173611111111,14,263,55,318
2022-11-07 13:51:05,0.05274305555555556,1,4,0,4
2022-12-05 19:34:41,40.18479166666667,9,501,62,563
2022-11-09 15:34:09,2.1799537037037036,11,9786,9410,19196
2022-11-07 13:52:03,0.1834375,1,4,4,8
2022-11-07 14:19:04,0.7590277777777777,2,29,29,58
2022-11-07 18:18:10,0.9546643518518518,3,24,12,36
2022-11-16 16:17:32,10.351574074074074,8,38,13,51
2022-11-07 13:50:00,2.02625,2,16,1,17
2022-11-07 15:07:59,2.673263888888889,1,6,14,20
2022-11-04 21:24:38,0.009849537037037037,1,1,1,2
2022-11-04 21:25:03,0.01175925925925926,1,1,1,2
2022-11-04 17:03:18,0.0625,1,80,0,80
2022-11-04 15:32:44,0.011087962962962963,1,26,0,26
2022-11-04 15:10:13,0.0309375,3,52,50,102
2022-11-08 09:55:47,15.952430555555555,47,4601,1162,5763
2022-11-04 19:14:56,0.22443287037037038,2,20,21,41
2022-11-04 13:40:21,0.06649305555555556,1,2,1,3
2022-11-04 12:56:55,0.08274305555555556,1,0,1,1
2022-11-04 13:34:02,0.21263888888888888,1,1,1,2
2022-11-04 14:41:56,0.2876388888888889,1,6,6,12
2022-11-07 13:50:10,3.3041435185185186,8,97,12,109
2023-02-16 21:51:00,104.94847222222222,5,189969,40905,230874
2022-11-07 18:45:28,4.0240277777777775,2,98,42,140
2022-11-07 10:54:30,8.937951388888889,11,18875,5562,24437
2022-11-04 13:52:58,0.8386574074074075,2,7,11,18
2022-11-04 12:45:34,0.8608333333333333,2,2,2,4
2022-11-04 17:01:42,1.067002314814815,2,62,16,78
2022-11-03 16:05:05,0.02912037037037037,2,89,19,108
2022-11-09 15:03:36,6.001412037037037,28,524,234,758
2022-11-03 15:14:44,0.07675925925925926,1,31,28,59
2022-11-03 13:50:42,0.024074074074074074,2,16,1,17
2022-11-03 12:51:50,0.10173611111111111,1,18,1,19
2022-11-03 13:18:45,0.15422453703703703,3,6,6,12
2022-11-04 14:32:45,1.2248148148148148,6,224,43,267
2022-11-03 08:14:45,0.4452314814814815,1,12,0,12
2022-11-03 14:58:06,0.8167361111111111,3,83,66,149
2022-11-02 19:52:40,0.052800925925925925,4,16,4,20
2022-11-02 18:37:25,0.05219907407407407,3,3,3,6
2022-11-08 08:59:03,5.66650462962963,3,14,8,22
2022-11-02 15:19:33,0.02736111111111111,1,2,2,4
2022-11-02 13:15:09,0.09237268518518518,1,5,1,6
2022-11-08 15:03:44,7.539513888888889,18,6517,1937,8454
2022-11-02 11:44:38,0.43377314814814816,1,6,3,9
2022-11-02 23:58:18,1.0861458333333334,1,198,146,344
2022-12-05 16:08:39,33.85381944444445,2,1,1,2
2022-11-01 18:30:36,0.024791666666666667,1,1,1,2
2022-11-01 17:37:20,0.027511574074074074,1,17,6,23
2022-11-02 07:26:36,0.6482175925925926,2,600,311,911
2022-11-15 12:50:04,21.899375,5,249,23,272
2022-11-02 13:53:37,0.9684837962962963,1,54,1,55
2022-11-01 13:04:54,0.012037037037037037,1,1,1,2
2022-11-01 13:21:13,0.04445601851851852,4,34,22,56
2022-11-01 11:54:42,0.1444675925925926,1,2,2,4
2022-11-02 15:22:11,1.5566203703703703,3,17,2,19
2022-10-31 17:37:18,0.025208333333333333,1,33,0,33
2022-10-31 17:22:52,0.02952546296296296,2,2,2,4
2022-10-31 17:19:15,0.04057870370370371,1,153,0,153
2022-10-31 16:50:17,0.06542824074074075,1,4,4,8
2022-10-31 16:49:58,0.06972222222222223,2,8,3,11
2022-11-02 16:38:44,2.0859722222222223,6,655,328,983
2022-11-21 17:58:54,50.148472222222225,37,4179,2312,6491
2022-11-21 16:53:09,21.173587962962962,11,69,32,101
2022-11-01 01:32:59,11.33068287037037,46,15780,8809,24589
2022-11-03 16:56:23,16.374583333333334,2,5,4,9
2022-10-31 16:22:01,1.2728009259259259,4,19,4,23
2022-11-01 18:15:36,3.244270833333333,5,536,337,873
2023-02-01 19:09:36,96.24974537037038,16,814,51,865
2022-11-02 11:03:43,4.801018518518519,4,117,89,206
2022-10-31 08:21:45,2.719988425925926,3,35,16,51
2022-10-31 16:32:47,3.158402777777778,3,35,10,45
2022-11-01 13:18:09,4.141006944444444,6,502,7,509
2022-11-28 14:47:46,31.57443287037037,2,9,2,11
2022-10-28 15:03:38,0.635462962962963,2,29,25,54
2022-11-01 18:10:46,4.879201388888889,3,25,1,26
2022-10-28 20:28:19,0.9826388888888888,2,21,1,22
2022-10-28 20:16:08,1.0002546296296295,1,60,0,60
2022-10-28 20:15:43,1.0589583333333332,1,27,0,27
2022-10-27 21:14:53,0.17631944444444445,2,34,21,55
2022-10-28 12:44:38,1.315636574074074,6,10,5,15
2022-10-27 12:38:59,0.15921296296296297,4,17,10,27
2022-10-27 14:56:49,0.1923726851851852,1,0,1,1
2022-11-03 14:22:40,7.208298611111111,16,367,149,516
2022-10-31 13:56:17,4.218784722222222,2,2,4,6
2022-10-27 16:06:55,0.7299189814814815,2,13,10,23
2022-10-27 18:33:15,0.9751041666666667,2,40,1,41
2022-10-27 07:26:11,0.5351736111111111,3,9,7,16
2022-10-26 20:41:53,0.1778472222222222,2,58,21,79
2022-10-26 16:33:23,127.09923611111111,20,146658,17884,164542
2022-10-28 11:05:41,1.8209375,19,1034,113,1147
2022-10-27 19:56:30,2.2793171296296295,6,217,24,241
2022-10-27 20:03:12,1.2746180555555555,3,5,3,8
2022-10-27 11:20:15,0.9655324074074074,1,60,50,110
2022-10-26 15:22:58,0.2671412037037037,11,73,15,88
2022-11-03 14:50:05,3.454224537037037,4,61,31,92
2022-10-26 10:05:44,0.1985185185185185,7,15,10,25
2022-10-26 12:38:01,0.5054050925925926,1,1,1,2
2022-10-27 18:33:52,1.8489699074074073,2,16,1,17
2022-10-27 12:00:18,1.757835648148148,3,6,4,10
2022-10-27 18:34:00,1.8632407407407408,2,19,1,20
2022-10-27 18:33:37,1.9076157407407408,2,44,13,57
2022-10-26 12:35:54,2.189201388888889,2,1754,219,1973
2022-10-28 12:47:48,2.8403240740740743,3,7,4,11
2022-10-25 14:02:13,0.07958333333333334,4,8,5,13
2022-10-25 13:43:06,0.05790509259259259,1,32,28,60
2022-10-26 12:58:53,1.031226851851852,3,4,3,7
2022-10-25 13:34:28,4.532592592592593,9,3634,840,4474
2022-10-28 13:39:53,3.1495254629629628,7,4284,717,5001
2022-10-25 12:51:17,0.20043981481481482,1,1,1,2
2022-10-27 14:43:58,2.3310185185185186,2,37,36,73
2022-11-01 18:09:53,7.958530092592593,5,70,14,84
2022-10-25 13:59:35,0.7694560185185185,4,32,21,53
2022-10-26 15:09:48,1.895185185185185,3,6,4,10
2022-10-24 17:18:20,0.022939814814814816,1,30,36,66
2022-10-27 13:00:39,2.872326388888889,1,5,24,29
2022-10-24 15:54:23,0.015196759259259259,1,0,4,4
2022-10-24 14:05:26,0.03408564814814815,2,12,15,27
2022-10-24 13:33:01,0.06243055555555556,1,2,2,4
2022-11-18 11:27:21,25.040092592592593,4,487,262,749
2022-10-24 14:00:02,0.15518518518518518,2,8,6,14
2022-10-24 13:15:52,0.2144675925925926,1,3,0,3
2022-10-24 15:24:18,1.080486111111111,2,7,2,9
2022-10-24 13:50:16,3.5435648148148147,7,2153,691,2844
2022-10-25 00:11:35,1.925138888888889,5,576,13,589
2022-10-24 13:48:03,1.5716087962962964,1,1,1,2
2022-10-24 09:08:32,1.5212037037037036,1,2,1,3
2022-10-24 13:25:57,2.249050925925926,1,1,1,2
2022-10-24 11:50:43,2.3145486111111113,2,4,4,8
2022-10-24 10:32:55,2.2710069444444443,1,5,3,8
2022-10-24 10:33:46,2.2751157407407407,1,3,2,5
2022-10-24 10:34:43,2.2825694444444444,1,3,2,5
2022-10-27 13:00:03,6.552766203703704,2,173,80,253
2022-10-23 09:46:47,1.5241319444444446,1,1,1,2
2022-10-21 21:38:36,0.8687962962962963,3,1591,576,2167
2022-10-24 17:48:40,2.944363425925926,6,326,85,411
2022-10-21 16:53:17,0.024050925925925927,1,1,1,2
2022-11-02 11:57:36,13.83261574074074,56,7617,4147,11764
2022-10-21 16:53:37,0.09244212962962962,2,57,55,112
2022-10-25 16:32:15,4.0894560185185185,3,57,39,96
2022-10-21 14:26:31,0.013159722222222222,1,1,0,1
2022-10-21 13:46:44,0.006481481481481481,1,0,1,1
2022-10-21 18:10:08,0.27140046296296294,2,160,103,263
2022-10-21 14:23:13,0.1316087962962963,2,3,0,3
2022-10-21 12:35:20,0.07621527777777778,4,10,25,35
2022-12-16 15:24:02,61.8203587962963,52,4188,1628,5816
2022-10-21 13:48:19,0.5422106481481481,1,353,0,353
2022-10-21 13:34:02,0.7637731481481481,2,84,53,137
2022-10-21 10:52:30,0.7155787037037037,2,37,28,65
2022-10-20 18:01:23,0.1449074074074074,1,3,2,5
2022-10-21 19:59:19,1.319039351851852,22,405,286,691
2022-10-26 15:06:46,6.129027777777778,12,47,38,85
2022-10-21 14:04:50,1.9490046296296297,8,179,63,242
2022-10-21 15:09:59,1.1869907407407407,5,191,160,351
2022-10-26 14:44:35,6.305706018518518,9,25,24,49
2022-10-20 13:05:49,0.2452777777777778,1,14,1,15
2022-10-20 08:22:01,0.2040625,1,5,3,8
2022-10-19 20:44:03,0.01861111111111111,1,3,3,6
2022-10-20 18:36:14,0.9754513888888889,3,21,0,21
2022-10-20 08:16:39,0.5716782407407407,1,3,2,5
2022-10-20 08:15:07,0.5635763888888888,1,3,2,5
2022-10-20 08:19:07,0.5625694444444445,1,3,2,5
2022-10-20 18:24:39,1.0144444444444445,3,8,3,11
2022-10-19 18:54:30,0.018599537037037036,1,1,1,2
2022-10-20 12:47:17,0.8393171296296297,1,41,40,81
2022-10-19 16:13:34,0.01337962962962963,2,124,2,126
2022-10-19 16:12:34,0.028877314814814814,2,125,3,128
2022-10-19 14:55:57,0.024270833333333332,1,1,0,1
2022-10-19 14:10:13,0.017060185185185185,3,3,2,5
2022-10-19 14:24:04,0.05421296296296296,1,2,2,4
2022-10-19 12:22:42,0.29094907407407405,2,14,9,23
2022-10-20 13:13:35,1.4434143518518519,2,2,2,4
2022-10-24 14:04:29,5.696331018518518,1,2,2,4
2022-10-19 04:47:42,0.4133449074074074,1,3,2,5
2022-10-21 10:40:40,2.720949074074074,11,393,239,632
2022-10-18 15:42:46,0.07231481481481482,1,7,2,9
2022-10-18 15:56:45,0.0746875,1,31,14,45
2022-10-26 08:44:37,7.841909722222222,4,149,112,261
2022-10-18 15:19:31,0.0633912037037037,6,239,59,298
2022-10-18 17:56:49,0.1763425925925926,1,14,12,26
2022-10-19 12:46:12,0.9623148148148148,1,40,40,80
2022-10-18 13:38:57,0.015196759259259259,2,3185,2,3187
2022-10-18 13:42:15,0.02744212962962963,1,2,2,4
2022-10-18 15:40:28,0.12347222222222222,1,21,6,27
2022-10-19 15:15:02,1.163900462962963,7,128,8,136
2022-10-18 15:10:10,0.11398148148148148,5,15,12,27
2022-10-20 09:57:11,1.8923032407407407,2,78,23,101
2022-10-18 12:15:37,0.05887731481481481,1,6,3,9
2022-10-18 14:33:54,0.16637731481481483,1,192,49,241
2022-10-31 07:28:45,12.892789351851851,9,568,590,1158
2022-10-18 14:29:01,18.0753125,3,40,7,47
2022-10-18 08:07:15,0.03422453703703704,1,5,7,12
2022-10-18 10:18:19,0.1355324074074074,1,1,1,2
2022-10-19 00:20:13,1.0140856481481482,5,206,225,431
2022-10-18 12:57:34,0.6439351851851852,1,3,2,5
2022-10-18 16:25:49,0.8347453703703703,3,4176,685,4861
2022-10-18 17:47:38,5.933310185185185,13,154,50,204
2022-10-18 12:55:56,0.719212962962963,1,3,2,5
2022-10-17 19:22:59,0.005046296296296296,1,1,1,2
2022-10-17 19:54:23,0.04630787037037037,1,2,2,4
2022-10-17 18:56:00,0.007326388888888889,1,1,1,2
2022-10-18 07:52:52,0.5564930555555555,1,4,197,201
2022-10-19 05:10:30,1.481712962962963,2,1360,105,1465
2022-10-17 18:17:01,0.027685185185185184,2,4,4,8
2022-10-18 09:41:09,0.7163078703703704,1,2,2,4
2022-10-17 18:57:39,0.1270601851851852,2,7,3,10
2022-10-17 15:56:29,0.0003935185185185185,1,3,29,32
2022-10-18 13:00:40,0.953599537037037,2,21,25,46
2022-10-17 14:57:29,0.035694444444444445,1,1,1,2
2022-10-17 14:54:35,0.03972222222222222,1,2,2,4
2022-10-17 17:09:25,0.13569444444444445,2,14,18,32
2022-10-18 17:51:37,1.1757638888888888,1,2,1,3
2022-10-18 07:14:13,0.7727430555555556,1,21,21,42
2022-10-18 04:45:48,0.6691319444444445,1,21,21,42
2022-10-17 15:48:22,0.14533564814814814,1,85,15,100
2022-10-18 06:56:37,0.8140972222222222,1,4,1,5
2022-10-17 12:41:57,0.5352083333333333,1,2,1,3
2022-10-17 14:40:35,0.7691666666666667,1,1,1,2
2022-10-17 08:53:37,0.7357523148148148,1,3,2,5
2022-10-17 13:06:20,14.909270833333334,3,73,23,96
2022-10-17 14:04:11,1.3370949074074074,7,2634,240,2874
2022-10-18 17:34:48,3.0336458333333334,2,309,231,540
2022-10-17 14:47:54,0.00755787037037037,1,2,1,3
2022-10-17 08:45:37,1.7217013888888888,1,2,1,3
2022-10-24 13:49:24,8.978449074074074,4,42,16,58
2022-10-19 07:51:26,3.753553240740741,4,30,7,37
2022-10-17 18:53:24,2.2575231481481484,5,7,6,13
2022-10-18 08:29:14,2.832037037037037,11,326,330,656
2022-10-17 18:29:18,2.266215277777778,2,5,2,7
2022-10-17 08:42:55,1.886412037037037,1,3,2,5
2022-10-17 16:00:03,2.3378587962962962,2,33,27,60
2022-10-17 12:47:22,2.320636574074074,1,13,13,26
2022-10-17 18:56:42,2.6531944444444444,3,2676,213,2889
2022-10-17 08:34:34,2.218703703703704,3,5,4,9
2022-10-17 16:39:15,2.5610185185185186,2,2619,200,2819
2022-10-15 10:35:35,0.40738425925925925,1,3,2,5
2022-10-14 18:06:57,0.06225694444444444,1,23,4,27
2022-10-17 09:23:20,2.745775462962963,4,43,2,45
2022-10-14 15:21:24,0.023206018518518518,1,3,2,5
2022-10-14 15:22:30,0.03199074074074074,1,3,2,5
2022-10-14 16:10:17,0.05103009259259259,3,5,2,7
2022-10-17 13:15:21,3.0243171296296296,7,46,47,93
2022-10-14 13:30:46,0.11890046296296296,3,4,8,12
2022-10-18 13:20:10,4.1990625,14,3473,291,3764
2022-10-14 15:10:33,0.28238425925925925,2,3,3,6
2022-10-14 14:57:51,0.2834027777777778,1,3,2,5
2022-10-14 15:04:10,0.29432870370370373,2,599,214,813
2022-10-14 14:48:39,0.285462962962963,1,3,2,5
2022-10-14 16:12:32,7.984131944444444,16,26354,3431,29785
2022-10-14 13:57:03,0.26340277777777776,2,71,59,130
2022-10-14 13:17:36,0.24200231481481482,5,44,45,89
2022-10-14 14:45:37,0.3411574074074074,1,3,2,5
2022-10-14 10:08:56,0.46945601851851854,1,3,2,5
2022-10-14 10:07:32,0.5955439814814815,1,3,2,5
2022-10-14 09:47:29,0.5849537037037037,1,3,2,5
2022-10-14 10:03:35,0.5873379629629629,1,3,2,5
2022-10-14 09:16:38,0.5450462962962963,1,2,1,3
2022-10-14 09:37:37,0.5631828703703704,1,3,2,5
2022-10-14 14:18:03,0.8614583333333333,6,34,9,43
2022-10-14 07:42:29,1.0378703703703704,6,215,124,339
2022-10-17 13:16:17,12.858958333333334,23,2784,970,3754
2022-10-13 17:07:10,0.04642361111111111,1,3,2,5
2022-10-17 13:35:28,3.904837962962963,4,42,46,88
2022-10-14 17:30:15,1.075462962962963,2,4,3,7
2022-10-14 17:39:56,1.0896527777777778,3,704,265,969
2022-10-14 16:45:16,1.0908449074074074,2,5,4,9
2022-10-13 16:46:13,0.415462962962963,4,9,8,17
2022-10-13 12:12:49,0.0225,1,3,2,5
2022-10-13 12:10:05,0.0578125,1,3,2,5
2022-10-14 14:04:50,1.1592939814814816,4,15,8,23
2022-11-14 08:34:30,31.939166666666665,4,17,19,36
2022-10-14 15:12:22,1.2252777777777777,3,40,23,63
2022-10-13 13:05:02,0.26186342592592593,8,21,19,40
2022-10-13 10:14:38,0.08864583333333333,1,3,2,5
2022-10-14 14:29:55,1.290300925925926,1,5,20,25
2022-10-13 10:06:18,0.1555787037037037,1,2,1,3
2022-10-13 10:03:16,0.1372800925925926,1,3,2,5
2022-10-13 10:07:14,0.1442476851851852,3,5,4,9
2022-10-13 10:02:41,0.14663194444444444,1,3,2,5
2022-10-14 14:10:36,1.34375,1,32,1,33
2022-10-13 09:59:02,0.23122685185185185,2,2,1,3
2022-10-13 09:56:35,0.2426736111111111,2,4,3,7
2022-10-13 09:54:35,0.2545601851851852,1,3,2,5
2022-10-14 14:18:16,1.5681828703703704,1,7,4,11
2022-10-14 14:31:01,1.6891666666666667,4,18,13,31
2022-10-14 14:46:39,2.4359953703703705,3,342,34,376
2022-10-13 03:58:59,0.34899305555555554,1,3,2,5
2022-10-14 16:08:37,1.9205787037037036,2,3,2,5
2022-10-13 07:37:30,0.5330555555555555,1,1,1,2
2022-10-17 13:34:22,4.794282407407407,5,15,13,28
2022-10-17 16:02:15,82.26690972222222,219,274269,40890,315159
2022-10-12 18:38:13,0.014791666666666667,1,3,2,5
2022-10-12 18:02:55,0.01738425925925926,1,2,1,3
2022-10-12 18:03:23,0.01990740740740741,2,4,3,7
2022-10-12 18:01:26,0.031747685185185184,2,4,3,7
2022-10-12 17:07:37,0.013518518518518518,1,1,0,1
2022-10-13 13:52:43,0.8878472222222222,2,10,10,20
2022-10-12 18:09:46,0.0852662037037037,6,37,8,45
2022-10-12 17:21:49,0.06039351851851852,1,0,1,1
2022-10-13 05:31:13,0.5899074074074074,3,30,4,34
2022-10-12 15:50:36,0.05409722222222222,5,608,18,626
2022-11-14 06:36:38,32.70275462962963,1,2,2,4
2022-10-13 08:50:03,0.8900694444444445,2,43,1,44
2022-10-12 13:08:48,0.020474537037037038,1,2,2,4
2022-11-01 11:50:43,19.99826388888889,11,339,197,536
2022-10-12 13:11:46,0.06070601851851852,3,4,3,7
2022-10-12 15:05:13,0.14434027777777778,3,116,36,152
2022-10-14 13:36:04,2.1097685185185187,4,12,7,19
2022-10-12 14:14:38,0.17469907407407406,2,150,14,164
2022-11-14 17:45:46,33.00700231481481,13,107,64,171
2022-10-12 10:44:31,5.756342592592593,10,23477,3043,26520
2022-10-12 14:33:23,0.2507523148148148,1,4,4,8
2022-10-13 10:48:42,1.3234953703703705,2,10,4,14
2022-10-12 02:54:20,0.10672453703703703,1,4,2,6
2022-10-13 10:33:36,70.80184027777777,16,243,216,459
2022-10-12 21:32:51,2.138900462962963,2,2,2,4
2022-10-12 02:48:56,0.1784837962962963,2,62,54,116
2022-10-12 14:12:00,0.6631712962962963,3,235,9,244
2022-10-12 18:00:17,0.8758912037037037,6,60,13,73
2022-10-13 08:39:03,1.5331712962962962,1,1,0,1
2022-10-12 07:25:05,0.4942708333333333,2,5,0,5
2022-10-11 17:18:40,0.035694444444444445,1,1,1,2
2022-10-12 17:20:47,1.3464583333333333,1,6,4,10
2022-10-12 07:44:08,0.9311342592592593,2,3,2,5
2022-10-11 15:05:32,0.24778935185185186,1,3,7,10
2022-10-19 13:55:38,8.232650462962964,9,92,77,169
2022-10-11 11:17:54,4.779525462962963,7,12523,867,13390
2022-10-11 17:46:25,0.4929050925925926,1,607,14,621
2022-10-11 18:13:05,0.5994212962962963,2,33,19,52
2022-10-19 09:17:46,8.933240740740741,39,32610,5632,38242
2022-10-11 13:21:30,0.7378703703703704,3,15,15,30
2022-10-11 14:05:40,0.8036574074074074,3,9,9,18
2022-10-11 12:39:25,0.7774421296296297,1,2,2,4
2022-10-11 12:19:32,0.7947453703703704,1,4,1,5
2022-10-10 18:35:24,0.07369212962962964,1,2,1,3
2022-10-11 14:58:49,0.9453125,7,44,34,78
2022-10-11 12:30:43,0.8637962962962963,3,11,10,21
2022-10-11 17:25:29,4.194629629629629,3,30,20,50
2022-10-12 15:15:12,2.015902777777778,2,2,2,4
2022-10-11 12:29:16,0.9031018518518519,3,30,5,35
2022-10-11 13:44:46,6.807037037037037,2,82,66,148
2022-10-17 14:15:02,7.040520833333333,7,1145,1149,2294
2022-11-17 14:41:11,38.06115740740741,2,48,10,58
2022-10-11 12:13:22,0.9729745370370371,6,4622,188,4810
2022-10-10 14:17:41,0.08751157407407407,1,9,9,18
2022-10-21 12:32:10,11.0071875,11,29440,4607,34047
2022-10-10 12:20:00,0.021944444444444444,1,3,3,6
2022-10-12 08:11:21,12.918645833333333,24,4422,2572,6994
2022-10-11 12:14:21,1.6844791666666667,1,3,3,6
2022-10-12 12:28:55,2.7340046296296294,1,3,3,6
2022-10-13 14:53:27,3.8615856481481483,2,22,15,37
2022-10-10 12:47:14,0.7764814814814814,1,1,1,2
2022-10-10 18:54:36,1.057048611111111,1,36,32,68
2022-10-10 18:54:54,1.0617824074074074,1,2,1,3
2022-10-12 17:18:11,3.0219212962962962,2,9,9,18
2022-10-10 13:08:34,0.9347800925925925,2,2,2,4
2022-10-10 16:57:29,1.2875925925925926,2,2,2,4
2022-10-17 17:25:30,9.054733796296297,19,16628,1181,17809
2022-10-11 16:09:17,2.990740740740741,2,738,19,757
2022-10-11 16:56:26,3.2376620370370373,5,10171,615,10786
2022-10-12 14:13:10,4.126111111111111,5,240,10,250
2022-10-10 13:16:58,2.2561458333333335,1,3,3,6
2022-10-10 19:03:09,3.001863425925926,1,22,15,37
2022-10-10 16:33:57,2.9144212962962963,1,1,1,2
2022-10-10 19:03:24,3.0139583333333335,1,2,1,3
2022-10-10 19:03:47,3.0176967592592594,1,6,3,9
2022-10-10 19:04:10,3.022650462962963,1,2,1,3
2022-10-10 13:25:22,2.8867592592592595,4,659,122,781
2022-10-07 15:49:09,0.01775462962962963,1,554,8,562
2022-10-07 16:19:15,108.0894212962963,17,86588,11858,98446
2022-10-07 16:19:50,0.9548148148148148,16,1020,62,1082
2022-10-11 14:45:24,4.160856481481481,11,2451,234,2685
2022-10-07 13:52:53,0.12664351851851852,1,3,3,6
2022-10-10 12:44:59,3.0897337962962963,2,27,16,43
2022-10-07 15:32:55,0.2467939814814815,5,634,46,680
2022-10-10 13:30:59,3.1668171296296297,3,154,8,162
2022-10-07 13:26:24,0.19996527777777778,1,151,7,158
2022-10-06 21:06:39,0.010555555555555556,1,2,2,4
2022-10-10 13:19:33,3.774583333333333,2,4,24,28
2022-10-07 13:23:24,0.807511574074074,2,31,3,34
2022-10-07 12:36:05,1.7503587962962963,1,1,1,2
2022-10-07 14:54:08,0.9296875,2,31,9,40
2022-10-11 16:54:42,5.088680555555555,3,104,17,121
2022-10-07 13:44:59,0.9862152777777777,3,31,30,61
2022-10-10 13:48:18,21.300104166666667,204,11412,8713,20125
2022-10-06 22:02:27,0.5002314814814814,1,4,3,7
2022-10-10 16:32:03,4.277719907407407,1,1,1,2
2022-10-07 14:14:00,1.3003703703703704,1,614,6,620
2022-10-07 17:45:24,2.0135763888888887,5,548,137,685
2022-10-07 14:05:49,1.5295833333333333,2,3,1,4
2022-10-07 20:34:41,1.9475810185185185,5,7612,414,8026
2022-10-07 22:01:59,2.0008449074074073,12,158,181,339
2022-10-05 21:48:14,0.010462962962962962,2,12,4,16
2022-10-07 17:42:25,1.8757060185185186,5,1635,68,1703
2022-10-05 21:16:37,0.029560185185185186,1,6,4,10
2022-10-05 18:52:01,0.011423611111111112,1,1,1,2
2022-10-11 13:56:42,5.911840277777777,8,3119,173,3292
2022-10-07 16:24:04,2.0210185185185185,13,10419,298,10717
2022-10-05 16:23:49,0.005208333333333333,1,2,1,3
2022-10-05 20:25:58,0.19944444444444445,4,16,13,29
2022-10-11 13:49:24,6.65119212962963,5,658,75,733
2022-10-07 11:59:03,1.9640393518518517,16,1173,607,1780
2022-10-05 15:49:14,0.13240740740740742,2,369,13,382
2022-10-14 11:28:08,9.83431712962963,5,505,124,629
2022-10-05 17:50:15,0.2538888888888889,5,139,59,198
2022-10-06 09:04:01,0.9114814814814814,3,56,28,84
2022-10-05 13:31:33,0.14015046296296296,1,1484,48,1532
2022-10-05 16:12:13,0.3009722222222222,4,13,11,24
2022-10-07 12:44:51,2.203877314814815,7,94,93,187
2022-10-05 13:15:14,0.39056712962962964,1,162,2,164
2022-10-05 13:12:48,0.4421759259259259,2,220,2,222
2022-10-05 13:19:04,0.4999189814814815,5,1070,624,1694
2022-10-04 21:51:56,0.049039351851851855,2,164,4,168
2022-10-04 23:39:48,0.15773148148148147,4,194,116,310
2022-10-11 20:31:24,10.992175925925926,40,1454,1783,3237
2022-11-15 12:06:45,42.02954861111111,112,115394,33923,149317
2022-10-05 17:03:50,1.0237731481481482,8,116,137,253
2022-10-07 13:46:55,3.0292708333333334,4,924,24,948
2022-10-04 13:48:28,0.024293981481481482,1,3,0,3
2022-10-04 13:55:15,0.0505787037037037,2,20,18,38
2022-10-04 13:00:53,0.011620370370370371,1,1,1,2
2022-10-04 15:52:13,0.28475694444444444,3,124,4,128
2022-10-04 11:46:50,0.13512731481481483,1,1,1,2
2022-10-04 14:24:07,0.6683217592592593,2,20,18,38
2022-10-05 17:40:38,1.9004282407407407,1,19,19,38
2022-10-03 16:42:05,0.027453703703703702,1,0,1,1
2022-10-04 14:26:53,2.114201388888889,1,1,1,2
2022-10-10 13:11:29,8.082245370370371,3,9,3,12
2022-10-04 13:56:36,2.403252314814815,3,72,66,138
2022-10-10 13:51:11,8.444398148148148,1,1,1,2
2022-10-04 14:07:34,2.872384259259259,1,2,2,4
2022-10-04 14:07:53,2.8787962962962963,1,2,2,4
2022-10-04 14:08:29,2.9664467592592594,1,2,1,3
2022-10-04 14:09:23,2.974664351851852,1,2,1,3
2022-10-03 13:21:51,1.956377314814815,4,4,11,15
2022-10-10 07:51:30,9.013414351851852,1,1,1,2
2022-10-04 14:12:04,3.2937268518518517,1,2,1,3
2022-10-04 14:13:22,3.3503125,1,6,3,9
2022-10-03 20:18:30,2.9284837962962964,3,352,332,684
2022-10-03 21:57:37,3.0645717592592594,1,1,1,2
2022-10-03 21:57:50,3.088287037037037,1,1,1,2
2022-10-03 21:49:36,3.0997916666666665,1,1,1,2
2022-10-11 15:48:04,6.892662037037037,11,664,1181,1845
2022-10-03 09:02:52,2.729814814814815,6,167,159,326
2022-10-10 08:05:31,9.682592592592593,1,7,1,8
2022-09-30 14:04:36,0.016238425925925927,1,41,39,80
2022-10-12 12:33:44,12.014351851851853,4,36672,3884,40556
2022-10-17 15:17:26,17.108935185185185,4,33,7,40
2022-09-30 19:30:39,7.140949074074074,14,1200,850,2050
2022-10-07 14:53:03,7.790335648148148,8,86,38,124
2022-10-10 13:20:20,10.155879629629629,8,338,68,406
2022-09-30 16:14:02,0.06069444444444445,2,3,0,3
2022-09-30 11:45:56,0.20629629629629628,2,4,3,7
2022-09-30 16:15:07,0.44875,2,12,16,28
2022-10-11 09:56:08,11.376423611111111,7,72,27,99
2022-09-29 16:25:16,0.006678240740740741,1,4,0,4
2022-10-03 21:37:09,4.283645833333333,2,2,2,4
2022-09-29 12:58:39,0.18261574074074075,2,5,4,9
2022-09-29 11:40:56,0.15362268518518518,2,3,4,7
2022-09-29 13:13:56,0.5699074074074074,1,10,8,18
2022-09-29 13:36:42,0.7385532407407407,7,18,7,25
2022-09-29 17:18:25,0.9994444444444445,1,30,6,36
2022-09-29 06:36:46,0.5982523148148148,1,4,6,10
2022-09-29 09:04:50,0.7381018518518518,1,6,1,7
2022-09-29 15:51:08,1.1007986111111112,5,67,43,110
2022-10-04 18:28:29,6.286053240740741,7,26,11,37
2022-09-29 17:22:24,1.287974537037037,5,64,27,91
2022-10-12 12:57:09,14.074965277777778,9,50098,4050,54148
2022-09-28 16:26:13,0.37572916666666667,1,19,19,38
2022-09-27 20:25:58,0.06912037037037037,3,332,5,337
2022-09-29 17:23:14,2.148877314814815,1,37,10,47
2022-09-28 12:57:43,0.9548032407407407,2,5,3,8
2022-09-27 13:36:35,0.03684027777777778,2,37,3,40
2022-09-27 12:55:41,110.11262731481482,13,120580,16200,136780
2022-09-28 14:55:46,1.4271296296296296,8,821,61,882
2022-09-26 22:01:01,0.09243055555555556,3,114,50,164
2022-09-29 14:33:14,3.0566203703703705,9,1813,462,2275
2022-10-11 14:47:55,15.01226851851852,3,209,77,286
2022-09-26 21:58:03,0.31318287037037035,1,8,0,8
2022-09-26 13:50:49,0.01875,2,74,69,143
2022-09-27 15:30:58,1.1175694444444444,2,8,8,16
2022-09-26 12:56:42,0.027256944444444445,1,2,2,4
2022-09-30 06:25:43,227.6000925925926,55,10685,2798,13483
2022-09-27 11:51:52,1.4412731481481482,2,129,7,136
2022-09-28 12:03:20,2.5220717592592594,1,2,2,4
2022-09-26 21:02:58,1.1991087962962963,3,41,29,70
2022-09-30 13:25:41,5.290428240740741,4,14,2,16
2022-09-30 19:13:40,6.770949074074074,6,19,19,38
2022-09-26 12:55:16,2.6154050925925927,1,1,1,2
2022-09-30 14:58:04,6.844236111111111,11,163,21,184
2022-09-28 13:53:22,4.916064814814815,2,2,2,4
2022-10-05 12:27:15,15.901215277777778,28,27375,1456,28831
2022-09-23 18:52:10,5.322997685185185,12,19747,438,20185
2022-09-26 08:55:43,2.765671296296296,2,29,13,42
2022-09-23 17:23:05,0.27436342592592594,2,34,3,37
2022-09-23 13:13:36,-0.22295138888888888,1,9,7,16
2022-10-05 20:28:32,16.578043981481482,167,42143,8580,50723
2022-09-29 00:09:30,6.151400462962963,2,3,3,6
2022-09-22 18:38:32,0.025347222222222222,2,2,2,4
2022-09-22 15:03:01,0.02140046296296296,1,4,4,8
2022-09-23 13:14:53,1.1359606481481481,9,65,72,137
2022-09-22 12:51:27,0.04805555555555555,1,1,0,1
2022-09-22 11:21:05,0.13712962962962963,1,39,14,53
2022-09-22 13:20:15,0.4313078703703704,1,17,3,20
2022-09-23 18:35:20,1.6765046296296295,1,1,1,2
2022-09-29 11:27:59,7.619270833333333,1,1,1,2
2022-09-21 18:54:10,0.008275462962962964,1,131,3,134
2022-09-21 18:59:52,0.09564814814814815,1,1,1,2
2022-09-21 15:41:45,0.006331018518518519,1,1,1,2
2022-09-21 14:15:32,0.03298611111111111,1,1,1,2
2022-09-22 07:45:24,1.6446412037037037,8,1423,97,1520
2022-09-21 15:46:05,0.16835648148148147,2,2,2,4
2022-09-21 12:17:04,0.1811111111111111,3,4,4,8
2022-09-21 11:56:23,0.3577314814814815,1,1,1,2
2022-09-23 18:48:41,2.653460648148148,1,0,3,3
2022-09-23 17:19:35,2.777534722222222,6,40,4,44
2022-09-28 14:45:06,8.370671296296296,3,31,15,46
2022-10-14 16:34:33,25.415555555555557,9,65262,5076,70338
2022-09-20 19:52:18,0.26439814814814816,9,17,12,29
2022-09-20 13:18:22,2.0911921296296296,3,1070,214,1284
2022-09-20 15:53:40,3.072858796296296,11,1519,403,1922
2022-09-20 11:46:55,0.1556712962962963,1,1,1,2
2022-09-20 19:43:32,0.8700462962962963,1,1,1,2
2022-09-19 20:55:51,0.1408449074074074,2,57,5,62
2022-09-19 19:27:18,0.08572916666666666,1,2,1,3
2022-09-21 12:15:27,1.8930208333333334,6,1525,335,1860
2022-09-23 13:24:29,3.961446759259259,6,10409,420,10829
2022-09-19 17:22:35,1.1577662037037038,5,86,28,114
2022-09-22 12:21:52,3.060416666666667,4,462,11,473
2022-09-19 11:09:24,0.016481481481481482,1,1,0,1
2022-09-20 07:41:56,2.731377314814815,5,59,14,73
2022-09-19 20:42:18,2.527083333333333,1,12,6,18
2022-09-19 17:51:44,1.2810300925925926,1,2,2,4
2022-09-19 12:37:33,1.7829398148148148,6,69,66,135
2022-09-19 12:28:13,1.792511574074074,1,11,11,22
2022-09-19 22:04:25,2.304988425925926,1,6,6,12
2022-09-19 12:37:19,1.9246064814814814,2,26,26,52
2022-09-19 12:42:13,1.974189814814815,2,8,8,16
2022-09-22 15:01:40,5.676574074074074,1,1,1,2
2022-09-16 21:20:02,0.020300925925925927,1,62,5,67
2022-09-16 20:15:03,0.04741898148148148,1,1,1,2
2022-09-19 13:10:22,2.7813078703703704,1,5,5,10
2022-09-16 20:12:59,0.08085648148148149,1,26,24,50
2022-09-16 20:11:48,0.10116898148148148,3,14,1,15
2022-09-21 08:40:36,4.683553240740741,11,1904,904,2808
2022-09-20 13:17:57,3.895347222222222,1,1,3,4
2022-09-16 14:23:58,0.02515046296296296,1,3,3,6
2022-09-16 19:01:57,0.22975694444444444,1,8,8,16
2022-09-28 12:07:08,11.980243055555556,2,40,16,56
2022-11-03 14:26:09,48.11554398148148,5,96858,10991,107849
2022-09-16 11:31:39,0.09565972222222222,1,1,1,2
2022-09-16 13:40:39,0.20488425925925927,2,14,2,16
2022-09-16 07:07:02,0.4514930555555556,1,1,1,2
2022-09-16 13:19:51,0.8273379629629629,16,435,767,1202
2022-09-15 18:10:16,0.2679050925925926,2,30,3,33
2022-09-30 13:16:25,14.855914351851851,59,14249,2006,16255
2022-09-19 10:27:07,0.009282407407407408,1,257,71,328
2022-09-16 08:57:42,0.9743171296296296,4,118,4,122
2022-09-15 15:31:09,0.08241898148148148,6,80,12,92
2022-09-15 13:39:59,0.010034722222222223,1,3,3,6
2022-09-16 20:16:00,1.4106597222222221,2,129,0,129
2022-09-20 13:20:39,5.264363425925926,3,30,14,44
2022-09-15 13:22:31,0.29413194444444446,1,5,0,5
2022-10-05 15:41:38,27.392997685185186,7,569,203,772
2022-09-14 23:29:59,0.025497685185185186,1,2,2,4
2022-09-15 13:21:58,0.2017824074074074,2,3,5,8
2022-09-16 16:59:41,2.0325810185185187,5,72,52,124
2022-09-14 17:28:40,0.06980324074074074,1,12,3,15
2022-09-14 17:32:13,0.07668981481481481,2,57,0,57
2022-09-15 13:34:23,0.9317129629629629,12,897,1057,1954
2022-09-14 15:53:43,0.03760416666666667,1,5,5,10
2022-09-14 14:38:40,0.015833333333333335,1,1,1,2
2022-09-14 17:19:15,0.12846064814814814,3,698,949,1647
2022-09-14 18:06:49,0.17174768518518518,2,35,2,37
2022-09-14 13:25:16,0.020856481481481483,1,5,0,5
2022-09-26 13:43:34,12.058252314814816,1,5,4,9
2022-09-14 12:45:01,0.09682870370370371,7,18,10,28
2022-09-14 14:13:21,0.20400462962962962,5,32,37,69
2022-09-14 11:19:03,0.7129976851851851,1,111,325,436
2022-09-14 11:58:06,0.8002546296296297,1,18,18,36
2022-09-13 17:11:24,0.05883101851851852,1,67,2,69
2022-09-16 15:38:08,3.0003819444444444,9,174,55,229
2022-09-13 16:10:12,0.07784722222222222,1,1,0,1
2022-09-23 15:49:31,10.222696759259259,4,22407,3275,25682
2022-09-13 17:16:37,0.29422453703703705,1,40,28,68
2022-09-13 12:04:14,0.17271990740740742,1,8,2,10
2022-09-13 15:56:20,0.5987962962962963,1,43,20,63
2022-09-14 23:21:06,1.8901388888888888,2,2,2,4
2022-09-13 15:29:48,0.7879282407407407,2,8,10,18
2022-09-13 11:58:47,0.7276388888888888,2,20,20,40
2022-09-13 06:36:04,0.6371990740740741,4,1012,593,1605
2022-09-12 18:11:40,0.03603009259259259,1,19,19,38
2022-09-12 18:30:27,0.060127314814814814,2,33,11,44
2022-09-12 17:39:01,0.11672453703703704,2,8,8,16
2022-09-12 17:35:45,0.11112268518518519,1,22,4,26
2022-09-12 15:33:57,0.03806712962962963,3,1218,916,2134
2022-09-15 13:50:11,3.2271180555555556,8,58,58,116
2022-09-14 10:06:30,2.0536689814814815,1,9,2,11
2022-09-12 13:19:48,0.1940625,1,2,13,15
2022-09-14 08:12:52,2.9694560185185184,1,7,0,7
2022-09-10 13:11:46,0.00024305555555555555,1,11,11,22
2022-09-12 16:09:37,2.8400578703703703,2,37,26,63
2022-09-14 11:36:13,4.731724537037037,2,28,4,32
2022-11-15 16:50:08,69.41486111111111,20,154909,23158,178067
2022-11-18 14:27:09,69.97172453703703,6,126,37,163
2022-09-14 11:52:55,4.879895833333333,2,24,18,42
2022-09-09 21:30:06,0.3970949074074074,4,746,313,1059
2022-09-12 13:20:31,3.1339004629629628,5,97,10,107
2022-09-22 07:45:04,13.123321759259259,240,40481,5766,46247
2022-09-12 19:59:20,3.9807175925925926,1,2,2,4
2022-09-09 07:15:24,0.5314236111111111,2,3,4,7
2022-09-10 10:34:50,2.0395949074074076,5,148,149,297
2022-09-13 14:04:03,4.999884259259259,1,3,3,6
2022-09-09 19:07:09,1.2385069444444445,1,19,16,35
2022-09-09 15:37:35,1.1927546296296296,4,483,182,665
2022-09-09 15:44:56,1.2719675925925926,1,3,6,9
2022-09-08 11:32:41,0.21520833333333333,2,9,9,18
2022-09-12 11:37:25,2.4721875,1,79,48,127
2022-10-07 14:00:20,32.84721064814815,6,944,339,1283
2022-09-07 20:33:03,0.07512731481481481,2,9,1,10
2022-09-07 21:45:22,0.17554398148148148,4,27,22,49
2022-09-07 17:46:14,0.1155324074074074,1,5,5,10
2023-02-03 17:43:46,149.2727662037037,150,42659,35128,77787
2022-09-12 19:03:49,5.225636574074074,1,1,1,2
2022-09-07 10:24:12,1.8207986111111112,2,13,16,29
2022-09-07 12:01:31,0.12293981481481482,1,1,0,1
2022-09-10 12:33:02,3.144212962962963,4,11,11,22
2022-09-07 20:42:46,0.5339583333333333,1,11,11,22
2022-09-07 19:45:17,0.7070717592592592,2,12,3,15
2022-09-07 14:44:20,0.634375,3,18,13,31
2022-09-07 11:46:26,0.5687152777777778,5,12735,1135,13870
2022-12-02 08:13:25,86.52820601851852,99,209916,56217,266133
2022-09-12 16:51:10,5.93099537037037,10,162,109,271
2022-09-06 19:20:12,0.08527777777777777,5,23,13,36
2022-09-07 10:51:38,0.7755208333333333,2,95,14,109
2022-09-07 13:03:03,0.9177199074074074,1,0,0,0
2022-09-13 08:19:44,6.86087962962963,3,125,35,160
2022-09-06 16:42:01,0.3230208333333333,1,5,5,10
2022-09-06 12:51:04,1.1307175925925925,1,44,1,45
2022-09-06 13:13:35,1.1614699074074073,1,4,4,8
2022-09-05 09:25:00,75.80174768518519,15,74463,11327,85790
2022-09-05 09:09:39,0.03972222222222222,1,2,0,2
2022-09-05 17:56:13,0.5950462962962964,3,102,82,184
2022-09-06 11:36:37,4.218043981481482,2,3866,362,4228
2022-09-27 08:39:31,24.532337962962963,2,8,22,30
2022-09-06 16:34:38,4.060868055555556,3,39,13,52
2022-09-02 14:49:09,0.014212962962962964,1,5,5,10
2022-09-02 16:17:59,0.11574074074074074,4,21,9,30
2022-09-02 13:59:25,0.019976851851851853,1,2,2,4
2022-09-02 15:59:26,0.24075231481481482,1,154,0,154
2022-09-02 11:55:30,0.1545601851851852,1,18,19,37
2022-10-04 14:00:48,32.40209490740741,1,6,6,12
2022-09-02 11:46:31,0.4640740740740741,1,2,0,2
2022-09-02 15:22:47,0.6416435185185185,1,8,2,10
2022-09-02 14:30:06,0.901238425925926,4,48,74,122
2022-09-02 14:49:39,0.9841087962962963,2,3,1,4
2022-09-01 16:06:56,0.04275462962962963,1,4,4,8
2022-09-01 16:52:33,0.10116898148148148,4,12,12,24
2022-09-08 12:50:31,28.942175925925927,40,4252,1003,5255
2022-09-05 18:35:48,4.313356481481481,2,2,2,4
2022-10-10 13:26:37,39.14376157407408,2,27214,4666,31880
2022-09-01 10:05:40,0.0665162037037037,1,1,1,2
2022-09-01 08:20:15,0.14578703703703705,1,0,3,3
2022-09-12 14:32:39,11.501006944444445,1,0,4,4
2022-09-15 18:25:33,14.683993055555556,3,7,13,20
2022-09-12 09:00:25,11.311261574074074,1,0,6,6
2022-09-01 09:53:39,0.5704050925925926,1,5,5,10
2022-08-31 17:04:04,0.022962962962962963,2,6,3,9
2022-08-31 13:10:26,0.006261574074074074,1,6,4,10
2022-09-05 08:20:27,4.854259259259259,6,35,17,52
2022-09-01 08:55:30,0.8585416666666666,4,8,5,13
2022-09-01 10:02:52,1.7380555555555555,3,70,2,72
2022-09-01 16:07:14,1.9977777777777779,10,399,108,507
2022-08-30 16:33:09,0.03417824074074074,1,3,2,5
2022-08-31 08:07:53,0.7051736111111111,1,4,4,8
2022-09-22 11:15:03,22.985300925925927,30,20908,2662,23570
2022-09-14 14:17:40,29.020949074074075,7,1978,153,2131
2022-08-29 16:46:08,0.15952546296296297,1,5,1,6
2022-08-30 10:30:46,1.0105555555555557,1,1,1,2
2022-08-29 13:56:08,0.15643518518518518,1,5,0,5
2022-08-30 10:31:34,1.0528587962962963,2,9,9,18
2022-08-31 19:48:41,2.470833333333333,3,9,3,12
2022-08-29 16:46:30,0.3602199074074074,1,2,0,2
2022-08-30 10:19:03,1.651087962962963,2,8,2,10
2022-09-06 12:12:26,8.896585648148148,8,26,11,37
2022-08-31 18:30:30,4.007569444444444,6,6,6,12
2022-08-31 17:26:39,4.1814583333333335,4,4,4,8
2022-09-01 13:12:38,5.16556712962963,5,24,19,43
2022-08-29 02:32:20,1.8097916666666667,2,1,2,3
2022-11-21 18:06:22,86.80454861111112,31,3041,1256,4297
2022-08-29 09:24:53,2.5930324074074074,1,1,1,2
2022-09-01 15:45:34,5.956122685185186,3,4,3,7
2022-08-29 07:10:14,2.654849537037037,1,1,1,2
2022-08-30 12:43:14,4.072719907407407,1,37,0,37
2022-08-26 19:04:19,0.46747685185185184,2,4,4,8
2022-09-29 00:09:44,34.239386574074075,6,133,145,278
2022-08-30 12:03:29,4.892986111111111,2,7,7,14
2022-08-30 13:29:48,4.962418981481481,2,3,2,5
2022-08-30 12:15:37,4.986342592592592,1,0,1,1
2022-08-25 15:00:38,0.7257870370370371,1,30,60,90
2022-09-15 15:12:59,21.983668981481483,4,104,47,151
2022-08-25 16:08:06,1.0237962962962963,1,22,18,40
2022-08-29 16:48:24,5.089398148148148,1,11,4,15
2022-08-26 12:11:55,65.91766203703703,15,64452,10592,75044
2022-09-16 12:42:58,22.982233796296295,2,3,0,3
2022-08-24 08:37:53,0.014027777777777778,1,1,1,2
2022-08-24 10:12:57,0.6179282407407407,1,1,1,2
2022-08-24 10:12:48,0.6180324074074074,1,1,1,2
2022-08-24 10:20:28,0.7948611111111111,2,63,62,125
2022-09-01 07:31:08,8.85167824074074,10,9888,853,10741
2022-08-23 14:38:59,0.10869212962962962,2,14,4,18
2022-09-15 11:32:32,23.06476851851852,3,45,45,90
2022-09-23 17:52:28,31.37790509259259,3,24,24,48
2022-08-23 09:10:08,0.04711805555555556,2,6,20,26
2022-09-02 20:05:32,13.88861111111111,6,242,149,391
2022-09-21 07:33:22,29.661145833333332,1,5,1,6
2022-08-24 16:12:42,2.0749305555555555,3,5,8,13
2022-08-24 09:38:03,1.8555787037037037,1,2,2,4
2022-09-02 12:48:20,10.990682870370371,3,15,12,27
2022-08-31 16:04:42,9.136886574074074,2,35,5,40
2022-10-10 14:12:40,0.03556712962962963,5,945,166,1111
2022-08-23 11:17:06,1.0887962962962963,1,15,4,19
2022-08-22 15:16:27,1.510949074074074,1,45,63,108
2022-09-15 19:53:36,26.889756944444443,3,32387,4476,36863
2022-08-19 22:37:39,0.06569444444444444,1,3,3,6
2022-08-24 09:07:17,4.504548611111111,3,6,4,10
2022-08-19 20:55:33,59.2812962962963,11,62412,10431,72843
2022-08-26 12:11:27,65.91733796296296,12,62438,10419,72857
2022-08-19 15:14:28,0.046550925925925926,1,2,0,2
2022-09-27 11:54:05,39.03980324074074,3,64,49,113
2022-08-24 10:27:56,5.034791666666667,5,263,50,313
2022-08-31 18:26:45,12.375555555555556,4,66,22,88
2022-08-23 11:23:52,4.692361111111111,2,7,5,12
2022-09-09 11:36:46,13.067476851851852,23,3062,180,3242
2022-09-09 19:01:02,22.160462962962963,32,351,219,570
2022-09-22 11:14:40,34.890034722222225,25,35182,5929,41111
2022-08-18 13:47:51,0.008958333333333334,1,1,1,2
2022-08-18 10:57:18,0.023981481481481482,2,4,1,5
2022-08-18 16:24:24,0.3029861111111111,10,262,64,326
2022-08-30 10:48:12,19.063055555555554,250,17114,3873,20987
2022-08-18 11:56:27,0.12108796296296297,4,52,6,58
2022-08-18 17:46:57,0.3957060185185185,3,383,94,477
2023-01-19 16:20:26,157.34993055555555,38,397754,145955,543709
2022-08-18 15:34:49,0.807650462962963,6,139,123,262
2022-08-18 08:03:50,57.745381944444446,11,61945,10292,72237
2022-08-31 12:46:32,13.901921296296296,2,16,1,17
2022-09-07 14:22:10,21.000127314814815,3,4,424,428
2022-08-18 14:57:40,1.056851851851852,1,13,2,15
2022-09-07 12:30:08,21.88545138888889,27,177,134,311
2022-08-18 09:56:22,1.8020138888888888,1,44,1,45
2022-09-02 15:25:26,17.08273148148148,5,217,142,359
2022-08-18 07:09:10,1.781099537037037,2,41,34,75
2022-08-16 12:30:52,0.085,1,3,1,4
2022-08-31 12:28:59,15.12429398148148,2,2,2,4
2022-09-15 11:01:20,30.08931712962963,11,32938,4652,37590
2022-08-16 11:41:37,0.17929398148148148,1,3,3,6
2022-09-02 19:29:51,17.778993055555556,11,18422,1654,20076
2022-08-16 17:25:57,0.8488773148148148,2,30,9,39
2022-08-16 15:20:46,0.8885995370370371,1,1,1,2
2022-08-17 07:50:58,1.637326388888889,2,6,6,12
2022-08-16 22:48:10,1.3957175925925926,20,239,143,382
2022-08-30 12:31:35,14.994155092592592,2,59,3,62
2022-09-01 07:57:59,16.92310185185185,2,175,0,175
2022-10-12 12:54:21,63.31607638888889,13,341,87,428
2022-08-25 14:31:34,12.625,15,11113,1209,12322
2022-08-30 12:46:21,58.90214120370371,10,46884,15609,62493
2022-08-31 14:37:19,18.88837962962963,1,26,26,52
2022-08-17 08:04:50,4.6352314814814815,2,8,2,10
2022-08-12 16:52:49,0.024259259259259258,1,2,2,4
2022-09-26 12:50:58,45.00303240740741,2,28,28,56
2022-08-12 13:10:01,0.062175925925925926,3,15,0,15
2022-08-16 11:04:52,4.042430555555556,5,124,31,155
2022-10-11 17:16:52,63.2815625,15,1556,260,1816
2022-08-12 12:48:37,0.3020717592592593,1,6,2,8
2022-08-31 12:35:11,19.46869212962963,2,17,1,18
2022-08-12 12:40:53,0.40390046296296295,1,2,2,4
2022-11-23 00:09:44,102.88818287037037,5,179789,24801,204590
2022-08-12 17:50:52,0.6301851851851852,2,6,2,8
2022-08-12 17:49:59,0.6485185185185185,1,6,7,13
2022-09-02 19:29:06,21.767546296296295,4,27,29,56
2022-08-30 12:31:00,18.731863425925926,3,63,4,67
2022-08-22 09:28:24,9.743159722222222,3,9,3,12
2022-08-11 16:10:25,0.014074074074074074,1,7,8,15
2022-08-17 13:59:43,5.937615740740741,3,135,71,206
2022-08-12 18:04:39,1.105949074074074,1,1,1,2
2022-08-16 11:53:47,4.882476851851852,3,90,31,121
2022-08-11 14:35:48,0.004733796296296297,2,2,32,34
2022-08-11 14:34:45,0.04487268518518518,2,15,10,25
2022-08-12 14:15:09,1.055011574074074,3,1275,131,1406
2022-08-11 16:32:11,0.1531597222222222,1,2,1,3
2022-08-12 11:11:28,1.0125694444444444,3,1338,222,1560
2022-08-12 12:36:28,1.1178125,3,16,2,18
2022-08-11 12:44:23,0.15328703703703703,3,11,9,20
2022-08-11 08:59:37,0.06341435185185185,2,2,2,4
2022-08-10 22:28:19,0.041574074074074076,1,1,1,2
2022-08-11 14:47:31,0.7899305555555556,1,1,1,2
2022-08-11 14:47:19,0.7971412037037037,1,1,1,2
2022-08-10 19:46:03,0.08137731481481482,1,5,1,6
2022-09-01 14:33:53,21.874837962962964,8,11446,1090,12536
2022-08-10 20:41:59,0.19131944444444443,2,6,1,7
2022-09-01 14:35:15,22.068125,26,14543,2009,16552
2022-09-02 17:54:03,40.84387731481481,25,7299,4401,11700
2022-08-10 18:20:40,0.7983333333333333,2,33,38,71
2022-08-09 23:22:55,0.10537037037037036,1,2,6,8
2022-08-29 09:43:20,6.8769328703703705,5,308,304,612
2022-08-10 11:57:21,0.9339814814814815,5,86,78,164
2022-08-10 12:00:19,0.8682291666666667,3,28,9,37
2022-08-11 13:52:27,2.003622685185185,12,1027,9,1036
2022-08-09 12:33:41,0.11707175925925926,2,2,2,4
2022-08-09 12:47:18,0.17866898148148147,2,28,10,38
2022-08-09 16:58:12,0.751724537037037,1,10,8,18
2022-08-10 15:55:19,1.8282060185185185,7,241,43,284
2022-08-08 18:33:35,0.1025,1,3,0,3
2022-08-12 17:36:18,4.072152777777778,2,39,39,78
2022-08-08 15:44:11,0.06895833333333333,1,1,3,4
2022-08-08 14:22:18,0.017141203703703704,1,1,1,2
2022-08-08 17:28:52,0.16577546296296297,2,3,0,3
2022-08-08 14:22:28,0.03792824074074074,1,7,0,7
2022-08-08 13:26:51,0.012835648148148148,2,11,3,14
2022-10-12 17:32:02,77.32925925925926,206,176365,31805,208170
2022-08-08 12:08:12,0.06600694444444444,1,4,0,4
2022-08-08 12:25:57,0.10783564814814815,2,29,2,31
2022-08-10 19:47:32,4.153958333333334,21,3891,1738,5629
2022-08-08 19:53:43,1.1485532407407408,4,203,52,255
2022-08-09 18:23:31,3.3032291666666667,3,10,9,19
2022-08-08 15:53:53,2.7722800925925926,2,247,932,1179
2022-08-17 18:57:08,12.238252314814815,4,108,92,200
2022-08-08 16:31:32,2.8263657407407408,4,307,961,1268
2022-08-08 12:48:11,2.7669791666666668,5,186,915,1101
2022-08-10 16:52:16,5.019548611111111,5,31,17,48
2022-08-05 17:29:39,0.04388888888888889,1,1,1,2
2022-08-05 17:14:01,0.04090277777777778,4,28,20,48
2022-08-06 07:42:56,0.6769212962962963,4,74,77,151
2022-08-06 07:38:56,0.713113425925926,12,39,130,169
2022-08-12 14:40:59,19.00170138888889,35,3187,270,3457
2022-08-05 13:14:51,0.013020833333333334,2,4,2,6
2022-08-11 13:45:04,6.035185185185185,8,89,65,154
2022-08-05 13:12:20,0.032372685185185185,1,0,2,2
2022-08-05 17:17:52,0.20711805555555557,1,2,2,4
2022-08-05 14:49:54,0.25207175925925923,2,13,13,26
2022-08-05 11:59:55,0.1833101851851852,2,4,4,8
2022-08-08 19:54:12,3.785902777777778,2,240,16,256
2022-09-05 12:38:08,31.783842592592592,2,74,74,148
2022-08-04 17:22:19,0.3355208333333333,5,6922,1560,8482
2022-08-08 19:52:47,4.256585648148148,11,305,236,541
2022-08-08 21:48:49,4.393368055555555,5,8,6,14
2022-08-04 12:22:25,0.0196875,1,2,2,4
2022-08-04 18:41:15,0.42940972222222223,7,39,14,53
2022-08-04 11:29:32,0.09053240740740741,3,4173,1475,5648
2022-10-20 16:15:50,77.76913194444444,2,4,2,6
2022-08-03 17:37:18,0.08467592592592593,1,164,87,251
2022-08-04 16:52:01,1.047175925925926,4,10,5,15
2022-08-04 11:29:19,0.8685532407407407,4,64,11,75
2022-08-05 17:27:19,2.129826388888889,1,3,1,4
2022-08-03 14:14:39,0.01611111111111111,1,1,0,1
2022-08-10 15:49:52,7.1089467592592595,36,1907,1077,2984
2022-08-03 12:37:43,0.06841435185185185,2,2,2,4
2022-09-30 13:26:51,59.10850694444444,13,61711,10071,71782
2022-08-03 12:33:18,0.26403935185185184,4,3,13,16
2022-09-05 12:06:36,33.283113425925926,1,2,2,4
2022-08-03 10:26:01,0.44252314814814814,1,4,4,8
2022-08-05 14:12:40,2.8325694444444443,16,764,647,1411
2022-08-03 03:09:58,0.29086805555555556,1,1,3,4
2022-08-02 20:02:26,0.025185185185185185,1,2,2,4
2022-08-02 19:03:59,0.13501157407407408,2,30,2,32
2022-08-09 07:35:06,6.667951388888889,2,8,1,9
2022-08-02 15:43:58,0.08344907407407408,4,14,18,32
2022-08-02 16:51:10,0.15415509259259258,2,7,2,9
2022-08-02 13:04:46,0.12885416666666666,2,8,12,20
2022-08-12 07:48:10,37.78106481481481,22,34351,7001,41352
2022-08-02 13:04:10,0.17306712962962964,1,1,1,2
2022-10-25 13:18:24,84.23498842592592,1,5,2,7
2022-08-03 11:32:20,3.0318055555555556,7,3690,1164,4854
2022-09-07 17:38:49,36.9596875,34,2769,1946,4715
2022-08-03 15:39:55,1.503599537037037,3,51,91,142
2022-08-01 19:32:12,0.03386574074074074,1,2,1,3
2022-08-31 08:05:33,31.349097222222223,20,595,141,736
2022-08-02 19:31:02,1.1652546296296296,3,55,6,61
2022-08-01 15:02:51,0.04708333333333333,1,2,1,3
2022-08-01 15:14:50,0.05649305555555555,2,60,28,88
2022-08-01 13:56:11,0.00982638888888889,1,1,1,2
2022-08-01 12:55:44,0.0060416666666666665,1,3,0,3
2022-08-09 07:46:53,7.9298263888888885,4,40,3,43
2022-08-01 12:06:30,0.10849537037037037,1,3,3,6
2022-08-05 06:45:07,3.9007175925925925,14,640,618,1258
2022-08-01 12:23:02,0.18450231481481483,5,93,91,184
2022-08-01 12:16:25,0.20085648148148147,1,6,0,6
2022-08-01 11:51:28,1.8857175925925926,1,3,3,6
2022-08-04 10:26:11,5.373831018518518,2,53,13,66
2022-08-01 08:46:32,2.3852083333333334,1,1,1,2
2022-08-01 08:46:57,2.3933912037037035,1,1,1,2
2022-08-01 11:40:26,2.536064814814815,2,72,49,121
2022-08-02 09:34:10,3.528900462962963,1,2,2,4
2022-08-01 16:07:30,2.895914351851852,3,580,552,1132
2022-08-01 13:19:46,2.889803240740741,6,22,25,47
2022-08-04 14:02:16,5.946261574074074,1,13,1,14
2022-07-29 14:30:59,0.017002314814814814,1,2,2,4
2022-09-09 13:18:56,42.03414351851852,2,53,53,106
2022-07-29 12:13:29,0.08766203703703704,2,4,4,8
2022-07-30 04:37:57,0.7790277777777778,1,6,2,8
2022-07-29 14:12:27,0.1842476851851852,5,24,26,50
2022-08-01 15:09:47,4.052615740740741,5,950,66,1016
2022-08-05 11:40:14,7.298935185185186,3,16,14,30
2022-10-18 12:48:03,114.92994212962962,4,415,130,545
2022-08-01 14:28:26,3.7907407407407407,4,31,8,39
2022-07-28 19:06:23,0.017893518518518517,1,18,12,30
2022-07-29 08:36:05,0.6489699074074075,3,7,6,13
2022-07-29 08:11:28,0.6159027777777778,3,16,15,31
2022-07-28 16:45:02,0.9535185185185185,1,1,0,1
2022-08-04 09:08:04,6.738854166666667,51,1247,1008,2255
2022-07-28 18:21:44,0.14726851851851852,2,49,27,76
2022-07-28 13:53:03,0.01707175925925926,1,1,1,2
2022-07-28 15:50:45,0.11993055555555555,1,0,1,1
2022-07-28 13:04:32,49.11877314814815,15,59848,6712,66560
2022-08-18 14:06:16,21.165104166666666,4,35,16,51
2022-07-28 12:14:15,0.08546296296296296,1,21,21,42
2022-08-02 17:14:46,5.32574074074074,1,5,2,7
2022-07-28 10:14:57,0.03302083333333333,1,1,1,2
2022-08-01 16:10:20,4.753703703703704,4,347,312,659
2022-07-28 18:24:27,0.891087962962963,5,62,40,102
2022-07-29 12:09:09,1.8147685185185185,11,3693,1007,4700
2022-07-27 20:32:57,0.0804861111111111,1,1,1,2
2022-07-27 13:37:02,0.023425925925925926,2,26,3,29
2022-07-27 13:09:33,0.008703703703703703,1,103,2,105
2022-07-27 12:39:10,0.011944444444444445,2,21,34,55
2022-07-27 10:38:40,249.91521990740742,4,388772,125878,514650
2022-07-27 11:06:01,0.1207986111111111,1,1,1,2
2022-07-27 08:00:47,0.42496527777777776,1,0,1,1
2022-07-27 14:26:27,1.1359375,6,2240,301,2541
2022-07-26 13:47:23,0.08940972222222222,3,24,3,27
2022-07-26 16:08:16,0.17505787037037038,3,11,15,26
2022-08-03 13:45:15,8.971712962962963,2,18,16,34
2022-08-01 16:06:30,6.482291666666667,20,6072,678,6750
2022-07-27 08:35:56,0.985,1,4,4,8
2022-07-26 11:44:54,0.17483796296296297,1,2,1,3
2022-07-27 08:44:14,1.6174537037037038,1,2,6,8
2022-07-25 19:19:40,0.11462962962962962,2,3,3,6
2022-07-26 12:37:35,0.9279050925925926,4,161,3,164
2022-07-26 12:29:00,1.0021180555555556,3,34,1,35
2022-07-27 11:23:57,3.006099537037037,3,106,58,164
2022-08-11 13:54:44,18.744733796296295,13,55,45,100
2022-07-27 08:08:59,3.9369675925925924,3,246,21,267
2022-07-25 11:51:37,2.7647569444444446,3,38,9,47
2022-07-26 11:27:02,3.760613425925926,1,56,55,111
2022-07-26 11:30:06,3.8084837962962963,1,11,11,22
2022-07-27 07:54:41,4.712025462962963,4,57,34,91
2022-08-12 13:53:52,20.935949074074074,8,20202,5884,26086
2022-07-22 14:24:49,0.01837962962962963,1,1,1,2
2022-07-26 11:02:59,3.886689814814815,1,2,6,8
2022-07-26 07:34:06,3.749884259259259,1,2,2,4
2022-07-26 07:55:14,39.77675925925926,95,55060,10282,65342
2022-07-22 16:01:30,0.13071759259259258,2,10,25,35
2022-07-22 11:32:20,0.007268518518518519,2,2,2,4
2022-07-26 15:57:59,4.263101851851852,4,55,29,84
2022-07-25 09:09:23,3.035763888888889,1,7,3,10
2022-09-01 10:04:50,41.10421296296296,7,34196,6543,40739
2022-07-26 20:00:24,4.853877314814815,2,3,1,4
2022-07-21 18:44:57,0.09197916666666667,2,49,17,66
2022-07-26 07:07:11,4.788599537037037,2,2,2,4
2022-07-22 14:17:49,1.0922916666666667,1,1,1,2
2022-07-21 09:52:34,0.007916666666666667,1,14,1,15
2022-07-21 09:03:25,0.006678240740740741,1,2,2,4
2022-07-21 09:02:26,41.95064814814815,18,76999,9582,86581
2022-07-27 15:15:41,6.304212962962963,3,154,31,185
2022-08-05 11:39:40,15.204409722222222,2,13710,1097,14807
2022-07-21 05:55:30,0.03854166666666667,1,1,1,2
2022-07-21 05:56:20,9.311747685185185,3,176,94,270
2022-07-20 10:30:14,0.02053240740740741,1,1,1,2
2022-09-01 20:19:11,43.8969212962963,6,81,70,151
2022-07-20 06:14:11,0.5765972222222222,1,78,78,156
2022-07-19 16:00:35,0.03405092592592593,2,2,2,4
2022-07-19 14:58:42,0.04375,2,11,10,21
2022-08-02 17:22:55,14.24738425925926,3,18272,2960,21232
2022-07-19 13:43:06,0.11875,2,1788,168,1956
2022-07-19 09:47:27,0.09503472222222223,2,24,3,27
2022-07-19 13:28:37,0.23247685185185185,1,1,1,2
2022-07-19 07:46:18,0.0050578703703703706,1,35,10,45
2022-07-19 06:13:21,0.011967592592592592,2,1,6,7
2022-07-20 13:54:44,1.9038425925925926,1,14,2,16
2022-07-18 15:43:52,0.010694444444444444,1,1,1,2
2022-07-19 09:53:53,27.821805555555557,17,30845,4542,35387
2022-07-18 14:02:42,0.022002314814814815,1,8,4,12
2022-07-18 14:01:52,0.026041666666666668,1,2,2,4
2022-07-18 13:26:21,0.12612268518518518,3,7,7,14
2022-07-18 17:18:19,0.3126851851851852,2,5,31,36
2022-07-26 11:56:40,8.499166666666667,3,3083,242,3325
2022-07-18 07:53:18,1.476886574074074,1,1,1,2
2022-07-18 13:46:08,2.492002314814815,1,1,1,2
2022-07-18 07:50:32,2.27912037037037,1,1,1,2
2022-07-18 13:17:08,2.7530439814814813,1,31,2,33
2022-07-22 17:05:38,6.945648148148148,23,7835,1016,8851
2022-07-18 13:19:40,3.1748842592592594,2,72,44,116
2022-07-19 08:24:56,4.814976851851852,1,1,1,2
2022-07-18 18:32:10,4.256793981481482,3,82,15,97
2022-07-15 13:54:08,1.2637962962962963,3,7,4,11
2022-07-18 12:12:35,4.848715277777778,8,1460,39,1499
2022-07-13 16:43:08,0.07505787037037037,2,54,3,57
2022-07-20 08:14:22,6.852222222222222,19,2154,343,2497
2022-07-21 08:35:41,55.32347222222222,14,56969,5797,62766
2022-07-13 12:19:20,0.45261574074074074,2,2,0,2
2022-07-13 12:18:44,0.5118287037037037,2,2,2,4
2022-07-20 17:23:03,7.827685185185185,6,355,316,671
2022-07-13 09:43:42,0.7693287037037037,1,30,16,46
2022-07-12 12:38:06,0.06987268518518519,1,0,1,1
2022-07-12 08:28:29,0.21296296296296297,1,2,1,3
2022-07-12 18:05:31,1.0625694444444445,1,14,36,50
2022-07-11 16:41:57,0.012175925925925925,1,12,14,26
2022-07-11 16:45:06,0.024618055555555556,1,19,3,22
2022-07-26 12:01:08,83.49055555555556,17,296762,40165,336927
2022-07-22 12:31:46,10.884050925925926,2,201,76,277
2022-07-12 12:18:35,1.0192939814814814,2,4,6,10
2022-07-26 07:39:14,14.902164351851852,1,1,0,1
2022-07-10 16:11:47,0.007314814814814815,1,5,5,10
2022-07-19 10:02:36,11.669756944444444,15,468,86,554
2022-07-08 20:44:25,8.983368055555555,6,3792,689,4481
2022-07-08 14:51:26,0.01570601851851852,2,4,2,6
2022-07-18 13:29:15,10.195752314814815,5,414,148,562
2022-07-12 04:34:09,3.797199074074074,7,767,585,1352
2022-07-11 13:59:08,3.3022685185185185,4,32,21,53
2022-07-13 14:07:21,6.120717592592593,7,244,72,316
2022-07-08 15:08:54,0.8825925925925926,1,6,0,6
2022-07-27 11:20:35,19.756319444444443,1,1,1,2
2022-09-29 08:42:08,83.74747685185186,4,33,10,43
2022-07-07 13:08:36,0.01653935185185185,1,48,0,48
2022-07-08 15:06:00,1.438726851851852,6,31,18,49
2022-07-07 12:17:49,0.7797685185185185,1,2,2,4
2022-07-06 15:36:28,0.07365740740740741,1,8,1,9
2022-07-06 16:10:07,0.6413310185185185,2,34,34,68
2022-07-07 12:17:59,1.757337962962963,3,110,19,129
2022-07-05 15:22:03,0.03145833333333333,1,8,8,16
2022-07-28 13:58:26,23.154247685185187,4,21016,2202,23218
2022-09-29 09:48:04,86.16688657407407,53,16734,2400,19134
2022-07-23 17:02:03,18.91605324074074,8,239,166,405
2022-07-26 08:14:08,21.62619212962963,6,8226,1298,9524
2022-07-05 12:53:44,0.8577199074074074,1,3,1,4
2022-07-04 16:36:36,0.12769675925925925,1,10,1,11
2022-07-04 16:26:19,0.1244212962962963,6,41,65,106
2022-07-11 09:02:54,6.831377314814815,4,18,9,27
2022-07-04 13:20:55,0.025231481481481483,1,24,32,56
2022-08-09 16:50:03,36.17324074074074,3,64,13,77
2022-07-07 12:18:44,3.1202314814814813,3,1742,330,2072
2022-08-31 18:58:45,60.41903935185185,2,39,3,42
2022-07-04 12:40:13,0.17967592592592593,1,2,2,4
2022-07-06 13:44:19,0.22133101851851852,2,16,8,24
2022-07-04 10:04:58,0.9646064814814815,1,1,1,2
2022-07-12 14:36:09,10.271932870370371,8,2352,771,3123
2022-08-14 15:27:13,52.08263888888889,21,44035,5626,49661
2022-07-01 20:17:41,0.11851851851851852,9,4,2,6
2022-07-01 18:55:35,0.08359953703703704,3,12,4,16
2022-07-06 14:02:07,4.888958333333333,3,95,152,247
2022-07-01 18:44:27,0.07116898148148149,2,14,6,20
2022-07-01 13:19:14,0.12454861111111111,1,1,1,2
2022-07-06 12:11:48,5.163090277777778,1,36,2,38
2022-07-01 15:53:16,0.5387037037037037,1,4,4,8
2022-08-18 13:13:54,48.64835648148148,1,11,10,21
2022-07-01 18:11:14,1.0139467592592593,21,333,138,471
2022-07-01 18:33:48,0.9984722222222222,1,6,2,8
2022-07-04 18:47:44,4.029756944444444,2,22,16,38
2022-09-06 08:39:31,67.60385416666666,7,84094,14801,98895
2022-07-07 17:02:22,6.979664351851852,3,22,14,36
2022-07-05 14:17:17,4.936782407407407,1,2,2,4
2022-09-30 19:33:00,92.16350694444445,172,91932,16549,108481
2022-06-30 16:05:29,0.024293981481481482,1,3,0,3
2022-07-01 14:44:42,1.0873726851851853,7,130,33,163
2022-06-30 15:51:04,0.18886574074074075,4,112,48,160
2022-06-30 16:09:52,0.8835532407407407,6,11846,430,12276
2022-06-30 15:01:40,0.8691898148148148,1,4,0,4
2022-06-29 18:23:40,0.01678240740740741,1,3,0,3
2022-06-29 17:32:19,0.037523148148148146,1,3,3,6
2022-06-29 15:55:22,0.03951388888888889,1,5,5,10
2022-06-29 16:20:35,0.09775462962962964,2,3,2,5
2022-07-01 13:48:43,2.0106712962962963,1,2,2,4
2022-06-29 14:19:38,0.02851851851851852,2,2,4,6
2022-07-22 10:35:32,35.888078703703705,87,53085,9813,62898
2022-06-29 15:03:33,0.08454861111111112,10,67,60,127
2022-06-30 12:53:33,1.0808449074074074,4,8123,364,8487
2022-06-29 17:49:31,0.3115625,2,4,2,6
2022-08-11 12:51:40,43.209143518518516,7,131,45,176
2022-07-04 08:13:05,4.991006944444444,1,2,11,13
2022-07-04 08:04:16,5.044108796296296,1,1,1,2
2022-06-29 13:02:54,0.7265856481481482,1,8,4,12
2022-08-08 13:53:08,40.77641203703703,9,34669,5337,40006
2022-07-26 08:11:33,27.82403935185185,15,27371,2547,29918
2022-07-01 13:04:38,3.0308680555555556,4,12346,580,12926
2022-07-01 14:10:56,3.1284375,5,11870,515,12385
2022-07-21 13:03:50,23.15826388888889,12,141,79,220
2022-07-05 16:08:36,14.191793981481482,7,635,49,684
2022-06-28 08:32:19,0.007118055555555555,1,2,2,4
2022-06-29 21:54:27,1.5704976851851853,3,2,9,11
2022-06-28 08:15:07,0.0007523148148148148,1,2,2,4
2022-06-29 08:30:20,1.0160069444444444,1,8,3,11
2022-07-21 17:22:38,23.500127314814815,37,23440,2541,25981
2022-06-28 12:34:55,0.5224884259259259,1,2,0,2
2022-06-28 21:24:45,0.9966319444444445,1,26,1,27
2022-06-30 16:11:08,2.783738425925926,7,179,75,254
2022-06-28 12:48:43,0.6632986111111111,2,55,2,57
2022-06-28 12:57:53,0.7134837962962963,2,6,0,6
2022-07-15 13:54:26,17.77315972222222,5,111,15,126
2022-08-10 07:13:37,46.91108796296297,91,58843,9153,67996
2022-06-28 12:04:20,0.8910532407407408,3,22,31,53
2022-06-28 11:44:57,0.9328125,1,13,22,35
2022-06-29 10:06:42,1.859236111111111,1,0,2,2
2022-06-28 06:56:25,109.8326388888889,5,63,34,97
2022-06-29 12:53:14,2.976840277777778,2,9,5,14
2022-06-29 09:23:49,2.1048958333333334,1,1,1,2
2022-06-27 12:36:11,0.8973611111111112,1,11,1,12
2022-06-28 06:55:03,1.588912037037037,1,2,2,4
2022-07-01 13:33:37,4.7040625,2,2,2,4
2022-06-28 06:53:53,1.4281365740740741,3,24,22,46
2022-06-27 13:50:44,1.9316898148148147,1,82,82,164
2022-06-27 19:01:49,2.8325578703703704,2,2,2,4
2022-06-27 07:27:30,2.470162037037037,1,27,1,28
2022-06-24 17:36:45,0.06936342592592593,1,6,3,9
2022-06-24 16:06:31,0.009675925925925926,1,1,0,1
2022-06-24 20:56:47,0.23304398148148148,2,12,15,27
2022-06-27 17:07:35,3.1084027777777776,2,10,0,10
2022-07-11 17:16:14,32.05003472222222,34,35909,4613,40522
2022-06-24 13:23:30,0.018877314814814816,1,1,2,3
2022-06-24 17:35:01,0.13873842592592592,1,8,1,9
2022-07-27 14:50:47,33.15506944444444,14,204,221,425
2022-06-27 17:09:20,3.413460648148148,1,2,2,4
2022-06-24 16:12:36,0.7571875,3,25,23,48
2022-06-29 11:41:01,5.657777777777778,9,409,354,763
2022-06-23 19:46:01,0.08460648148148148,11,86,53,139
2022-06-24 14:26:15,0.8526736111111111,2,37,1,38
2022-06-23 16:53:50,0.0234375,1,6,7,13
2022-06-24 17:23:29,1.1143634259259259,1,2,0,2
2022-06-23 15:08:37,0.030833333333333334,1,13,7,20
2022-11-14 06:00:10,146.85894675925925,40,4927,2513,7440
2022-07-01 17:33:54,8.170613425925925,11,506,188,694
2022-07-01 14:46:02,8.053414351851853,1,1,1,2
2022-06-23 14:59:54,0.062094907407407404,3,20,7,27
2022-06-23 12:43:53,0.06268518518518519,1,2,2,4
2022-06-25 15:17:11,2.2085069444444443,4,81,57,138
2022-06-27 12:08:18,4.101180555555556,1,11,11,22
2022-06-23 12:39:48,0.14991898148148147,1,16,4,20
2022-07-21 12:07:54,28.68951388888889,5,30569,3750,34319
2022-06-23 11:37:29,0.7460648148148148,3,24,24,48
2022-11-10 20:05:28,141.09988425925926,225,247510,45404,292914
2022-06-23 13:57:12,0.9296064814814815,8,29781,2724,32505
2022-06-24 17:31:31,2.191377314814815,3,19,21,40
2022-08-04 16:02:55,76.05509259259259,42,3587,1024,4611
2022-06-22 12:26:03,0.21108796296296295,1,1,106,107
2022-06-22 13:29:40,0.3559837962962963,1,1,1,2
2022-06-22 13:29:28,0.35604166666666665,1,1,1,2
2022-06-24 12:48:19,2.8169328703703704,10,1760,268,2028
2022-06-24 12:56:08,2.391909722222222,2,9,3,12
2022-06-30 12:47:40,8.599641203703703,2,29,20,49
2022-06-22 16:23:08,0.7691203703703704,2,58,5,63
2022-07-26 14:10:38,39.73056712962963,8,42653,5343,47996
2022-07-13 17:04:08,26.028518518518517,39,27086,3721,30807
2022-06-22 12:11:40,0.8295023148148148,7,456,423,879
2022-06-21 16:31:15,0.017233796296296296,1,1,1,2
2022-06-21 17:39:55,0.0791550925925926,1,7,3,10
2022-06-23 11:28:09,1.9836342592592593,5,112,215,327
2022-06-21 15:21:07,0.017893518518518517,1,12,6,18
2022-11-21 15:21:28,154.24873842592592,3,1830,19,1849
2022-07-27 09:59:08,35.842326388888885,11,9508,2051,11559
2022-06-23 12:40:14,1.9942476851851851,4,1481,261,1742
2022-06-21 12:53:08,0.1178587962962963,1,2,1,3
2022-06-23 10:31:23,2.0507291666666667,1,2,2,4
2022-06-29 13:30:55,8.189722222222223,29,15142,3090,18232
2022-06-23 11:26:15,5.837719907407408,5,22,3,25
2022-06-21 18:26:36,0.819849537037037,8,1644,261,1905
2022-06-29 22:49:02,11.010462962962963,28,17522,3809,21331
2022-06-23 11:58:44,2.6219212962962963,9,141,133,274
2022-06-21 15:55:26,1.103935185185185,4,187,82,269
2022-06-20 16:49:09,0.9328240740740741,1,1,1,2
2022-06-23 16:36:23,40.03053240740741,43,58867,9258,68125
2022-06-21 18:27:01,3.262939814814815,3,9,5,14
2022-07-18 17:09:08,39.28863425925926,13,15458,1941,17399
2022-07-13 16:43:29,25.687928240740742,28,67164,7983,75147
2022-06-20 12:43:36,2.772384259259259,2,10,2,12
2022-06-22 05:04:36,4.574548611111111,18,3813,1269,5082
2022-06-22 15:50:21,5.1125694444444445,6,67,44,111
2022-06-18 06:35:04,0.9188773148148148,8,299,104,403
2022-06-17 14:53:46,0.1987962962962963,1,1,0,1
2022-06-23 12:51:54,6.113969907407407,11,151,45,196
2022-06-21 19:35:55,4.691273148148148,1,29,1,30
2022-06-17 16:10:33,0.6647222222222222,1,1,1,2
2022-06-17 16:10:17,0.665625,1,1,1,2
2022-06-21 08:24:51,4.516018518518519,5,44,5,49
2022-06-20 12:40:11,3.777025462962963,2,50,22,72
2022-06-16 15:27:59,0.05803240740740741,3,41,27,68
2022-08-01 16:24:44,98.32846064814815,8,45,24,69
2022-06-24 09:34:52,7.889351851851852,16,929,1044,1973
2022-06-16 12:17:48,0.017685185185185186,4,21,45,66
2022-06-16 11:54:46,0.29868055555555556,1,1,1,2
2022-06-15 20:11:57,0.019849537037037037,1,12,12,24
2022-06-15 18:59:11,0.02388888888888889,1,68,68,136
2022-06-15 18:25:51,0.0719675925925926,3,65,54,119
2022-06-15 17:51:42,0.05287037037037037,1,1,1,2
2022-06-15 16:42:43,0.03760416666666667,1,13,8,21
2022-06-21 15:51:18,4.889074074074074,6,85,96,181
2022-06-21 16:01:09,7.0328587962962965,34,20224,1956,22180
2022-06-21 14:45:36,6.074826388888889,11,2116,1010,3126
2022-06-21 13:56:01,6.1487847222222225,4,205,77,282
2022-06-15 16:34:15,0.34752314814814816,3,20,15,35
2022-06-21 19:30:41,6.551516203703704,1,1,2,3
2022-06-14 15:27:40,0.011435185185185185,1,2,4,6
2022-06-27 11:06:21,12.873703703703704,23,569,170,739
2022-06-14 12:10:51,0.03542824074074074,1,26,26,52
2022-07-21 12:23:48,37.057175925925925,3,42067,4874,46941
2022-06-14 13:28:12,0.9147453703703704,3,138,36,174
2022-06-15 15:43:31,2.0039699074074075,1,8,13,21
2022-06-14 13:15:39,1.0202199074074074,2,2,2,4
2022-06-17 18:14:04,631.6539930555556,7,44,25,69
2022-06-13 07:22:08,1.553460648148148,1,1,1,2
2022-08-22 10:13:21,71.71431712962963,7,71983,10347,82330
2022-06-13 12:02:06,2.6051273148148146,1,2,2,4
2022-06-13 13:34:45,3.0947685185185185,6,125,93,218
2022-06-30 14:37:18,19.95423611111111,10,32049,3535,35584
2022-06-13 12:05:46,2.8886574074074076,1,4,4,8
2022-07-18 17:21:07,39.29695601851852,12,45089,5272,50361
2022-06-10 16:49:04,0.11043981481481481,1,2,2,4
2022-06-10 16:48:58,0.11311342592592592,1,2,2,4
2022-06-10 14:54:14,0.046342592592592595,3,157,137,294
2022-06-10 13:55:24,0.005729166666666666,1,2,2,4
2022-06-10 11:43:13,0.017314814814814814,1,6,5,11
2022-06-10 13:41:54,0.20844907407407406,6,36,29,65
2022-06-14 12:56:32,4.19292824074074,4,137,96,233
2022-06-10 01:32:20,0.00962962962962963,1,11,2,13
2022-06-10 08:27:51,0.3284606481481481,1,1,1,2
2022-06-09 23:01:01,0.02361111111111111,1,4,1,5
2022-06-10 16:50:11,0.7894097222222223,1,4,4,8
2022-07-21 10:02:08,41.75758101851852,4,42678,5057,47735
2022-06-15 16:18:00,5.870393518518519,3,22,21,43
2022-07-22 11:53:54,42.7284375,13,53449,6116,59565
2022-06-14 15:10:13,4.862881944444444,14,9612,628,10240
2022-06-10 16:50:29,0.9847916666666666,1,15,8,23
2022-06-09 17:04:43,0.00837962962962963,1,23,1,24
2022-06-09 16:38:48,0.014444444444444444,1,7,2,9
2022-06-23 15:11:17,13.96326388888889,6,25,19,44
2022-06-14 16:14:12,5.006956018518519,1,1,1,2
2022-06-10 10:46:30,0.8003356481481482,1,4,0,4
2022-07-26 13:48:59,47.0330787037037,12,51968,5757,57725
2022-06-09 16:37:48,0.25453703703703706,3,31,17,48
2022-06-13 14:44:06,4.056828703703704,9,41,22,63
2022-06-10 06:12:17,0.6984259259259259,6,3243,270,3513
2022-06-09 13:31:02,0.01972222222222222,1,34,2,36
2022-06-10 06:18:42,0.7202083333333333,3,3287,268,3555
2022-06-14 15:22:21,5.1031712962962965,2,31,26,57
2022-06-17 17:59:35,8.31480324074074,22,13172,946,14118
2022-06-09 22:18:29,0.7299537037037037,3,6,4,10
2022-06-21 09:04:15,12.191851851851851,31,15081,1873,16954
2022-06-10 00:56:44,1.3280208333333334,3,1158,89,1247
2022-06-09 17:18:26,0.9901273148148149,6,84,24,108
2022-06-08 17:30:03,0.05179398148148148,3,48,45,93
2022-06-09 16:20:39,1.0341087962962963,1,8,2,10
2022-06-08 15:34:05,0.010729166666666666,1,1,1,2
2022-06-09 21:02:33,1.2751736111111112,3,30,2,32
2022-06-09 16:33:10,1.1345601851851852,4,92,40,132
2022-06-08 15:16:00,0.12354166666666666,1,1,1,2
2022-06-08 14:51:40,0.28711805555555553,2,2,2,4
2022-07-18 17:06:10,40.439166666666665,7,9170,587,9757
2022-06-08 16:42:23,0.9520949074074074,3,11,9,20
2022-06-09 13:50:50,1.9409722222222223,6,108,73,181
2022-06-07 23:51:00,0.3382986111111111,1,15,0,15
2022-06-08 09:45:10,0.7733101851851852,9,136,64,200
2022-06-08 13:04:22,1.0047916666666667,5,21,12,33
2022-06-09 12:44:27,2.026736111111111,3,35,3,38
2022-06-07 12:00:36,0.6505671296296296,4,12,7,19
2022-06-06 20:41:41,0.038356481481481484,1,0,2,2
2022-06-13 13:59:27,6.926041666666666,1,1,0,1
2022-06-23 20:51:33,17.37275462962963,7,170,108,278
2022-06-13 17:34:08,7.40957175925926,3,43,7,50
2022-06-18 00:06:05,50.80050925925926,18,90503,16403,106906
2022-06-06 13:29:07,0.6269328703703704,1,0,6,6
2022-07-11 09:00:13,35.98688657407408,3,95,83,178
2022-06-07 12:09:40,2.536423611111111,1,1,1,2
2022-06-06 11:47:33,2.1050115740740742,1,1,1,2
2022-06-29 12:45:14,25.365289351851853,42,41682,5054,46736
2022-06-06 14:49:25,2.8625,3,91,74,165
2022-06-07 15:57:52,3.8836921296296296,6,336,94,430
2022-06-03 18:19:03,0.008078703703703704,1,51,51,102
2022-06-08 13:30:41,4.810439814814814,15,25000,1763,26763
2022-06-03 17:56:37,0.018125,1,2,2,4
2022-06-03 16:29:38,0.013715277777777778,1,1,1,2
2022-06-07 16:05:21,4.314641203703704,5,234,42,276
2022-06-03 13:59:14,0.7293055555555555,1,9,21,30
2022-06-02 19:52:30,0.010277777777777778,1,1,1,2
2022-06-03 16:34:42,0.8908217592592592,5,364,140,504
2022-06-06 11:48:08,4.1427199074074075,3,3337,346,3683
2022-06-02 14:37:00,0.02704861111111111,1,1,1,2
2022-06-03 13:31:11,1.160451388888889,3,435,140,575
2022-06-02 11:44:03,0.4729976851851852,1,4,2,6
2022-06-02 11:45:41,0.4775115740740741,1,2,1,3
2022-06-02 12:10:09,0.5218171296296297,3,172,77,249
2022-06-01 17:40:49,0.02605324074074074,4,7,7,14
2022-06-02 15:40:02,0.9497222222222222,3,42,7,49
2022-06-02 16:52:46,1.0088657407407406,5,6,5,11
2022-06-01 19:01:32,0.17609953703703704,1,16,1,17
2022-06-01 14:27:23,0.06672453703703704,2,14,1,15
2022-06-06 14:35:21,6.075520833333333,25,16841,2954,19795
2022-06-01 14:26:37,0.2178587962962963,3,5,6,11
2022-06-01 13:59:40,0.5936111111111111,1,15,6,21
2022-08-03 10:33:45,68.54009259259259,7,139,51,190
2022-07-04 10:03:42,33.67597222222222,4,2911,30,2941
2022-06-01 12:43:28,0.8318634259259259,1,2,1,3
2022-06-01 14:03:06,0.9389814814814815,6,25,14,39
2022-05-31 18:06:49,0.06719907407407408,1,11,0,11
2022-06-01 17:52:08,1.0961342592592593,6,249,44,293
2022-06-01 13:00:11,0.8694907407407407,1,2,0,2
2022-06-09 07:50:03,13.866064814814814,3,2536,550,3086
2022-06-01 12:36:19,2.0553125,6,1681,363,2044
2022-06-06 11:47:34,6.655601851851852,4,7266,494,7760
2022-05-31 13:58:39,0.27239583333333334,2,5,2,7
2022-05-31 13:40:48,0.28118055555555554,1,3,3,6
2022-06-20 10:07:47,25.64820601851852,17,514,179,693
2022-06-03 09:08:36,3.6488657407407405,7,25,1,26
2022-06-09 10:00:40,80.01697916666667,195,47925,14352,62277
2022-05-31 13:57:44,1.3016666666666667,8,1027,130,1157
2022-06-02 08:30:54,2.959791666666667,1,25,25,50
2022-05-31 13:01:54,2.948402777777778,1,4,0,4
2022-07-27 15:14:48,65.14350694444444,75,4691,2426,7117
2022-06-01 15:06:21,7.041631944444444,50,3897,1845,5742
2022-05-31 15:07:31,3.951273148148148,8,12285,663,12948
2022-05-27 18:36:31,1.4411805555555555,6,310,118,428
2022-06-24 15:10:38,29.266006944444445,33,7382,1976,9358
2022-05-31 12:59:49,4.8795370370370375,1,4,4,8
2022-05-26 16:24:12,0.03719907407407407,2,12214,620,12834
2022-05-26 13:56:55,0.020868055555555556,1,3,2,5
2022-05-26 13:57:12,0.043298611111111114,1,2,2,4
2022-06-29 17:15:32,34.36769675925926,12,151,124,275
2022-06-14 07:58:48,18.99709490740741,4,6,5,11
2022-05-31 13:39:03,5.293483796296297,4,10,13,23
2022-05-31 13:16:18,5.712476851851852,3,44,2,46
2022-07-04 09:59:16,48.79034722222222,47,92618,13454,106072
2022-05-31 13:06:45,5.772488425925926,8,170,130,300
2022-05-25 20:04:43,371.45640046296296,26,517311,156048,673359
2022-05-25 18:38:56,0.017233796296296296,1,1,5,6
2022-06-03 08:56:37,8.644745370370371,12,164,152,316
2022-05-25 18:54:43,0.13783564814814814,1,1,1,2
2022-06-07 09:53:05,12.824050925925926,10,36,48,84
2022-05-25 15:35:50,0.08923611111111111,1,3,0,3
2022-05-31 07:21:32,5.747650462962963,1,1,1,2
2022-05-25 11:23:57,0.5659722222222222,1,71,192,263
2022-05-25 11:23:41,0.6124189814814814,1,13,9,22
2022-05-25 14:51:27,0.8924537037037037,1,103,9,112
2022-05-24 23:36:56,0.2537152777777778,1,1,1,2
2022-05-31 07:48:10,6.717175925925926,1,1,1,2
2022-05-25 09:19:06,0.8244444444444444,2,8,11,19
2022-05-31 08:02:56,6.910625,8,555,186,741
2022-05-31 16:41:22,7.381145833333333,41,14861,881,15742
2022-06-13 17:45:26,27.830289351851853,13,41128,3365,44493
2022-06-02 08:24:16,9.522060185185186,8,188,119,307
2022-05-23 19:25:52,0.0016898148148148148,1,1,0,1
2022-05-23 14:43:10,0.043912037037037034,1,7,6,13
2022-05-24 12:51:26,1.138414351851852,1,14,109,123
2022-06-29 10:16:36,37.13734953703704,1,3,3,6
2022-06-02 08:19:27,9.593726851851851,1,30,1,31
2022-05-20 15:00:58,0.05457175925925926,5,8,5,13
2022-05-23 14:11:09,3.1325462962962964,1,31,30,61
2022-05-20 16:41:12,0.25028935185185186,2,11,8,19
2022-05-19 21:46:26,0.019965277777777776,2,41,0,41
2022-06-10 13:36:48,21.74822916666667,1,5,10,15
2022-06-29 20:07:51,41.258287037037036,45,2981,479,3460
2022-05-19 20:15:36,0.24465277777777777,8,70,90,160
2022-05-25 20:21:27,6.321724537037037,2,247,31,278
2022-05-31 12:41:54,12.113981481481481,1,41,41,82
2022-05-23 18:32:21,6.294803240740741,16,338,109,447
2022-05-18 19:26:45,0.013275462962962963,1,2,2,4
2022-06-17 14:42:28,3.2878587962962964,3,348,254,602
2022-05-18 19:49:08,0.08439814814814815,3,7,6,13
2022-05-18 18:17:40,0.2309375,10,105,135,240
2022-05-19 18:28:12,1.0671643518518519,1,7,0,7
2022-05-18 17:07:49,0.05115740740740741,4,17,15,32
2022-05-18 14:29:53,0.006006944444444444,1,1,1,2
2022-05-19 20:42:44,1.2891550925925925,1,0,1,1
2022-05-18 14:06:41,0.04203703703703704,1,0,220,220
2022-05-19 08:29:16,0.8224189814814815,6,47,8,55
2022-05-18 15:57:24,0.3048958333333333,1,7,0,7
2022-05-18 14:06:24,0.2672685185185185,2,20,3,23
2022-05-18 13:46:12,0.256724537037037,1,2,2,4
2022-06-01 10:16:15,14.217847222222222,5,43,3,46
2022-06-28 18:51:48,41.96200231481482,43,119721,25262,144983
2022-05-18 23:00:47,0.9608680555555555,2,8,8,16
2022-05-19 20:17:02,9.408171296296297,8,3575,3453,7028
2022-05-17 22:34:32,0.015868055555555555,1,7,0,7
2022-05-25 15:16:09,7.8583796296296295,10,218,67,285
2022-06-20 14:16:17,26.89841435185185,19,233,178,411
2022-05-17 16:56:24,0.12939814814814815,1,3,1,4
2022-05-17 16:20:37,0.10533564814814815,3,9,11,20
2022-05-17 13:48:23,0.013414351851851853,1,3,7,10
2022-05-17 13:14:17,0.028402777777777777,2,4,6,10
2022-05-18 15:47:18,7.312268518518518,11,1800,121,1921
2022-05-17 16:56:58,0.8506481481481482,3,24,7,31
2022-05-18 13:08:57,1.5870833333333334,6,32,26,58
2022-05-19 20:21:19,2.904710648148148,1,1,1,2
2022-05-23 10:55:36,6.756273148148148,21,114,89,203
2022-05-16 18:55:47,0.0431712962962963,1,18,0,18
2022-05-16 18:18:09,0.021076388888888888,1,1,0,1
2022-06-13 11:49:44,29.831469907407406,26,39922,3628,43550
2022-05-16 21:24:20,0.2667824074074074,5,4,10,14
2022-09-14 09:45:22,233.6946064814815,82,9439,2547,11986
2022-05-17 11:37:48,0.9529513888888889,2,11,11,22
2022-05-16 11:08:04,0.04,1,9,9,18
2022-05-16 13:34:05,0.1699189814814815,1,0,6,6
2022-05-17 07:32:47,1.5797106481481482,1,2,2,4
2022-06-08 13:03:18,23.89327546296296,21,41613,5536,47149
2022-05-17 06:31:06,1.835775462962963,9,73,117,190
2022-05-16 20:02:28,2.0438194444444444,1,10,0,10
2022-05-16 21:04:30,1.1202777777777777,1,1,1,2
2022-05-25 23:10:16,64.49641203703703,22,107849,30678,138527
2022-05-16 11:24:01,0.955462962962963,1,1,1,2
2022-05-17 15:58:15,2.774421296296296,3,67,12,79
2022-05-25 22:46:53,11.152766203703704,7,27461,4288,31749
2022-05-16 17:24:20,2.9095138888888887,6,1099,994,2093
2022-05-16 21:30:49,3.123784722222222,2,3,3,6
2022-05-17 21:42:14,4.21261574074074,10,3624,2248,5872
2022-05-13 19:50:41,0.13571759259259258,4,27,6,33
2022-05-13 17:47:09,0.06922453703703704,1,2,0,2
2022-05-13 18:59:57,0.1290162037037037,1,6,4,10
2022-05-13 15:49:23,0.01087962962962963,1,2,0,2
2022-05-16 13:37:39,2.943726851851852,1,5,2,7
2022-05-13 15:26:26,0.033900462962962966,1,3,3,6
2022-05-16 19:14:25,3.285578703703704,1,1,1,2
2022-05-17 12:33:14,4.019675925925926,2,47,3,50
2022-05-13 13:14:23,0.10909722222222222,4,8,8,16
2022-05-13 13:14:50,0.13067129629629629,3,68,59,127
2022-05-23 19:20:30,10.557465277777778,1,1,1,2
2022-05-18 12:23:47,5.44900462962963,7,87,83,170
2022-05-16 12:17:26,3.677627314814815,9,8591,237,8828
2022-05-13 15:47:19,0.7727777777777778,1,4,0,4
2022-05-12 20:25:56,0.05115740740740741,5,8274,3296,11570
2022-06-01 10:24:20,19.735104166666666,1,1,1,2
2022-06-03 11:40:22,22.96548611111111,12,242,94,336
2022-05-12 18:25:16,0.21891203703703704,1,12,12,24
2022-05-12 15:09:25,0.11164351851851852,5,40,17,57
2022-05-23 15:50:41,11.281006944444444,16,347,134,481
2022-05-16 11:40:28,4.162673611111111,8,10,11,21
2022-05-12 07:37:14,0.03469907407407408,3,7,10,17
2022-05-12 06:51:46,0.018113425925925925,1,3,1,4
2022-05-12 14:22:00,0.5216203703703703,3,9,6,15
2022-05-12 00:28:33,0.09251157407407408,1,1,1,2
2022-05-11 19:31:41,0.012430555555555556,1,15,0,15
2022-05-11 19:58:33,0.04059027777777778,1,7,5,12
2022-05-18 17:18:43,7.037858796296296,1,3,0,3
2022-05-18 15:52:13,7.147835648148148,20,30626,7188,37814
2022-05-12 08:42:28,14.768217592592592,5,94,59,153
2022-05-11 17:17:50,0.12925925925925927,4,19,22,41
2022-05-11 17:19:08,0.18413194444444445,9,566,47,613
2022-05-12 20:31:12,1.3366666666666667,2,2,2,4
2022-05-13 14:28:00,2.2083101851851854,12,391,442,833
2022-08-25 06:34:43,105.88966435185185,8,27424,4251,31675
2022-05-11 11:16:47,0.031516203703703706,2,2,17,19
2022-05-16 20:47:28,5.48619212962963,2,3,15,18
2022-05-16 16:18:30,5.510914351851852,2,6,2,8
2022-05-23 12:02:31,12.460219907407408,12,373,299,672
2022-05-11 15:11:27,0.8383333333333334,7,152,56,208
2022-05-10 17:19:51,0.008784722222222222,1,4,0,4
2022-05-10 19:24:24,0.1697685185185185,1,1,1,2
2022-05-10 16:16:29,0.04672453703703704,1,19,13,32
2022-06-06 14:53:50,27.03929398148148,35,239,78,317
2022-05-13 20:19:30,10.068287037037036,11,38922,10349,49271
2022-05-10 14:09:35,0.1976388888888889,1,15,13,28
2022-06-01 10:38:45,22.12900462962963,1,2,2,4
2022-05-11 11:24:11,1.2518055555555556,2,8,2,10
2022-06-14 11:56:47,35.27545138888889,28,60191,8945,69136
2022-06-02 16:14:21,23.459386574074074,8,53895,8440,62335
2022-05-10 14:58:53,0.4914236111111111,2,3,3,6
2022-05-10 18:29:18,0.8655208333333333,10,123,57,180
2022-05-09 19:45:18,0.02259259259259259,1,10,9,19
2022-05-10 08:03:56,0.7159143518518518,2,40,2,42
2022-06-27 17:08:32,49.12802083333333,5,195,8,203
2022-05-17 23:07:43,0.08739583333333334,4,1300,4,1304
2022-06-08 13:41:57,48.28021990740741,37,74664,14375,89039
2022-05-09 15:10:57,4.086863425925926,4,171,10,181
2022-05-10 20:21:44,1.8956481481481482,1,144,0,144
2022-05-09 17:09:49,2.9965625,6,36,14,50
2022-05-09 11:45:43,2.1322569444444444,2,87,87,174
2022-05-31 14:36:45,24.70916666666667,2,20,6,26
2022-05-17 21:44:38,12.176111111111112,6,11,7,18
2022-05-06 14:45:17,0.20913194444444444,2,15,15,30
2022-05-11 11:50:35,5.860486111111111,2,38,28,66
2022-05-06 15:31:00,0.9341203703703703,5,254,3,257
2022-05-05 20:20:27,0.14520833333333333,1,1,1,2
2022-05-11 12:09:54,5.896400462962963,1,86,1,87
2022-05-05 14:02:47,0.0052662037037037035,1,0,52,52
2022-05-09 11:39:08,4.293738425925926,4,68,16,84
2022-05-05 13:49:55,0.6823842592592593,2,23,14,37
2022-05-05 14:12:01,0.7810763888888889,1,1,1,2
2022-05-12 10:24:35,7.879201388888889,158,26738,15670,42408
2022-05-04 16:39:31,0.11097222222222222,1,5,9,14
2022-05-04 13:42:36,0.013773148148148149,1,1,3,4
2022-05-09 11:13:07,4.936967592592593,2,48,3,51
2022-05-04 16:23:37,0.29238425925925926,2,10,4,14
2022-05-13 20:18:14,9.83576388888889,8,29015,7471,36486
2022-06-07 21:35:05,37.78811342592593,12,134116,23640,157756
2022-05-04 16:30:34,0.7238310185185185,1,30,19,49
2022-05-04 19:18:25,0.965775462962963,2,123,2,125
2022-05-09 16:29:18,6.014212962962963,32,15336,3646,18982
2022-05-05 11:21:17,1.7964814814814816,4,2696,1003,3699
2022-05-04 11:47:57,0.8352546296296296,2,5,1,6
2022-05-04 13:36:38,0.9222569444444444,2,9,10,19
2022-05-24 07:53:45,24.95605324074074,60,10060,1506,11566
2022-05-03 14:12:17,0.025347222222222222,1,1,6,7
2022-05-17 13:36:24,14.118287037037037,8,196,95,291
2022-05-03 14:31:25,0.7609027777777778,2,63,24,87
2022-06-21 12:23:36,49.709513888888885,38,52243,5887,58130
2022-05-03 13:55:10,0.8230324074074075,2,256,8,264
2022-05-02 16:47:40,0.042777777777777776,1,42,6,48
2022-05-02 16:47:47,0.09635416666666667,2,63,12,75
2022-05-04 06:40:25,1.6223032407407407,1,2,1,3
2022-05-05 11:22:46,2.849664351851852,1,28,27,55
2022-05-02 15:56:25,0.030787037037037036,2,55,11,66
2022-05-02 16:58:18,0.10020833333333333,3,13,15,28
2022-05-02 15:56:15,0.07393518518518519,3,44,82,126
2022-05-02 14:40:38,0.0734837962962963,1,57,53,110
2022-05-02 14:25:53,0.06357638888888889,1,60,60,120
2022-07-20 07:49:57,78.9534837962963,7,120277,18706,138983
2022-05-02 11:06:45,0.12328703703703704,2,2,2,4
2022-05-02 09:05:27,0.05247685185185185,1,1,1,2
2022-05-03 12:42:02,6.167465277777778,33,667,658,1325
2022-05-31 13:26:06,30.285324074074072,6,45,12,57
2022-05-09 14:36:53,9.349328703703703,8,9666,2400,12066
2022-05-02 14:28:58,2.2224537037037035,2,57,708,765
2022-05-02 09:01:18,2.1162847222222223,1,3,3,6
2022-05-12 03:04:56,11.898055555555555,40,23085,4322,27407
2022-05-02 11:49:20,2.2906828703703703,2,13,7,20
2022-05-02 11:48:21,2.3943287037037035,1,1,1,2
2022-05-11 13:04:08,11.463391203703704,9,11419,3267,14686
2022-04-29 21:42:15,0.037210648148148145,3,58,58,116
2022-04-29 21:20:53,0.026944444444444444,2,31,27,58
2022-04-30 08:40:47,0.6324305555555556,6,105,16,121
2022-04-29 16:26:45,0.016435185185185185,1,7,12,19
2022-05-04 12:08:25,5.260729166666667,23,1674,166,1840
2022-04-29 12:41:33,0.1100462962962963,1,17,17,34
2022-04-30 22:43:38,1.756724537037037,2,67,4,71
2022-04-29 12:55:39,0.769525462962963,1,53,179,232
2022-04-28 18:17:44,0.013194444444444444,1,43,40,83
2022-04-28 17:49:45,0.008506944444444444,1,1,1,2
2022-05-03 09:26:20,4.6958217592592595,23,2377,418,2795
2022-04-28 17:11:54,0.09234953703703704,1,3,1,4
2022-05-02 19:27:34,4.259791666666667,9,2991,2173,5164
2022-04-28 17:47:38,0.21376157407407406,1,24,2,26
2022-05-16 21:19:53,18.435578703703705,32,41409,11424,52833
2022-05-04 08:04:10,6.108055555555556,14,8184,2563,10747
2022-05-04 08:05:24,6.127858796296296,11,8243,2627,10870
2022-05-13 11:55:45,15.293333333333333,11,37139,10014,47153
2022-04-29 15:05:03,1.5454282407407407,1,1,1,2
2022-04-29 14:54:58,2.6722569444444444,10,264,223,487
2022-04-28 13:31:57,0.7540740740740741,2,2,2,4
2022-04-27 19:18:29,0.05204861111111111,1,3,3,6
2022-04-27 18:59:53,0.06616898148148148,2,8,8,16
2022-04-27 18:46:49,0.9281481481481482,2,211,143,354
2022-04-27 15:15:26,0.013055555555555556,1,1,1,2
2022-04-27 14:46:55,0.011423611111111112,1,1,1,2
2022-04-27 14:26:22,0.030081018518518517,2,3,2,5
2022-04-28 14:44:56,1.2078356481481483,2,18,1,19
2022-04-27 19:44:21,0.467337962962963,12,41,15,56
2022-04-27 12:51:39,0.19658564814814813,1,105,16,121
2022-05-18 14:39:02,21.729849537037037,6,18580,5026,23606
2022-04-27 16:28:42,1.0830787037037037,2,107,37,144
2022-04-27 13:00:45,0.9564930555555555,2,2,2,4
2022-05-16 12:43:25,20.047905092592593,12,141,58,199
2022-04-27 08:50:03,0.9509953703703704,1,1,0,1
2022-04-27 20:54:31,1.462037037037037,1,1,1,2
2022-04-26 00:58:50,0.30745370370370373,2,14,10,24
2022-04-26 10:54:15,0.7427662037037037,1,1,1,2
2022-04-25 17:51:50,0.04068287037037037,1,1,0,1
2022-05-16 13:32:17,20.908148148148147,18,153,59,212
2022-04-25 14:26:59,0.06997685185185185,3,14,20,34
2022-05-12 01:47:50,16.704756944444444,17,25310,5338,30648
2022-04-26 21:29:52,1.5562268518518518,1,3,2,5
2022-04-25 19:15:00,0.9098263888888889,1,12,12,24
2022-04-25 18:27:53,0.8888541666666666,2,25,10,35
2022-05-11 13:37:14,17.972048611111113,10,17784,5133,22917
2022-04-26 21:08:28,3.4282523148148147,1,2,2,4
2022-05-12 11:08:15,19.249166666666667,1,1,1,2
2022-04-25 15:31:45,2.7819791666666664,12,146,106,252
2022-04-25 18:48:08,0.924837962962963,4,34,28,62
2022-04-25 09:32:06,2.635266203703704,1,2,2,4
2022-05-10 20:39:58,18.342974537037037,20,14442,4802,19244
2022-05-03 15:06:11,11.009386574074075,1,48,42,90
2022-04-29 14:57:09,20.525497685185186,1,3,2,5
2022-04-25 19:10:51,3.31462962962963,8,226,158,384
2022-04-22 14:54:20,0.039641203703703706,3,19,16,35
2022-04-23 06:40:14,0.8942824074074074,3,15,16,31
2022-04-25 18:50:45,3.7221875,5,50,16,66
2022-05-04 14:37:58,12.606319444444445,13,343,216,559
2022-05-12 03:25:44,20.342465277777777,9,25916,5356,31272
2022-04-25 15:33:57,3.8768055555555554,5,39,22,61
2022-04-22 19:24:39,1.8638657407407409,2,10,8,18
2022-04-22 17:29:32,1.069224537037037,3,51,26,77
2022-04-21 16:12:14,0.04075231481481482,1,1,1,2
2022-04-25 19:12:51,4.212858796296296,1,3,3,6
2022-04-21 13:33:29,0.013009259259259259,1,2,1,3
2022-04-21 13:09:00,0.016875,1,9,10,19
2022-05-24 10:30:46,32.99349537037037,3,20,4,24
2022-04-22 11:38:08,1.598599537037037,5,121,99,220
2022-04-20 21:26:27,0.03243055555555555,2,87,22,109
2022-04-20 21:05:39,0.022060185185185186,1,21,11,32
2022-04-26 14:51:15,5.863159722222222,5,67,6,73
2022-04-20 18:01:24,0.03384259259259259,1,1,1,2
2022-04-22 16:19:16,1.9675347222222221,5,36,3,39
2022-04-22 08:53:25,1.0217361111111112,2,29,1,30
2022-04-21 11:00:35,0.9680208333333333,4,241,7,248
2022-04-21 16:43:46,1.254513888888889,14,295,83,378
2022-04-26 20:56:08,6.422986111111111,1,4,5,9
2022-05-02 16:30:55,19.277118055555555,30,4326,778,5104
2022-04-20 14:44:37,0.49766203703703704,3,5,0,5
2022-04-19 21:09:04,0.1507175925925926,1,1,1,2
2022-05-02 09:46:52,13.041967592592593,19,911,736,1647
2022-04-19 16:32:22,0.07762731481481482,2,13,13,26
2022-04-27 08:12:18,7.813472222222222,7,636,52,688
2022-04-19 14:12:37,0.057511574074074076,2,49,33,82
2022-04-19 14:32:26,0.1663888888888889,6,772,194,966
2022-04-20 14:11:51,1.1739699074074075,2,71,4,75
2022-04-21 12:39:11,2.1379282407407407,5,17,8,25
2022-04-19 15:27:54,0.44785879629629627,2,1,2,3
2022-04-18 22:36:46,0.057777777777777775,2,2,2,4
2022-04-19 15:13:08,0.9785995370370371,1,34,31,65
2022-04-19 11:39:04,5.899305555555555,6,29,17,46
2022-04-18 11:49:31,0.04569444444444445,1,12,1,13
2022-04-18 17:49:58,0.444375,3,25,3,28
2022-05-16 22:43:17,33.2815162037037,49,69450,29099,98549
2022-04-17 01:15:19,0.02693287037037037,3,8,8,16
2022-04-18 17:02:00,2.0181944444444446,3,4110,2187,6297
2022-04-19 07:02:19,3.7228935185185184,1,2,14,16
2022-04-18 13:25:08,3.1539814814814813,5,145,241,386
2022-04-15 12:10:16,0.15891203703703705,1,5,15,20
2022-06-13 20:36:58,60.96420138888889,72,31724,8342,40066
2022-04-18 08:47:38,3.685925925925926,3,48,29,77
2022-04-19 07:07:29,4.657384259259259,5,890,83,973
2022-04-18 11:47:21,3.8537037037037036,3,69,62,131
2022-04-27 06:34:22,12.702650462962962,3,52,14,66
2022-04-14 13:41:02,0.009664351851851851,1,1,0,1
2022-09-27 11:12:56,165.9467361111111,15,362,84,446
2022-04-21 13:55:30,7.094212962962963,5,7,4,11
2022-04-21 07:59:26,6.8802662037037035,3,38,23,61
2022-04-22 16:07:16,22.034791666666667,23,16513,4452,20965
2022-04-18 20:43:21,4.942048611111111,7,281,275,556
2022-04-19 12:44:09,5.644606481481482,4,4492,924,5416
2022-04-14 20:42:28,0.9835069444444444,1,2,2,4
2022-04-15 04:37:10,1.3919097222222223,1,4,2,6
2022-04-13 18:40:48,0.04640046296296296,5,93,72,165
2022-04-14 13:22:54,0.8385300925925926,2,2,2,4
2022-04-14 09:52:15,0.7045486111111111,3,33,10,43
2022-04-18 15:52:13,4.996053240740741,29,12448,8128,20576
2022-04-19 13:51:51,6.103923611111111,9,16963,3513,20476
2022-04-13 16:28:02,0.007280092592592592,1,6,0,6
2022-06-01 11:15:39,48.803900462962964,10,60290,15428,75718
2022-04-14 14:02:30,0.9248842592592592,1,5,0,5
2022-04-13 15:19:14,0.04736111111111111,3,4,14,18
2022-04-14 18:02:40,1.2070486111111112,1,1,1,2
2022-04-13 15:19:52,0.2530439814814815,2,6,3,9
2022-04-13 15:03:20,0.5071180555555556,1,7,6,13
2022-04-15 00:24:38,1.917175925925926,7,45,14,59
2022-04-13 16:03:24,0.7814930555555556,6,2645,1245,3890
2022-06-29 10:03:17,77.6250925925926,3,8,8,16
2022-04-12 16:37:13,0.041400462962962965,1,0,3,3
2022-04-19 19:13:28,7.152638888888889,4,260,607,867
2022-04-12 16:25:02,0.07526620370370371,2,13,3,16
2022-04-12 16:51:48,0.10261574074074074,2,19,31,50
2022-04-12 17:33:57,0.20265046296296296,2,14,4,18
2022-04-19 14:32:08,7.182696759259259,8,678,90,768
2022-04-12 17:48:25,0.27969907407407407,3,24,17,41
2022-04-18 14:50:13,6.150173611111111,3,32,16,48
2022-04-12 08:19:49,0.03297453703703704,1,1,1,2
2022-04-12 15:47:01,0.47903935185185187,12,441,385,826
2022-04-14 13:51:55,2.539178240740741,4,3226,1139,4365
2022-04-18 09:58:24,7.890543981481481,9,226,127,353
2022-04-13 15:28:20,1.8986226851851853,3,23,9,32
2022-04-11 17:37:16,0.0738425925925926,2,7,3,10
2022-04-13 11:50:15,1.8166782407407407,1,29,22,51
2022-04-12 19:46:11,1.1592361111111111,1,44,10,54
2022-04-11 16:42:45,0.054560185185185184,5,74,21,95
2022-04-11 16:02:11,0.1466087962962963,1,8,6,14
2022-04-11 16:19:28,0.23278935185185184,1,3,2,5
2022-04-11 20:16:20,0.4665856481481481,2,22,12,34
2022-04-11 16:21:45,0.3575115740740741,1,1,1,2
2022-04-11 16:22:28,0.3717013888888889,1,11,0,11
2022-04-11 11:32:07,1.4584606481481481,1,1,1,2
2022-05-12 04:35:08,32.30443287037037,11,37612,9512,47124
2022-05-04 13:35:12,25.085763888888888,5,24163,7881,32044
2022-04-11 16:23:35,2.3538425925925925,10,207,237,444
2022-04-13 20:39:00,5.065243055555555,4,4549,2332,6881
2022-04-08 19:35:39,0.09163194444444445,2,5,3,8
2022-04-08 17:42:05,0.07305555555555555,1,1,1,2
2022-04-11 20:25:16,3.2355324074074074,5,102,182,284
2022-04-11 10:55:30,2.8397685185185186,2,19,4,23
2022-04-12 11:55:44,3.9084606481481483,1,4,3,7
2022-04-11 09:20:03,2.8033680555555556,10,50,37,87
2022-04-14 07:06:15,5.839166666666666,3,85,40,125
2022-04-08 11:58:02,0.04369212962962963,1,2,2,4
2022-04-13 11:49:06,5.457349537037037,6,164,52,216
2022-05-24 13:31:10,48.761006944444446,42,75882,20201,96083
2022-04-15 01:10:05,7.136678240740741,17,9163,3014,12177
2022-04-08 14:03:56,0.8875115740740741,9,915,523,1438
2022-05-11 21:56:48,34.26365740740741,3,6875,1332,8207
2022-04-07 15:05:11,0.007743055555555556,1,0,85,85
2022-04-12 12:55:12,4.9535532407407405,1,1,1,2
2022-04-08 13:31:43,1.0444444444444445,3,11,5,16
2022-04-13 09:36:55,5.981041666666667,7,9134,1825,10959
2022-04-11 12:59:35,4.214340277777778,1,7,8,15
2022-04-07 18:48:04,0.5156828703703704,7,29,28,57
2022-04-07 14:56:34,0.6611111111111111,1,4,0,4
2022-04-08 11:31:38,1.6989467592592593,2,33,53,86
2022-05-04 12:27:28,27.705277777777777,1,1,1,2
2022-05-04 12:27:40,27.712002314814814,1,1,1,2
2022-04-08 20:55:43,2.0887037037037035,3,146,83,229
2022-04-06 16:35:43,0.0637962962962963,1,6,6,12
2022-04-06 18:21:15,0.18296296296296297,1,7,1,8
2022-04-11 09:06:10,4.989224537037037,14,11034,1689,12723
2022-04-06 09:27:11,0.04950231481481481,1,2,2,4
2022-04-12 16:38:51,6.409837962962963,10,438,515,953
2022-04-19 13:38:25,13.313680555555555,1,0,4,4
2022-04-06 11:28:18,0.3487152777777778,1,1,1,2
2022-04-06 18:12:01,0.8435763888888889,16,354,352,706
2022-04-06 19:29:32,0.9481597222222222,8,739,106,845
2022-04-07 19:06:50,1.9619560185185185,3,3,3,6
2022-04-06 07:51:58,0.6266782407407407,1,1,1,2
2022-04-06 12:19:00,0.8275810185185185,3,697,92,789
2022-04-06 10:15:09,0.8102083333333333,3,27,7,34
2022-04-06 09:32:40,0.8630324074074074,5,44,29,73
2022-04-06 09:43:02,0.9643634259259259,1,0,1,1
2022-04-05 12:15:02,0.21216435185185184,3,17,30,47
2022-04-05 15:13:12,0.3957523148148148,2,24162,12462,36624
2022-04-05 20:55:01,0.9325694444444445,5,48,48,96
2022-04-12 15:13:59,7.763460648148148,5,69,11,80
2022-04-05 08:00:04,0.5345138888888888,1,1,1,2
2022-04-06 13:42:15,1.8969212962962962,1,3,2,5
2022-04-06 13:33:32,1.9420717592592593,1,10,17,27
2022-04-04 15:50:56,0.03554398148148148,1,1,1,2
2022-04-14 16:10:52,10.058599537037036,7,143,96,239
2022-04-04 11:53:54,0.017777777777777778,2,7,7,14
2022-04-05 10:26:04,0.9780902777777778,1,2,1,3
2022-05-09 15:28:53,1.1005208333333334,14,3884,796,4680
2022-04-13 13:44:32,9.442847222222222,17,8293,2318,10611
2022-04-12 16:52:31,9.613414351851851,9,155,50,205
2022-04-11 20:19:12,13.151840277777778,27,451,901,1352
2022-04-04 12:54:26,2.7957060185185183,1,1,1,2
2022-04-05 13:50:46,15.879525462962963,16,41786,23278,65064
2022-04-05 08:50:22,3.745509259259259,5,1360,750,2110
2022-04-05 09:56:36,3.8230208333333335,1,3,3,6
2022-04-01 14:39:28,0.04717592592592593,3,7,8,15
2022-04-01 14:02:58,0.0431712962962963,1,92,92,184
2022-08-24 09:51:05,145.0302662037037,40,180624,33564,214188
2022-04-04 14:57:24,3.1776851851851853,2,53,0,53
2022-04-01 15:53:19,0.22554398148148147,2,2,2,4
2022-04-01 12:50:47,0.21814814814814815,1,1,0,1
2022-04-01 07:17:31,0.1590162037037037,1,1,1,2
2022-04-04 16:20:26,3.6906712962962964,2,10,6,16
2022-04-01 13:27:41,0.6070601851851852,1,50,48,98
2022-04-05 17:48:42,4.805347222222222,35,1871,989,2860
2022-04-11 14:45:21,10.817488425925927,2,16,8,24
2022-04-04 14:06:57,3.8358333333333334,4,62,13,75
2022-04-11 13:51:28,10.940486111111111,14,11278,1895,13173
2022-04-04 14:27:45,3.9776273148148147,2,544,92,636
2022-03-31 19:26:51,0.20569444444444446,2,3,3,6
2022-04-04 14:25:46,4.002453703703703,5,464,423,887
2022-04-01 14:53:08,1.0317013888888888,3,63,58,121
2022-03-31 12:45:47,0.028449074074074075,1,1,1,2
2022-03-31 11:49:03,0.28565972222222225,1,1,1,2
2022-04-13 13:04:47,13.422893518518519,11,19122,6734,25856
2022-04-19 16:58:09,19.65858796296296,3,41,39,80
2022-04-19 13:37:03,19.56515046296296,5,3276,1525,4801
2022-03-30 19:33:16,0.06234953703703704,2,154,77,231
2022-03-31 12:43:04,0.7972222222222223,3,30,30,60
2022-04-04 15:37:33,5.049444444444444,14,1735,1300,3035
2022-04-01 08:52:42,6.342152777777778,5,2936,795,3731
2022-03-30 21:12:29,0.22821759259259258,1,3,3,6
2022-04-01 15:54:01,2.0284837962962965,1,63,0,63
2022-03-30 15:41:04,0.03608796296296296,1,10,2,12
2022-03-30 15:56:04,0.07799768518518518,1,12,1,13
2022-03-30 16:12:28,0.07369212962962964,4,470,937,1407
2022-03-31 11:39:47,1.1790740740740742,2,50,50,100
2022-03-30 13:03:55,0.5500115740740741,3,82,144,226
2022-03-29 23:07:32,0.05246527777777778,2,17,5,22
2022-04-05 17:05:28,6.8606134259259255,1,3,1,4
2022-03-29 20:12:27,0.04292824074074074,2,4,2,6
2022-03-30 14:06:32,0.7900578703703703,1,1,1,2
2022-03-29 16:21:19,0.0078009259259259256,1,4,4,8
2022-03-29 16:57:16,0.09229166666666666,3,52,4,56
2022-03-29 14:38:15,0.19953703703703704,2,11,5,16
2022-04-08 08:57:51,58.451574074074074,33,5558,709,6267
2022-03-29 09:32:14,0.0008333333333333334,1,3,3,6
2022-03-29 16:57:43,0.5324884259259259,1,1,1,2
2022-03-29 16:55:40,0.5821412037037037,1,2,2,4
2022-03-29 17:17:47,0.7978703703703703,2,21,9,30
2022-04-07 14:02:43,9.771921296296297,6,173,93,266
2022-03-29 15:34:30,0.8474537037037037,2,2,4,6
2022-03-29 16:04:20,1.2922222222222222,9,19,14,33
2022-03-29 19:00:18,1.1980902777777778,16,191,154,345
2022-04-01 15:19:36,4.050821759259259,1,23,5,28
2022-03-28 14:37:56,0.03966435185185185,1,0,1,1
2022-04-07 08:48:25,9.853842592592592,2,4,3,7
2022-04-04 12:26:24,7.052314814814815,1,11,6,17
2022-04-29 15:44:29,32.19633101851852,1,12,7,19
2022-03-28 12:14:10,0.1268287037037037,2,18,11,29
2022-05-17 16:32:12,51.00445601851852,12,68681,22460,91141
2022-04-12 10:11:04,15.385127314814815,10,2929,750,3679
2022-04-01 14:21:26,11.900821759259259,14,40682,22839,63521
2022-04-11 09:24:33,36.47666666666667,20,599,498,1097
2022-04-12 18:46:07,17.11371527777778,3,20136,5993,26129
2022-03-28 10:00:53,1.923136574074074,1,1,1,2
2022-03-28 09:56:55,1.9741666666666666,3,33,36,69
2022-03-29 17:24:25,3.466099537037037,1,66,66,132
2022-03-27 17:09:16,1.8983564814814815,1,63,122,185
2022-03-28 11:45:18,20.793553240740742,5,16,567,583
2022-03-25 15:47:06,0.030555555555555555,1,1,1,2
2022-03-25 16:46:53,0.07181712962962963,1,3,3,6
2022-03-25 13:07:43,0.0337037037037037,1,1,1,2
2022-03-28 12:06:48,3.0105439814814816,1,9,1,10
2022-06-07 22:33:07,81.68174768518519,93,292046,90049,382095
2022-03-29 17:02:46,4.764803240740741,6,3851,1739,5590
2022-03-29 14:19:06,5.494664351851852,18,80,43,123
2022-03-25 13:12:23,0.7586226851851852,1,90,90,180
2022-03-25 11:25:21,0.7019791666666667,2,443,441,884
2022-03-28 09:47:53,3.654189814814815,2,18,18,36
2022-03-24 15:59:09,0.010844907407407407,4,51,35,86
2022-03-24 15:47:49,0.00494212962962963,1,1,1,2
2022-03-24 19:14:35,6.125925925925926,8,27890,17267,45157
2022-03-24 15:08:31,0.024363425925925927,1,1,1,2
2022-03-24 16:13:09,0.11268518518518518,3,68,164,232
2022-03-24 13:23:54,0.6011574074074074,2,122,117,239
2022-03-24 13:19:40,0.6017824074074074,5,260,343,603
2022-03-28 09:43:39,4.50787037037037,1,31,31,62
2022-04-06 17:19:34,28.051087962962963,27,1200,460,1660
2022-03-30 20:28:36,7.0277314814814815,9,38,56,94
2022-03-24 09:26:28,0.5894444444444444,7,103,44,147
2022-03-25 19:51:44,2.061053240740741,5,5069,2344,7413
2022-03-23 18:50:09,0.06913194444444444,3,4,4,8
2022-03-23 23:17:00,0.2927430555555556,6,219,154,373
2022-03-23 19:56:49,0.17775462962962962,8,435,216,651
2022-03-25 10:35:49,2.028738425925926,1,1,0,1
2022-03-23 15:11:34,0.36811342592592594,11,10280,9893,20173
2022-03-23 14:56:12,0.7746296296296297,2,5,5,10
2022-03-25 15:59:25,2.9540509259259258,21,19025,13534,32559
2022-03-31 07:32:33,8.601828703703704,22,3510,1293,4803
2022-03-23 21:46:11,1.3454629629629629,4,10,3,13
2022-03-23 18:41:18,1.2441782407407407,11,154,83,237
2022-06-01 15:15:53,71.14605324074074,1,1,1,2
2022-03-31 11:43:32,9.01951388888889,10,230,55,285
2022-03-23 12:25:30,1.040474537037037,5,340,305,645
2022-03-23 07:46:59,0.8998611111111111,4,407,408,815
2022-03-29 19:35:25,7.976736111111111,7,107,211,318
2022-03-24 12:43:52,2.6995138888888888,2,2,2,4
2022-05-26 11:28:15,76.89726851851852,29,125037,40507,165544
2022-04-01 13:50:22,11.00849537037037,6,22889,12183,35072
2022-03-23 15:14:55,2.937962962962963,9,2364,1804,4168
2022-03-24 13:45:30,4.0036805555555555,5,143,55,198
2022-03-23 20:36:12,4.022592592592592,4,102,6,108
2022-03-29 15:51:49,9.181365740740741,10,28,16,44
2022-03-23 14:26:33,4.743912037037037,11,4833,4677,9510
2022-03-23 15:15:59,4.805578703703704,1,33,33,66
2022-03-29 17:24:15,17.94826388888889,65,54362,24789,79151
2022-03-31 11:44:48,13.857534722222223,12,313,69,382
2022-04-07 19:58:00,23.015983796296297,51,2443,721,3164
2022-04-19 10:14:51,34.10542824074074,3,75,21,96
2022-05-13 20:18:46,58.713229166666665,27,91668,31768,123436
2022-03-31 11:45:18,15.772395833333333,5,146,14,160
2022-04-07 21:35:17,23.264606481481483,1,5,2,7
2022-03-28 14:31:19,13.823333333333334,16,154,15,169
2022-04-19 12:19:55,35.885868055555555,35,32770,10368,43138
2022-03-28 09:38:17,15.101435185185185,5,27353,16436,43789
2022-03-25 16:49:37,13.956956018518518,1,2,2,4
2022-03-23 23:07:34,13.919456018518519,7,20,13,33
2022-06-01 11:30:58,84.3510300925926,2,18,9,27
2022-04-05 13:23:27,27.86460648148148,39,498,397,895
2022-03-28 14:28:10,33.93247685185185,55,4376,1813,6189
2022-03-30 16:46:51,23.29366898148148,30,495,360,855
2022-03-28 09:19:12,24.26193287037037,1,5,4,9
2022-04-21 12:07:54,49.70806712962963,5,8,5,13
2022-03-24 10:00:46,21.737222222222222,5,35,9,44
2022-03-25 16:04:44,24.023252314814815,14,38377,20333,58710
2022-03-24 19:44:15,0.05545138888888889,1,9,9,18
2022-03-23 20:18:43,27.401481481481483,128,56613,24429,81042
2022-04-18 15:34:36,52.99429398148148,1,7,2,9
2022-11-02 19:45:39,253.06681712962964,29,364634,68367,433001
2022-05-16 11:36:42,117.54623842592592,26,24431,8399,32830
2022-03-25 19:27:19,43.92123842592593,38,69087,26310,95397
2022-04-19 20:01:29,75.34582175925927,18,101332,33992,135324
2022-04-20 08:26:51,44.940243055555555,15,73089,29247,102336
2022-04-26 08:07:52,83.87449074074074,4,13,13,26
2022-03-28 09:00:29,64.78175925925926,4,36,24,60
2022-04-05 17:27:29,99.6625462962963,13,151832,55157,206989
2022-05-10 15:22:43,300.46181712962965,31,397065,128240,525305
2022-04-13 08:37:33,398.23466435185185,14,115,59,174
2022-03-22 20:57:19,0.015983796296296298,1,2,2,4
2022-03-22 20:55:22,0.07905092592592593,1,2,1,3
2022-03-22 21:14:58,0.14504629629629628,4,4747,2188,6935
2022-03-22 17:06:17,0.008958333333333334,1,1,1,2
2022-03-22 20:07:48,0.13447916666666668,6,550,536,1086
2022-03-22 14:45:30,0.10436342592592593,3,4,3,7
2022-03-22 13:17:56,0.19561342592592593,1,33,33,66
2022-03-22 13:52:29,0.31381944444444443,2,254,219,473
2022-03-21 19:13:58,0.05261574074074074,1,135,135,270
2022-03-21 19:28:23,0.0647800925925926,1,1,1,2
2022-03-22 10:45:50,0.7308449074074074,3,73,5,78
2022-03-21 16:38:52,0.07114583333333334,1,7,2,9
2022-03-21 16:23:40,0.06659722222222222,1,2,1,3
2022-03-21 17:07:56,0.14378472222222222,1,1,1,2
2022-03-21 14:05:47,0.05309027777777778,1,0,2,2
2022-03-21 17:48:07,0.21783564814814815,4,1643,1120,2763
2022-03-21 15:59:47,0.1597337962962963,1,4,4,8
2022-03-21 12:10:24,0.01954861111111111,1,1,1,2
2022-03-21 12:07:29,0.01832175925925926,1,1,1,2
2022-03-21 16:34:10,0.3283333333333333,3,46,52,98
2022-03-21 14:26:44,0.25655092592592593,2,9,6,15
2022-03-21 20:46:32,1.4455555555555555,5,372,346,718
2022-03-22 13:55:58,2.8825694444444445,1,68,68,136
2022-03-21 15:18:01,2.106122685185185,5,502,481,983
2022-03-21 15:04:14,2.374108796296296,2,23,21,44
2022-03-21 11:39:45,2.38068287037037,1,1,1,2
2022-03-21 16:11:03,2.935162037037037,6,81,80,161
2022-03-21 19:55:41,3.113136574074074,1,4,8,12
2022-03-19 10:44:18,0.7403935185185185,1,2,5,7
2022-03-18 17:57:55,0.044756944444444446,1,65,115,180
2022-03-21 16:17:52,3.0032060185185183,3,51,50,101
2022-03-18 15:45:39,0.05929398148148148,1,2,10,12
2022-03-21 10:33:19,4.757256944444444,33,2477,2078,4555
2022-03-18 17:51:25,0.2607291666666667,3,230,87,317
2022-03-18 14:07:03,0.26524305555555555,3,105,236,341
2022-03-18 16:04:43,0.41202546296296294,1,2,5,7
2022-03-21 17:09:03,3.7175231481481483,1,73,73,146
2022-03-21 16:37:18,3.7610995370370373,2,63,10,73
2022-03-18 15:33:24,0.724224537037037,2,83,155,238
2022-03-21 18:34:00,3.8909606481481482,3,71,39,110
2022-03-21 08:29:05,3.5402893518518517,3,28,11,39
2022-03-17 20:33:55,0.040729166666666664,1,5,3,8
2022-03-21 11:44:03,3.690289351851852,3,30,15,45
2022-03-17 19:05:14,0.014270833333333333,3,12,4,16
2022-03-17 18:39:17,0.09206018518518519,1,2,2,4
2022-03-21 22:56:17,9.100231481481481,7,11301,7271,18572
2022-03-17 15:05:38,0.10555555555555556,1,1,1,2
2022-03-17 18:23:40,0.8108449074074074,2,123,222,345
2022-03-17 13:03:08,0.041886574074074076,2,5,3,8
2022-03-18 09:02:12,0.9019212962962962,3,25,9,34
2022-03-17 16:51:43,0.25579861111111113,1,9,10,19
2022-03-17 12:11:55,0.09983796296296296,1,11,9,20
2022-03-17 09:53:57,0.06827546296296297,2,4,4,8
2022-03-17 11:47:01,0.2247800925925926,1,0,6,6
2022-03-21 11:37:45,4.302557870370371,4,178,109,287
2022-03-21 13:04:18,4.490162037037037,3,196,194,390
2022-03-17 12:33:02,0.5945370370370371,2,71,156,227
2022-03-17 11:42:58,0.6902893518518518,1,12,3,15
2022-03-17 11:21:20,0.7450231481481482,1,2,2,4
2022-03-16 17:49:24,0.054953703703703706,2,5,2,7
2022-03-16 15:44:34,0.03318287037037037,1,51,0,51
2022-03-17 09:25:09,0.7903356481481482,2,32,30,62
2022-03-22 14:46:00,6.022071759259259,9,120,128,248
2022-03-22 07:51:13,22.494965277777776,21,2367,403,2770
2022-03-16 15:24:01,0.061203703703703705,5,194,143,337
2022-03-16 14:59:56,0.05113425925925926,3,21,27,48
2022-03-16 14:03:59,0.026979166666666665,1,119,219,338
2022-03-16 13:23:00,0.04840277777777778,6,33,31,64
2022-03-16 12:37:08,0.021909722222222223,1,117,221,338
2022-03-16 15:19:38,0.21585648148148148,1,1,1,2
2022-03-16 00:21:31,0.008449074074074074,1,81,29,110
2022-03-18 21:16:17,2.937384259259259,2,40,40,80
2022-03-16 14:01:33,0.6852546296296296,2,17,54,71
2022-03-18 21:48:28,3.016226851851852,1,21,21,42
2022-03-16 10:37:48,0.6182523148148148,1,126,260,386
2022-03-15 17:59:59,0.03540509259259259,2,284,542,826
2022-03-15 17:56:58,0.037349537037037035,1,63,63,126
2022-03-15 15:26:52,0.019814814814814816,1,4,0,4
2022-03-17 10:45:50,1.8533333333333333,1,2,1,3
2022-03-15 18:06:47,0.30400462962962965,9,100,51,151
2022-03-15 14:00:19,0.0568287037037037,3,60,114,174
2022-03-18 16:05:27,3.206076388888889,3,5,2,7
2022-03-15 14:04:32,0.1827199074074074,1,44,43,87
2022-03-15 12:07:35,0.5843865740740741,2,352,28,380
2022-03-15 12:05:34,0.6419675925925926,2,10,1,11
2022-03-15 10:07:17,0.5611111111111111,1,3,3,6
2022-03-18 11:52:55,3.6658449074074073,2,5,4,9
2022-03-15 13:46:00,0.7540972222222222,1,122,220,342
2022-03-16 20:27:54,2.0530092592592593,5,329,244,573
2022-03-15 17:50:30,0.9426736111111111,1,108,257,365
2022-03-14 18:09:19,0.033541666666666664,1,74,204,278
2022-03-15 16:53:26,0.9644560185185185,1,94,268,362
2022-03-15 16:52:56,0.9761111111111112,1,72,158,230
2022-03-14 18:10:07,0.036550925925925924,1,81,216,297
2022-03-15 12:07:56,0.8290046296296296,3,41,301,342
2022-03-14 16:37:20,0.043784722222222225,2,7,4,11
2022-03-17 09:49:25,107.59724537037037,5,551,453,1004
2022-03-14 17:26:24,0.09667824074074075,1,10,1,11
2022-03-14 13:37:07,0.02883101851851852,1,2,2,4
2022-03-17 19:05:28,3.385335648148148,2,11,10,21
2022-03-15 11:08:54,1.0645949074074075,1,1,1,2
2022-03-17 20:39:57,3.513611111111111,2,7,3,10
2022-03-14 15:25:45,0.6465162037037037,2,76,161,237
2022-03-14 15:26:41,0.6779398148148148,4,96,215,311
2022-03-14 19:26:12,0.8512847222222222,4,113,112,225
2022-03-14 16:21:08,0.7227662037037037,3,69,68,137
2022-03-14 11:15:38,0.5936342592592593,1,2,0,2
2022-03-14 17:11:19,1.034826388888889,1,59,59,118
2022-03-14 16:14:04,1.2737962962962963,1,12,7,19
2022-03-14 14:05:14,1.1912962962962963,1,10,10,20
2022-03-15 16:57:45,2.3295601851851853,3,58,56,114
2022-03-18 08:46:45,5.595370370370371,3,60,20,80
2022-03-21 11:54:54,8.18056712962963,4,89220,89220,178440
2022-03-15 13:47:45,2.2877430555555556,3,259,662,921
2022-03-14 15:55:04,1.4499074074074074,3,87,87,174
2022-03-14 13:15:08,1.3033101851851852,3,93,241,334
2022-03-12 19:28:49,0.05590277777777778,1,103,103,206
2022-03-14 15:39:59,1.9561458333333333,2,64,61,125
2022-03-14 16:56:04,2.089710648148148,3,80,75,155
2022-03-14 15:12:23,2.010127314814815,1,104,102,206
2022-03-14 16:28:35,2.0766319444444443,2,105,103,208
2022-03-14 14:53:57,2.0249537037037038,1,97,97,194
2022-03-12 15:05:14,0.0661111111111111,1,24,67,91
2022-03-12 12:37:10,0.11811342592592593,1,25,18,43
2022-03-12 12:30:43,0.1695949074074074,1,122,220,342
2022-03-12 12:06:56,0.5574305555555555,1,124,222,346
2022-03-11 23:13:11,0.02474537037037037,2,3,2,5
2022-03-16 14:54:51,4.718854166666667,6,120,97,217
2022-03-13 18:54:02,2.0054398148148147,3,108,106,214
2022-03-11 19:16:14,0.02349537037037037,1,72,72,144
2022-03-15 12:17:52,3.738773148148148,2,5,5,10
2022-03-11 19:40:50,0.06814814814814815,2,115,115,230
2022-03-11 20:21:31,0.10282407407407407,1,1,1,2
2022-03-14 15:19:18,2.9078935185185184,5,6,6,12
2022-03-14 13:02:42,2.8222800925925924,1,5,0,5
2022-03-11 19:35:48,0.09513888888888888,2,9,1,10
2022-03-14 07:50:36,2.637824074074074,1,4,2,6
2022-03-16 09:08:56,4.699293981481482,3,31,37,68
2022-03-11 17:04:18,0.032581018518518516,1,0,1,1
2022-03-15 12:35:02,3.878726851851852,4,6463,3087,9550
2022-03-11 16:13:29,0.07732638888888889,2,206,203,409
2022-03-14 07:40:43,2.743240740740741,3,31,1,32
2022-03-11 14:03:28,0.011863425925925927,1,8,8,16
2022-03-15 08:59:48,3.9005555555555556,2,96,8,104
2022-03-11 13:27:59,0.1453472222222222,2,8,11,19
2022-03-11 17:00:11,0.48346064814814815,1,6,3,9
2022-03-10 21:21:56,0.02701388888888889,1,1,1,2
2022-03-11 12:58:03,0.6726504629629629,1,107,123,230
2022-03-11 10:22:36,0.5894791666666667,1,1,1,2
2022-03-11 16:13:48,0.9134027777777778,2,91,91,182
2022-03-14 09:12:29,3.6547685185185186,2,112,6,118
2022-03-14 14:12:38,4.011423611111111,8,745,378,1123
2022-03-10 19:19:46,0.26359953703703703,8,56,45,101
2022-03-10 14:01:05,0.10815972222222223,2,37,21,58
2022-03-10 11:09:05,0.007673611111111111,1,1,1,2
2022-03-10 11:09:29,0.032268518518518516,2,6,10,16
2022-03-10 10:35:27,0.4426273148148148,1,2,2,4
2022-03-10 11:23:46,0.6175925925925926,1,4,4,8
2022-03-15 14:13:34,5.775138888888889,4,458,125,583
2022-03-10 12:44:51,0.7227199074074074,1,10,4,14
2022-03-15 07:47:12,5.708078703703704,33,5547,3098,8645
2022-03-09 22:27:15,0.23901620370370372,1,1,1,2
2022-03-10 13:58:05,0.9256712962962963,2,27,17,44
2022-03-10 12:44:29,0.8615856481481482,14,85,73,158
2022-03-14 15:47:29,5.053356481481481,2,60,27,87
2022-03-15 09:15:03,5.808171296296297,1,3,1,4
2022-03-09 13:25:35,0.04146990740740741,1,30,30,60
2022-03-09 14:51:56,0.1786111111111111,1,7,8,15
2022-03-09 13:21:24,0.13820601851851852,2,0,8,8
2022-03-09 13:39:04,0.18524305555555556,2,38,38,76
2022-03-11 19:05:44,2.949097222222222,3,122,29,151
2022-03-10 08:59:20,1.6455671296296297,2,97,8,105
2022-03-09 18:53:01,5.019189814814815,10,849,310,1159
2022-03-09 16:16:26,1.0791435185185185,4,19,8,27
2022-03-10 10:54:46,1.8819097222222223,14,2107,1343,3450
2022-03-09 19:30:38,5.131759259259259,15,400,260,660
2022-03-16 17:38:25,9.136793981481482,25,655,456,1111
2022-03-15 23:21:06,7.453738425925926,11,1891,152,2043
2022-03-10 10:34:44,2.7307638888888888,19,406,39,445
2022-03-08 13:03:03,0.11994212962962963,1,3,0,3
2022-03-08 12:37:20,0.9554282407407407,5,10,7,17
2022-03-09 14:48:53,1.767048611111111,1,1,1,2
2022-03-09 12:09:56,1.8459953703703704,25,112,132,244
2022-03-09 16:07:52,2.103946759259259,1,3,2,5
2022-03-07 13:58:44,0.10592592592592592,1,0,8,8
2022-03-08 11:18:38,1.1545023148148148,1,1,1,2
2022-03-08 18:45:41,1.5038194444444444,6,163,88,251
2022-03-07 18:10:33,1.2419675925925926,4,31,31,62
2022-03-07 21:14:33,2.1935532407407408,2,4,1,5
2022-03-07 15:22:48,2.0057638888888887,2,3,2,5
2022-03-08 09:49:45,3.0307060185185186,2,13,4,17
2022-03-08 14:46:44,4.875231481481482,10,1535,893,2428
2022-03-04 18:11:48,0.03476851851851852,1,21,13,34
2022-03-04 17:53:54,0.029895833333333333,1,1,2,3
2022-03-18 12:30:08,13.85954861111111,6,236,141,377
2022-03-08 09:49:30,3.8356481481481484,2,68,71,139
2022-03-07 17:10:16,3.188888888888889,3,54,26,80
2022-03-09 09:19:05,4.9196875,4,29,17,46
2022-03-08 10:17:57,3.9899537037037036,2,22,4,26
2022-03-04 12:56:15,0.8524421296296296,1,42,0,42
2022-03-07 19:29:14,3.818287037037037,4,351,22,373
2022-03-04 17:04:19,0.8950694444444445,4,81,29,110
2022-03-03 19:41:03,0.036458333333333336,1,8,0,8
2022-03-03 23:22:38,0.2274537037037037,1,13,1,14
2022-03-04 08:53:00,0.6659490740740741,1,2,1,3
2022-03-08 12:19:41,4.868564814814815,1,1,0,1
2022-03-09 13:47:59,5.932627314814815,2,1,40,41
2022-03-07 17:17:45,4.110196759259259,1,13,104,117
2022-03-04 16:50:24,1.1087268518518518,2,0,42,42
2022-03-03 15:31:41,0.05440972222222222,2,47,3,50
2022-03-03 18:35:48,0.18405092592592592,2,230,121,351
2022-03-04 10:57:10,0.9146643518518518,4,52,40,92
2022-03-03 15:01:56,0.09552083333333333,4,152,111,263
2022-03-10 11:00:30,6.965092592592592,3,160,307,467
2022-03-10 13:31:35,7.681157407407407,10,471,1004,1475
2022-03-03 12:43:13,0.11302083333333333,1,1,1,2
2022-03-03 18:46:31,0.441400462962963,3,52,18,70
2022-03-02 23:06:31,0.01070601851851852,1,2,2,4
2022-03-04 13:36:28,1.9223842592592593,12,346,29,375
2022-03-03 12:21:31,0.8506481481481482,3,5,2,7
2022-03-02 20:57:39,0.20552083333333335,2,16,4,20
2022-03-04 11:32:20,1.839537037037037,1,21,21,42
2022-03-02 16:55:49,0.06653935185185185,2,2,3,5
2022-03-02 21:18:54,0.2490625,21,120,107,227
2022-03-03 14:33:49,0.9753703703703703,1,12,13,25
2022-03-02 15:20:47,0.03940972222222222,3,13,8,21
2022-03-02 15:02:27,0.19052083333333333,1,1,1,2
2022-03-02 14:37:05,0.2396875,1,1,1,2
2022-03-02 03:36:19,0.00818287037037037,1,0,1,1
2022-03-02 03:27:28,0.0880787037037037,3,18,12,30
2022-03-02 09:24:33,0.43938657407407405,2,287,75,362
2022-03-02 12:55:14,8.517777777777777,5,16,12,28
2022-03-01 17:37:58,0.025532407407407406,1,2,2,4
2022-03-03 13:17:13,1.8576388888888888,3,54,2,56
2022-03-01 16:47:17,0.006053240740740741,1,2,2,4
2022-03-02 10:38:14,0.7614236111111111,1,24,61,85
2022-03-08 13:16:34,6.919375,1,89,50,139
2022-03-01 17:26:30,0.8884143518518518,13,15,11,26
2022-03-02 09:49:05,1.0110069444444445,3,72,35,107
2022-03-01 13:55:11,0.6852314814814815,3,102,8,110
2022-02-28 19:17:44,0.09640046296296297,2,12,8,20
2022-03-01 14:12:58,0.9054166666666666,1,46,132,178
2022-03-01 16:03:05,0.9998611111111111,10,311,112,423
2022-03-02 09:48:12,1.8462731481481482,3,61,3,64
2022-03-01 17:09:53,1.1575578703703704,2,130,25,155
2022-03-01 10:26:20,1.0017708333333333,2,26,2,28
2022-02-28 10:23:13,0.03961805555555555,1,4,4,8
2022-02-28 20:46:47,0.485787037037037,1,2,3,5
2022-02-28 20:00:21,0.5052083333333334,6,128,131,259
2022-03-18 17:15:36,19.21790509259259,14,390,315,705
2022-03-14 12:31:32,15.812800925925925,19,903,752,1655
2022-03-01 21:10:31,4.1558217592592595,2,97,38,135
2022-03-04 16:04:43,6.9607523148148145,1,3,1,4
2022-02-25 16:28:16,0.06802083333333334,1,0,4,4
2022-03-10 18:41:56,13.219074074074074,19,521,198,719
2022-02-25 16:46:38,0.2755324074074074,3,99,38,137
2022-02-25 08:21:29,0.021655092592592594,1,2,2,4
2022-02-25 17:00:00,0.7970833333333334,1,53,16,69
2022-02-25 14:54:45,0.8364351851851852,1,4,4,8
2022-02-24 18:23:34,0.0134375,2,15,725,740
2022-02-24 18:08:55,0.22112268518518519,2,16,32,48
2022-02-25 16:29:36,7.114409722222222,1,2,1,3
2022-02-24 18:09:10,0.27457175925925925,1,5,1,6
2022-02-24 10:43:51,0.11931712962962963,1,12,7,19
2022-03-11 22:43:50,15.956701388888888,10,706,173,879
2022-02-24 18:30:17,0.8315972222222222,1,218,1,219
2022-02-23 23:27:30,0.03239583333333333,2,21,10,31
2022-02-24 07:58:18,0.4609027777777778,2,29,3,32
2022-02-23 20:53:52,0.081875,6,26,24,50
2022-02-23 19:01:33,0.0038773148148148148,1,1,1,2
2022-03-17 17:51:38,22.222094907407406,8,146,119,265
2022-03-02 16:13:54,8.042048611111111,11,718,398,1116
2022-02-25 13:06:45,1.901863425925926,15,318,123,441
2022-03-01 16:44:20,6.116041666666667,1,2,0,2
2022-02-23 13:51:41,0.028599537037037038,2,3,3,6
2022-02-23 13:30:06,0.024293981481481482,1,1,1,2
2022-03-15 13:19:20,20.035972222222224,28,38544,9722,48266
2022-02-23 10:51:48,0.014583333333333334,1,1,1,2
2022-02-25 10:32:23,2.4123958333333335,1,1,1,2
2022-02-25 16:11:47,4.969641203703704,23,2051,284,2335
2022-03-14 18:57:56,20.37664351851852,47,3605,2428,6033
2022-02-23 16:40:06,1.1498726851851853,2,7,6,13
2022-02-22 20:58:05,0.33609953703703704,1,2,115,117
2022-03-04 17:18:35,54.21318287037037,63,116360,29114,145474
2022-02-22 23:16:39,0.8981134259259259,3,6,6,12
2022-02-22 08:57:28,0.8332291666666667,1,1,1,2
2022-02-22 11:18:35,0.9346180555555555,5,682,141,823
2022-02-23 09:46:42,1.9510185185185185,1,6,6,12
2022-02-25 17:19:17,17.052511574074074,77,31078,11643,42721
2022-02-25 12:43:56,4.328368055555556,2,7,1,8
2022-02-21 10:10:15,0.8236342592592593,1,0,2,2
2022-02-21 11:41:27,0.8865740740740741,1,3,3,6
2022-03-21 09:15:38,30.005243055555557,5,29,88,117
2022-02-23 19:58:33,4.888518518518518,3,1991,125,2116
2022-02-21 16:31:39,2.775983796296296,2,2,2,4
2022-02-23 20:48:19,0.011284722222222222,8,1736,1339,3075
2022-02-23 20:48:05,0.011122685185185185,7,1587,1295,2882
2022-02-23 20:47:00,0.01037037037037037,6,1442,873,2315
2022-02-23 20:46:38,0.010115740740740741,4,818,708,1526
2022-02-23 20:46:28,0.01,2,702,631,1333
2022-02-24 14:52:52,5.975428240740741,2,89,140,229
2022-02-18 20:11:42,0.20074074074074075,5,12,7,19
2022-02-18 13:49:54,0.009780092592592592,1,10,1,11
2022-02-18 10:57:39,0.023229166666666665,1,1,12,13
2022-02-21 17:30:11,3.327916666666667,1,0,2,2
2022-02-18 17:00:02,0.5461111111111111,1,1,1,2
2022-03-01 19:05:54,0.012060185185185186,1,82,56,138
2022-02-18 13:50:23,0.6496875,1,15,25,40
2022-02-21 17:17:59,3.864548611111111,9,60,141,201
2022-02-18 12:14:44,0.8174421296296296,1,2,1,3
2022-02-21 15:10:59,4.055462962962963,21,777,157,934
2022-02-18 17:20:24,1.1350810185185185,6,61,19,80
2022-02-17 13:42:15,0.10217592592592592,1,27,27,54
2022-02-18 08:11:19,1.0160416666666667,8,27,17,44
2022-02-17 13:38:32,0.7143055555555555,3,18,12,30
2022-02-22 18:26:44,6.035335648148148,23,17774,2554,20328
2022-02-16 16:50:37,0.02732638888888889,2,2,3,5
2022-02-18 11:20:07,1.8487037037037037,1,3,0,3
2022-02-16 16:33:33,0.05480324074074074,1,22,0,22
2022-03-02 14:48:20,10.923692129629629,34,6784,1894,8678
2022-02-16 13:06:26,0.021967592592592594,1,0,50,50
2022-02-23 18:43:22,7.342685185185185,24,9414,988,10402
2022-02-22 17:21:16,6.338611111111111,12,105,32,137
2022-02-15 23:55:38,0.11960648148148148,1,11,33,44
2022-02-15 23:55:22,0.1301388888888889,2,35,39,74
2022-02-16 14:13:33,0.7823148148148148,5,144,9,153
2022-02-16 02:14:04,0.2826736111111111,3,75,6,81
2022-02-17 12:14:01,1.6993981481481482,1,2,0,2
2022-02-16 11:53:26,14.75375,2,69,60,129
2022-02-15 18:13:08,0.06021990740740741,2,6,7,13
2022-02-15 15:56:31,0.08697916666666666,3,79,11,90
2022-03-09 16:37:00,25.80568287037037,38,16002,2928,18930
2022-02-16 09:15:14,0.9599537037037037,3,28,5,33
2022-02-15 08:13:56,0.010300925925925925,1,5,0,5
2022-02-15 15:53:05,0.5008796296296296,1,21,9,30
2022-02-15 16:48:01,0.5400231481481481,2,124,3,127
2022-02-16 00:12:30,0.8486342592592593,1,1,1,2
2022-02-15 14:44:35,0.7639930555555555,3,299,52,351
2022-02-23 16:20:27,8.939965277777778,16,257,164,421
2022-02-15 16:53:24,1.1039583333333334,1,18,5,23
2022-02-15 16:49:39,1.2101388888888889,2,7,4,11
2022-02-22 18:51:07,8.671770833333333,1,2,2,4
2022-02-15 19:15:42,14.344131944444445,2,8,5,13
2022-02-15 15:44:35,2.1144212962962965,4,28255,5127,33382
2022-02-15 01:30:55,2.4236458333333335,1,1,1,2
2022-02-14 15:35:20,2.2390393518518517,1,4,2,6
2022-02-14 18:35:16,4.776574074074074,7,636,172,808
2022-02-11 22:14:01,0.09503472222222223,3,96,32,128
2022-02-14 17:03:07,2.894884259259259,3,29,61,90
2022-02-11 21:43:55,1.9075810185185185,5,288,71,359
2022-02-11 18:46:09,0.06400462962962963,1,6,2,8
2022-02-14 11:48:23,25.111909722222222,5,16,10,26
2022-02-11 15:25:07,0.028402777777777777,1,9,1,10
2022-02-11 14:55:31,0.012476851851851852,1,36,0,36
2022-02-15 12:54:35,4.426620370370371,1,1,1,2
2022-02-16 19:37:52,5.768356481481481,4,111,50,161
2022-02-11 18:33:55,0.7753125,1,4,4,8
2022-02-11 21:51:30,0.9741203703703704,1,1,1,2
2022-02-28 11:22:36,9.74236111111111,13,1678,171,1849
2022-02-11 16:16:26,0.9776967592592593,3,61,47,108
2022-02-10 17:29:27,0.029791666666666668,2,2857,235,3092
2022-02-22 18:46:22,12.150219907407408,1,2,2,4
2022-02-11 17:02:02,0.02011574074074074,1,42,42,84
2022-02-10 15:31:00,0.036099537037037034,2,55,16,71
2022-02-10 15:26:15,0.039594907407407405,1,3,1,4
2022-02-10 17:02:03,0.26035879629629627,1,3,3,6
2022-02-10 13:52:07,0.24914351851851851,1,12,0,12
2022-02-11 19:31:09,1.6205671296296296,2,55,42,97
2022-03-22 11:09:52,41.12166666666667,2,17,7,24
2022-02-15 12:45:08,5.566840277777778,9,2761,2635,5396
2022-02-09 22:33:40,0.02943287037037037,1,2,0,2
2022-02-09 22:44:29,0.05210648148148148,3,251,80,331
2022-02-17 18:44:55,18.32923611111111,33,1441,417,1858
2022-02-11 18:54:04,1.9575810185185185,3,56,3,59
2022-02-09 17:27:59,0.064375,2,26,16,42
2022-02-09 15:28:43,0.001712962962962963,1,1,0,1
2022-02-09 13:20:06,0.3139351851851852,2,17,15,32
2022-02-09 11:26:48,0.5575925925925926,2,4,10,14
2022-02-09 15:04:45,0.8078703703703703,2,38,7,45
2022-02-09 17:32:51,0.9202893518518519,1,15,2,17
2022-02-11 17:35:10,2.948263888888889,4,41,5,46
2022-02-09 15:24:41,0.861550925925926,2,97,5,102
2022-02-09 14:28:58,0.8815509259259259,3,208,225,433
2022-02-08 19:10:53,0.07700231481481482,1,4,0,4
2022-02-15 16:54:43,6.980844907407407,32,15126,5641,20767
2022-02-09 15:48:09,0.9428356481481481,1,5,4,9
2022-02-08 14:54:19,0.020891203703703703,1,2,4,6
2022-03-07 08:10:18,26.99978009259259,3,27549,6785,34334
2022-02-08 16:53:23,0.5543865740740741,4,10,7,17
2022-02-09 18:12:29,1.8369560185185185,4,105,8,113
2022-02-09 14:24:49,1.749525462962963,6,250,736,986
2022-02-07 14:35:44,0.09105324074074074,1,30,3,33
2022-02-07 11:33:49,0.04459490740740741,1,0,6,6
2022-02-07 15:34:56,0.24734953703703705,3,37,27,64
2022-02-18 12:56:53,18.683530092592594,6,40,40,80
2022-02-17 12:16:37,11.956215277777778,17,2344,625,2969
2022-02-07 17:09:57,7.946087962962963,4,53,18,71
2022-02-14 16:33:35,9.380659722222223,4,11,4,15
2022-02-04 16:08:03,0.051145833333333335,1,6,0,6
2022-02-07 16:41:49,8.283518518518518,5,42,14,56
2022-02-04 16:32:14,4.808611111111111,3,2,5,7
2022-02-04 15:25:37,4.899201388888889,1,8,8,16
2022-03-01 10:09:20,25.553368055555556,128,74907,24875,99782
2022-02-03 18:55:14,0.05527777777777778,1,58,4,62
2022-02-09 15:48:41,7.038136574074074,7,130,39,169
2022-02-03 16:12:14,0.06535879629629629,1,44,44,88
2022-02-03 16:47:22,0.1656712962962963,7,213,245,458
2022-02-07 15:04:18,4.181331018518518,3,53,24,77
2022-02-03 11:57:29,4.665277777777778,1,1,1,2
2022-02-03 16:55:45,0.4626388888888889,2,6,5,11
2022-02-03 20:39:46,14.690069444444445,3,3,6,9
2022-02-07 18:34:56,6.018993055555556,6,424,99,523
2022-02-04 19:15:14,1.7836805555555555,1,6,1,7
2022-02-04 21:51:02,1.902013888888889,5,187,23,210
2022-02-02 19:23:43,0.1333101851851852,4,44,28,72
2022-02-02 17:12:22,0.035,1,11,14,25
2022-02-02 15:45:51,0.03484953703703704,2,2,2,4
2022-02-03 17:07:20,1.4370370370370371,3,69,8,77
2022-02-04 19:52:08,2.9422800925925925,8,3042,1248,4290
2022-02-23 17:39:41,21.907777777777778,1,1,1,2
2022-02-02 11:59:40,0.7955208333333333,1,88,3,91
2022-02-01 20:49:04,0.20075231481481481,1,13,3,16
2022-02-01 15:04:31,0.02917824074074074,1,1,1,2
2022-02-01 19:59:24,1.0991435185185185,3,608,26,634
2022-02-02 22:18:09,1.4947222222222223,15,117,63,180
2022-02-01 15:13:58,0.20927083333333332,7,73,36,109
2022-02-01 11:20:22,12.676342592592592,1,2,2,4
2022-01-31 21:58:27,0.11359953703703704,1,6,6,12
2022-01-31 21:53:16,0.11461805555555556,1,2,1,3
2022-02-01 13:32:55,0.7763773148148149,1,2,2,4
2022-01-31 19:18:00,0.1262037037037037,3,2,12,14
2022-01-31 18:47:49,0.023622685185185184,1,2,2,4
2022-01-31 17:50:20,0.013321759259259259,2,102,102,204
2022-02-01 20:49:13,1.146273148148148,2,36,27,63
2022-01-31 20:33:16,0.14859953703703704,1,7,0,7
2022-02-01 18:08:17,1.0539236111111112,2,2,4,6
2022-01-31 17:09:17,0.03681712962962963,1,1,1,2
2022-01-31 16:15:54,0.0028356481481481483,1,2,0,2
2022-01-31 16:10:46,0.014039351851851851,1,140,4,144
2022-01-31 16:03:07,0.043159722222222224,1,1,0,1
2022-01-31 14:48:20,0.0015277777777777779,1,1,1,2
2022-01-31 18:50:25,0.17341435185185186,3,201,12,213
2022-01-31 14:50:56,0.03871527777777778,1,1,0,1
2022-01-31 14:51:50,0.03690972222222222,1,1,0,1
2022-01-31 20:22:11,0.3145833333333333,4,2369,2254,4623
2022-01-31 17:51:29,0.2442013888888889,3,10,6,16
2022-02-02 08:44:22,1.9335069444444444,4,138,48,186
2022-02-09 15:59:27,31.15822916666667,44,91411,22457,113868
2022-01-31 15:32:14,0.7803703703703704,2,43,24,67
2022-02-15 15:40:51,15.864467592592593,3,15483,3805,19288
2022-01-31 10:38:08,2.645891203703704,1,1,0,1
2022-02-07 16:03:12,8.729155092592592,4,101,25,126
2022-01-31 12:45:11,1.606875,1,2,2,4
2022-01-30 14:35:53,0.7542708333333333,1,20,3,23
2022-02-02 23:24:40,4.4580671296296295,6,195,10,205
2022-01-31 16:28:11,2.6240740740740742,2,10,6,16
2022-01-28 17:31:23,0.02050925925925926,2,6,6,12
2022-01-28 23:34:10,0.30640046296296297,1,1,0,1
2022-01-28 15:53:25,8.881388888888889,1,2,2,4
2022-01-28 15:32:47,0.15094907407407407,2,31,12,43
2022-02-08 15:20:54,6.886770833333333,4,43,16,59
2022-01-28 12:52:01,0.4404166666666667,1,2,2,4
2022-02-02 15:44:37,6.924282407407407,25,920,583,1503
2022-01-27 20:16:55,0.02516203703703704,2,1,0,1
2022-01-27 19:17:49,0.11737268518518519,1,4,1,5
2022-01-27 16:16:25,0.0140625,2,15,1,16
2022-01-27 15:51:38,0.0060879629629629626,2,35,20,55
2022-01-27 15:43:43,0.004803240740740741,1,1,0,1
2022-01-27 14:58:55,0.01769675925925926,3,14,5,19
2022-01-27 15:25:43,0.046608796296296294,1,2,2,4
2022-01-27 19:46:15,0.26090277777777776,1,1,1,2
2022-01-27 19:45:58,0.2608449074074074,2,385,125,510
2022-01-27 19:45:18,0.26047453703703705,1,1,1,2
2022-01-28 01:05:31,1.0000578703703704,2,22,13,35
2022-01-31 18:35:54,5.017291666666667,5,146,9,155
2022-01-26 19:23:32,0.02431712962962963,2,3,3,6
2022-01-26 20:06:27,0.06258101851851852,1,4,4,8
2022-01-27 19:48:00,1.0932986111111112,4,153,34,187
2022-01-27 14:13:23,0.8574537037037037,6,75,36,111
2022-01-26 17:54:11,0.00951388888888889,1,17,13,30
2022-01-26 15:19:38,0.03802083333333333,1,1,1,2
2022-01-26 12:24:33,0.0840625,1,12,12,24
2022-01-28 11:39:55,2.0634375,2,7,4,11
2022-01-26 12:10:00,0.4404050925925926,1,1,0,1
2022-01-27 19:49:04,1.8566898148148148,3,49,9,58
2022-01-28 23:32:27,3.155798611111111,3,3,3,6
2022-01-27 15:24:51,2.1758333333333333,19,3751,303,4054
2022-01-27 14:00:54,1.9563657407407407,2,24,10,34
2022-01-25 14:48:25,0.052037037037037034,2,6,6,12
2022-02-01 15:48:25,7.980150462962963,20,9070,1354,10424
2022-01-28 11:15:30,3.7015972222222224,3,79,19,98
2022-01-24 14:54:47,0.02943287037037037,2,3,2,5
2022-01-24 15:33:43,0.25721064814814815,1,1,1,2
2022-01-24 10:46:38,0.006504629629629629,1,1,1,2
2022-02-07 15:35:38,14.221412037037037,16,27866,2920,30786
2022-01-24 12:27:45,0.12755787037037036,1,1,6,7
2022-01-25 22:26:17,2.253622685185185,2,8,6,14
2022-01-29 15:08:35,6.204224537037037,2,65,4,69
2022-03-03 13:10:15,39.140775462962964,12,5353,1776,7129
2022-01-31 16:43:08,9.062569444444444,8,48,288,336
2022-01-24 13:54:24,16.216898148148147,2,16,2,18
2022-01-24 12:21:32,2.2390625,1,1,1,2
2022-01-29 00:49:26,7.1191203703703705,6,192,366,558
2022-01-25 14:41:21,3.7241203703703705,7,232,134,366
2022-01-24 12:21:42,2.6896643518518517,2,4,4,8
2022-01-21 14:52:13,0.014502314814814815,1,1,1,2
2022-02-07 15:11:37,17.239085648148148,27,2451,719,3170
2022-01-21 13:46:15,0.0431712962962963,4,26,36,62
2022-01-21 16:12:10,0.18283564814814815,1,1,6,7
2022-02-07 16:32:14,17.22193287037037,1,3,32,35
2022-01-24 09:53:54,2.946087962962963,4,14,10,24
2022-01-21 13:47:34,0.13028935185185186,2,1,1,2
2022-01-21 13:28:19,0.1387037037037037,3,30,15,45
2022-01-21 16:18:12,14.785717592592592,2,1,1,2
2022-02-15 10:46:12,25.267337962962962,1,2,2,4
2022-01-25 19:46:11,4.8351851851851855,3,105,11,116
2022-02-01 10:09:50,11.544456018518519,1,0,7,7
2022-01-21 20:00:10,0.9816550925925925,17,772,272,1044
2022-02-02 00:28:12,13.260694444444445,6,322,349,671
2022-01-20 18:40:49,0.04168981481481481,1,3,0,3
2022-01-20 20:51:51,0.15822916666666667,1,39,10,49
2022-02-01 11:04:08,11.76869212962963,17,179,179,358
2022-01-20 18:51:19,0.15488425925925925,1,34,14,48
2022-01-20 15:37:35,0.049756944444444444,1,1,1,2
2022-01-21 17:30:10,1.2465162037037036,2,5,2,7
2022-01-20 10:40:26,0.0002199074074074074,1,1,1,2
2022-03-11 18:36:45,50.389201388888885,54,309,214,523
2022-01-20 13:46:48,0.1729050925925926,1,4,4,8
2022-01-21 11:11:08,1.1018055555555555,13,592,56,648
2022-01-20 13:47:24,13.682384259259258,2,2,0,2
2022-01-20 08:46:50,0.001574074074074074,1,3,1,4
2022-02-14 12:18:40,25.205185185185186,1,2,0,2
2022-01-21 14:49:29,1.5577546296296296,2,2,2,4
2022-01-20 14:26:51,0.8478009259259259,2,24,15,39
2022-01-19 17:03:18,0.001979166666666667,1,3,3,6
2022-01-19 16:00:16,0.007152777777777778,2,2,2,4
2022-01-21 12:30:12,1.8725810185185185,4,115,106,221
2022-01-19 15:16:19,0.026990740740740742,2,7,7,14
2022-01-19 14:30:04,0.004108796296296296,1,1,1,2
2022-01-19 14:23:00,0.0007407407407407407,1,2,2,4
2022-01-19 14:06:00,12.698391203703704,1,1,1,2
2022-01-19 14:27:57,0.14971064814814813,3,27,21,48
2022-01-19 20:04:26,0.40824074074074074,7,140,48,188
2022-01-19 14:19:36,0.8500462962962962,6,832,54,886
2022-01-19 13:47:35,0.9262847222222222,9,179,20,199
2022-01-19 13:29:07,0.9258217592592592,6,182,142,324
2022-01-18 14:44:35,0.0031944444444444446,1,0,1,1
2022-01-18 14:48:46,0.008854166666666666,2,5,1,6
2022-01-18 14:16:56,0.009270833333333334,2,28,9,37
2022-01-18 15:02:57,0.05585648148148148,1,219,70,289
2022-01-18 14:36:22,0.04101851851851852,2,36,9,45
2022-01-31 18:20:53,13.290949074074074,2,10,1,11
2022-01-18 11:20:10,0.03,2,18,1,19
2022-03-02 09:03:15,42.958645833333335,5,182,34,216
2022-01-17 20:20:58,0.01704861111111111,1,2,2,4
2022-01-18 12:16:30,13.678252314814815,5,7,4,11
2022-01-18 12:27:34,0.7120949074074074,1,3,0,3
2022-01-17 17:10:52,0.006863425925925926,1,1,1,2
2022-01-18 12:28:53,0.9305092592592593,6,47,34,81
2022-01-17 14:02:55,0.03643518518518519,1,1,1,2
2022-02-10 14:47:03,25.058645833333333,11,183,33,216
2022-01-26 09:14:46,9.824814814814815,1,3,3,6
2022-01-18 22:52:35,3.9683912037037037,18,232,145,377
2022-02-02 00:31:35,18.269826388888887,5,954,505,1459
2022-01-16 16:15:20,1.9496527777777777,1,36,0,36
2022-01-14 17:35:39,0.030381944444444444,1,24,24,48
2022-01-14 13:54:01,0.007511574074074074,1,1,1,2
2022-01-14 13:22:04,0.06133101851851852,3,56,17,73
2022-01-18 17:44:49,4.246585648148148,16,15346,7253,22599
2022-01-14 15:47:03,0.21920138888888888,2,12,1,13
2022-01-17 23:34:06,13.573252314814814,2,5,5,10
2022-01-13 21:48:52,0.007210648148148148,1,1,0,1
2022-01-14 15:59:42,0.782962962962963,5,2346,5935,8281
2022-01-15 02:25:21,1.2630787037037037,2,14,2,16
2022-01-14 10:42:08,0.6180555555555556,1,19,0,19
2022-01-14 12:37:51,0.7558217592592592,3,80,5,85
2022-01-14 12:42:13,10.152233796296295,1,1,1,2
2022-01-13 17:26:03,0.0051736111111111115,1,1,1,2
2022-01-14 09:52:39,0.7359606481481481,4,58,51,109
2022-01-13 11:02:24,0.04114583333333333,4,12,12,24
2022-01-13 14:17:28,0.653425925925926,1,2,2,4
2022-01-12 21:39:34,0.30039351851851853,4,87,40,127
2022-01-13 11:45:30,9.128020833333334,1,0,1,1
2022-01-12 14:12:43,0.1711111111111111,1,2,2,4
2022-01-12 15:33:32,0.7738657407407408,13,614,265,879
2022-01-18 15:21:32,8.932407407407407,30,9758,7330,17088
2022-02-09 14:27:30,28.227523148148148,8,1120,654,1774
2022-02-08 16:27:23,27.81483796296296,47,6171,3340,9511
2022-01-11 19:05:39,0.06225694444444444,2,4,1,5
2022-01-14 15:12:31,2.9589351851851853,27,5106,556,5662
2022-01-11 16:45:40,0.05103009259259259,2,13,2,15
2022-01-11 14:57:34,0.06553240740740741,1,5,1,6
2022-01-11 13:16:00,0.007719907407407407,1,52,0,52
2022-02-03 15:11:53,23.753078703703704,1,2,2,4
2022-01-11 10:57:26,0.05174768518518519,1,0,4,4
2022-01-11 12:44:30,0.14449074074074075,1,1,1,2
2022-01-29 01:01:37,18.30300925925926,7,366,490,856
2022-01-11 08:14:11,0.6181828703703703,2,21,0,21
2022-01-11 08:16:39,0.631724537037037,2,3,3,6
2022-01-10 17:05:58,0.00800925925925926,1,13,13,26
2022-01-10 17:13:28,0.02347222222222222,2,296,221,517
2022-01-11 09:04:23,7.031180555555555,1,1,1,2
2022-01-26 18:18:29,20.57439814814815,60,42095,11061,53156
2022-01-10 14:22:49,0.0011805555555555556,1,1,1,2
2022-01-21 11:10:42,11.126689814814815,44,26433,14875,41308
2022-02-08 14:47:49,35.34122685185185,13,70,13,83
2022-01-10 09:46:21,1.776689814814815,13,1179,775,1954
2022-01-18 15:43:21,14.793888888888889,6,26,22,48
2022-01-10 14:28:40,6.764930555555556,1,1,1,2
2022-01-14 15:19:04,6.873275462962963,2,12,7,19
2022-01-07 19:02:49,3.9603935185185186,2,3,1,4
2022-01-12 08:28:20,4.694826388888889,6,107,33,140
2022-01-19 19:15:13,12.153773148148149,3,10,10,20
2022-01-18 15:36:12,11.111712962962963,3,8,7,15
2022-02-18 09:21:30,42.942824074074075,56,57386,13214,70600
2022-01-10 15:06:14,3.9202777777777778,1,54,0,54
2022-01-06 16:59:06,2.8880555555555554,1,1,1,2
2022-01-19 22:00:33,13.260787037037037,4,120,56,176
2022-01-06 13:53:59,0.02045138888888889,1,11,9,20
2022-02-02 14:12:12,27.845127314814814,13,449,98,547
2022-01-07 15:55:59,3.864699074074074,3,3,3,6
2022-01-05 15:54:40,0.017280092592592593,1,4,4,8
2022-01-05 15:58:42,0.08962962962962963,1,5,4,9
2022-01-05 13:21:04,0.03304398148148148,1,1,0,1
2022-01-11 10:59:38,5.9791087962962965,1,22,1,23
2022-01-06 13:48:50,1.4960069444444444,1,6,3,9
2022-01-12 13:57:01,7.56474537037037,3,31,49,80
2022-01-05 10:34:08,1.6511805555555557,4,6,3,9
2022-01-27 13:29:31,253.18195601851852,44,339440,109458,448898
2022-01-06 13:16:01,2.149050925925926,1,70,13,83
2022-01-04 13:07:44,0.16810185185185186,4,204,63,267
2022-01-05 11:16:23,1.1044791666666667,2,27,3,30
2022-01-10 16:44:34,6.506886574074074,1,5,5,10
2022-01-13 20:21:00,10.040011574074073,3,22,3,25
2022-01-10 12:53:20,6.601122685185185,7,187,147,334
2022-01-04 17:58:28,0.9140277777777778,2,6,6,12
2022-01-24 20:18:04,21.050439814814816,8,26655,7420,34075
2022-01-03 18:11:48,0.02351851851851852,1,1,0,1
2022-01-03 19:19:04,0.08185185185185186,3,15,37,52
2022-01-10 11:55:43,6.786608796296297,1,1,1,2
2022-01-03 19:49:27,0.15458333333333332,8,27,26,53
2022-01-06 14:45:41,2.9722685185185185,1,57,52,109
2022-01-03 13:49:58,0.021145833333333332,1,8,2,10
2022-01-04 12:23:10,1.839548611111111,7,18684,13792,32476
2022-01-04 11:59:47,2.6193518518518517,1,1,1,2
2022-01-12 14:29:09,10.936168981481481,1,6,0,6
2022-01-10 11:44:11,9.590983796296296,1,3,2,5
2021-12-30 22:03:20,0.01615740740740741,2,8,2,10
2022-01-24 20:25:11,24.984618055555554,62,3600,698,4298
2022-01-11 18:19:33,12.121261574074074,1,1,1,2
2021-12-30 15:17:15,0.1998263888888889,3,29,14,43
2022-01-04 11:59:20,5.572881944444444,1,2,0,2
2022-01-07 07:34:12,8.477037037037038,1,64,0,64
2021-12-30 08:10:34,0.5705671296296296,2,18,6,24
2021-12-30 09:16:03,0.6685300925925926,4,46,16,62
2022-01-12 15:42:39,13.984606481481482,4,37,36,73
2021-12-29 15:09:54,0.4477083333333333,1,2,7,9
2022-01-06 16:26:45,9.04306712962963,1,1,1,2
2021-12-28 12:41:27,0.006446759259259259,1,22,22,44
2021-12-28 16:02:50,0.18459490740740742,3,297,7,304
2022-01-06 15:39:13,9.205983796296296,1,4,2,6
2022-01-31 20:12:11,34.4240162037037,2,13,9,22
2021-12-28 19:33:23,0.9018402777777778,21,16356,13936,30292
2021-12-28 10:07:05,0.02417824074074074,1,28,2,30
2022-01-05 09:09:52,8.15236111111111,2,32,0,32
2021-12-28 01:17:38,0.05334490740740741,3,24,26,50
2021-12-27 23:49:48,0.014467592592592593,2,73,73,146
2021-12-28 00:07:46,0.06162037037037037,12,3053,2026,5079
2021-12-27 22:09:37,0.010069444444444445,1,243,384,627
2021-12-27 22:31:40,0.02556712962962963,2,73,73,146
2021-12-27 21:31:21,0.07884259259259259,15,10984,10985,21969
2022-01-28 19:05:47,32.00729166666667,6,55016,20998,76014
2022-01-03 15:18:39,6.865891203703704,4,117,21,138
2021-12-27 19:25:27,0.44592592592592595,3,4,7,11
2022-01-03 10:08:56,6.737037037037037,5,122,84,206
2021-12-30 16:30:58,3.2696296296296294,4,37,10,47
2022-01-10 17:21:05,14.598391203703704,4,72,10,82
2021-12-27 16:48:48,1.262511574074074,1,5,1,6
2022-01-10 15:28:35,16.94991898148148,2,21010,13920,34930
2021-12-24 10:28:47,0.12189814814814814,1,1,1,2
2021-12-23 21:12:59,0.024965277777777777,1,1,1,2
2021-12-23 22:17:20,0.11663194444444444,1,1,1,2
2021-12-29 22:18:04,6.15175925925926,1,0,12,12
2021-12-23 19:18:08,0.0769212962962963,4,29,8,37
2022-01-11 17:06:05,19.174560185185186,19,26250,14706,40956
2021-12-23 18:59:33,0.07982638888888889,2,4,8,12
2021-12-23 16:53:56,0.009467592592592593,1,14,7,21
2021-12-23 16:22:33,0.005787037037037037,1,1,1,2
2021-12-23 13:59:12,0.17489583333333333,1,38,8,46
2022-01-03 15:54:17,11.143344907407407,2,114,26,140
2022-01-19 18:51:59,55.081041666666664,59,5929,2554,8483
2021-12-23 15:53:33,0.2950347222222222,2,2,2,4
2022-01-10 14:28:04,18.31076388888889,14,17776,13535,31311
2021-12-23 18:19:34,0.6022337962962963,1,2,4,6
2021-12-22 21:14:35,0.0691087962962963,3,9000,10488,19488
2021-12-22 17:28:45,0.0009606481481481482,1,3,3,6
2021-12-23 09:05:32,0.6922916666666666,1,1,1,2
2021-12-22 13:42:19,0.013206018518518518,2,4,4,8
2021-12-30 08:56:43,7.887800925925926,18,67969,64743,132712
2022-01-31 12:58:18,41.85893518518518,24,1536,638,2174
2021-12-22 13:18:03,0.15944444444444444,1,17,2,19
2022-01-28 17:55:24,37.730497685185185,49,6618,2921,9539
2021-12-21 23:54:42,0.017916666666666668,4,13,40,53
2021-12-21 22:57:37,0.03581018518518519,3,18,5,23
2021-12-21 22:17:02,0.007627314814814815,2,10,4,14
2021-12-21 21:54:10,0.00755787037037037,1,2,1,3
2022-01-11 11:17:08,20.701805555555556,6,477,450,927
2021-12-22 20:35:39,6.327719907407407,18,47064,41372,88436
2021-12-21 20:06:33,0.12612268518518518,12,14659,14232,28891
2021-12-22 08:27:30,0.6462847222222222,3,5387,6577,11964
2022-01-06 13:00:54,15.845138888888888,24,1881,495,2376
2021-12-21 17:55:26,0.6284259259259259,5,3263,3401,6664
2021-12-21 11:34:47,0.36366898148148147,1,3,0,3
2021-12-23 18:43:37,2.84681712962963,16,51976,51183,103159
2021-12-21 08:11:26,0.4769907407407407,2,23,5,28
2021-12-21 10:57:42,0.6498495370370371,1,14,0,14
2021-12-21 16:17:12,0.8877314814814815,4,13,7,20
2021-12-21 10:37:32,3.6300347222222222,20,17439,18200,35639
2021-12-20 17:20:21,0.03775462962962963,1,2,2,4
2021-12-21 12:12:22,0.9729166666666667,3,36,29,65
2021-12-20 13:40:56,0.0503587962962963,2,573,7,580
2021-12-20 11:06:43,0.022199074074074072,1,2,2,4
2021-12-20 14:08:05,0.332025462962963,1,1,1,2
2021-12-20 13:42:03,0.8649189814814815,1,1,1,2
2021-12-20 10:47:32,1.4088194444444444,1,1,0,1
2021-12-20 14:25:34,2.5806944444444446,1,2,1,3
2021-12-20 14:28:17,2.607835648148148,1,6,3,9
2021-12-21 17:17:28,3.9152430555555555,2,18,12,30
2021-12-17 15:08:54,0.03340277777777778,2,33,8,41
2021-12-20 14:22:50,3.042384259259259,4,1308,1306,2614
2021-12-17 12:30:18,0.0628587962962963,2,3,5,8
2021-12-17 09:33:27,0.024131944444444445,1,26,1,27
2021-12-23 09:23:39,6.462962962962963,1,2,1,3
2021-12-17 16:13:34,0.7783217592592593,3,202,267,469
2021-12-16 21:42:58,0.006643518518518518,1,15,5,20
2021-12-20 16:19:08,3.859189814814815,7,6976,710,7686
2021-12-20 09:53:49,3.649097222222222,4,7,11,18
2021-12-17 19:05:22,1.0649189814814815,5,98,38,136
2021-12-16 15:40:57,0.0045138888888888885,1,1,1,2
2021-12-16 15:24:26,0.03155092592592593,1,1,1,2
2021-12-16 16:08:14,0.07349537037037036,2,4,1,5
2021-12-16 19:34:15,0.24085648148148148,1,11,65,76
2021-12-28 09:20:51,11.899050925925925,15,60583,52468,113051
2021-12-16 14:29:26,0.8307407407407408,7,191,253,444
2021-12-16 14:35:20,0.7973263888888888,3,5,2,7
2021-12-15 18:34:42,-0.0002546296296296296,1,3,1,4
2021-12-15 17:02:06,0.00625,3,64,58,122
2021-12-16 17:03:55,1.033576388888889,12,429,281,710
2021-12-15 16:06:38,0.0340162037037037,2,124,21,145
2021-12-16 09:42:02,1.8318055555555555,2,46,36,82
2021-12-21 14:44:09,6.142245370370371,2,4,4,8
2021-12-21 15:47:41,6.189525462962963,11,23370,17497,40867
2022-01-17 12:22:42,33.18181712962963,1,2,1,3
2021-12-15 13:59:11,0.40819444444444447,1,1,3,4
2021-12-15 08:40:17,0.23859953703703704,8,6889,6888,13777
2021-12-15 10:36:28,0.7306365740740741,1,1,1,2
2021-12-15 03:01:23,1.1019444444444444,1,23,0,23
2021-12-20 13:41:40,9.60431712962963,2,19,5,24
2021-12-13 22:15:19,0.006793981481481482,1,6,0,6
2021-12-15 19:40:47,2.0133680555555555,5,75,129,204
2021-12-13 18:09:50,0.025902777777777778,3,553,633,1186
2021-12-22 09:51:55,8.766006944444445,10,230,94,324
2021-12-13 16:17:01,0.0022453703703703702,1,1,719,720
2021-12-13 17:46:49,0.11979166666666667,4,50,61,111
2021-12-22 11:35:59,8.902291666666667,3,92,44,136
2021-12-13 14:29:47,0.013483796296296296,1,1,1,2
2021-12-13 17:34:26,0.1832175925925926,1,1,1,2
2021-12-13 13:13:39,0.15702546296296296,1,27,3,30
2022-01-13 16:14:52,34.157731481481484,55,78137,67943,146080
2021-12-13 15:31:11,0.25155092592592593,1,6,6,12
2021-12-14 08:43:07,0.9302546296296297,11,118,54,172
2021-12-13 17:21:26,0.3573263888888889,2,5,2,7
2021-12-13 17:30:46,1.0346412037037036,3,54,88,142
2021-12-13 16:12:58,1.029074074074074,1,2,2,4
2021-12-13 13:31:50,1.5925578703703704,1,15,10,25
2021-12-27 11:37:52,53.06295138888889,13,109436,64465,173901
2021-12-13 14:53:48,2.568275462962963,1,6,6,12
2021-12-11 02:24:38,0.08493055555555555,3,37,5,42
2021-12-13 16:46:03,2.846863425925926,4,285,21,306
2021-12-16 16:22:14,22.07980324074074,16,53410,12203,65613
2021-12-15 02:55:33,4.1962268518518515,4,2636,2669,5305
2021-12-10 21:02:49,0.018449074074074073,1,6,6,12
2021-12-15 14:57:53,4.788680555555556,18,286,72,358
2021-12-11 00:39:00,0.2601273148148148,2,23,0,23
2021-12-10 19:20:56,0.07849537037037037,8,324,287,611
2021-12-14 15:46:16,4.197280092592592,6,125,45,170
2021-12-12 12:30:44,1.9321412037037038,1,6,5,11
2021-12-22 12:52:07,11.969583333333333,1,2,2,4
2021-12-12 12:31:46,2.022152777777778,2,5,3,8
2021-12-10 14:29:19,0.12150462962962963,1,7,0,7
2021-12-09 16:35:23,0.08538194444444444,1,1,1,2
2021-12-09 14:25:32,0.0014930555555555556,1,1,1,2
2021-12-09 13:32:36,0.03965277777777778,1,6,5,11
2021-12-23 09:07:21,13.951319444444444,3,48587,43284,91871
2021-12-22 13:43:11,13.164363425925925,11,1261,593,1854
2021-12-10 07:56:38,0.9146296296296297,1,1,3,4
2021-12-13 15:36:50,4.2509143518518515,3,5,5,10
2021-12-13 11:50:03,4.108414351851851,1,10,10,20
2021-12-13 12:24:36,4.166261574074074,9,1134,1210,2344
2021-12-23 09:19:25,14.446168981481481,1,1,1,2
2021-12-08 20:59:58,0.006273148148148148,1,2,0,2
2021-12-10 16:44:09,1.8409490740740742,2,5,5,10
2021-12-08 20:21:43,0.005659722222222222,1,3,2,5
2021-12-08 21:39:35,0.07230324074074074,2,130,129,259
2021-12-08 20:41:58,0.06409722222222222,5,43,55,98
2021-12-08 19:25:49,0.014837962962962963,1,11,11,22
2021-12-09 17:00:06,0.9189236111111111,1,18,0,18
2021-12-08 18:52:31,-0.00018518518518518518,1,2,18,20
2021-12-09 13:42:24,0.7881712962962963,2,8,5,13
2021-12-08 18:42:22,0.026400462962962962,2,6,8,14
2021-12-08 18:39:10,6.431412037037037,26,16594,1816,18410
2021-12-08 18:04:41,0.016064814814814816,1,384,931,1315
2021-12-10 13:55:54,1.8745949074074073,1,10,10,20
2021-12-08 14:14:36,0.005451388888888889,1,2,0,2
2021-12-08 14:51:28,0.07944444444444444,7,74,18,92
2021-12-08 13:43:21,0.27381944444444445,1,3,3,6
2021-12-21 04:48:38,13.178483796296296,3,20689,6769,27458
2021-12-13 08:30:50,5.511643518518518,18,11939,4485,16424
2021-12-08 18:19:46,1.8299652777777777,9,7218,7660,14878
2021-12-07 21:04:19,0.035902777777777777,5,25,38,63
2021-12-09 12:01:03,1.7422800925925925,1,49,0,49
2021-12-08 18:25:30,1.0831944444444443,4,12,8,20
2022-01-11 13:25:49,34.87966435185185,62,87830,63659,151489
2021-12-08 08:54:24,0.8140509259259259,3,69,31,100
2022-02-16 00:49:58,70.89188657407408,11,140792,72135,212927
2022-01-24 20:13:21,48.815428240740744,14,138899,73362,212261
2021-12-07 05:57:47,0.32868055555555553,8,319,155,474
2021-12-06 19:04:28,0.03320601851851852,3,74,15,89
2021-12-06 18:55:59,0.043125,3,72,0,72
2021-12-06 18:31:28,0.03318287037037037,1,25,25,50
2021-12-06 17:44:38,0.0062037037037037035,1,45,0,45
2021-12-06 16:51:53,0.07043981481481482,1,2,2,4
2021-12-07 05:25:28,0.8071296296296296,7,3117,244,3361
2021-12-06 09:20:43,0.12840277777777778,1,2,0,2
2021-12-12 03:49:12,5.902164351851852,3,1127,205,1332
2021-12-06 05:22:43,0.0007175925925925926,1,1,1,2
2021-12-05 06:01:23,0.36515046296296294,1,1,1,2
2021-12-22 12:36:09,18.174594907407407,5,62811,46162,108973
2021-12-06 03:12:51,1.545011574074074,1,4,2,6
2021-12-06 17:49:50,14.039756944444445,4,28,56,84
2021-12-17 16:07:00,13.7215625,14,24624,8345,32969
2021-12-07 15:44:28,3.7622569444444443,2,4,7,11
2021-12-06 09:35:01,2.6103819444444443,2,17,16,33
2021-12-03 17:09:25,0.006527777777777778,3,4,4,8
2021-12-03 16:35:44,0.25157407407407406,9,74,49,123
2021-12-03 13:18:37,0.4963194444444444,4,51,59,110
2021-12-03 18:08:58,0.744363425925926,11,131,68,199
2021-12-02 13:13:42,0.08248842592592592,1,1,1,2
2021-12-06 05:18:58,3.7729166666666667,13,611,64,675
2021-12-02 09:09:17,0.001979166666666667,1,1,1,2
2021-12-02 08:32:39,0.004421296296296296,2,2,1,3
2021-12-02 07:58:39,0.36190972222222223,1,0,0,0
2021-12-02 08:01:35,0.4039814814814815,5,31,31,62
2021-12-01 19:13:02,10.012511574074074,39,3467,6896,10363
2021-12-03 20:15:09,2.140324074074074,5,36,0,36
2021-12-23 12:35:57,80.25184027777777,70,153782,71052,224834
2022-02-02 19:06:14,125.34715277777778,40,263487,87291,350778
2021-12-08 19:33:24,7.678206018518519,6,22177,8006,30183
2021-12-01 22:18:58,0.8065393518518519,5,2976,3289,6265
2021-12-02 08:51:48,1.477835648148148,8,5471,3781,9252
2022-03-12 01:53:53,101.91509259259259,34,200627,89453,290080
2021-11-30 10:32:20,0.7265277777777778,1,2,2,4
2021-11-29 15:10:20,0.02556712962962963,1,1,1,2
2021-11-29 16:26:00,2.1918402777777777,2,4,4,8
2021-12-07 17:09:18,10.411909722222223,2,2,2,4
2021-12-02 09:41:35,13.720069444444444,26,1305,363,1668
2021-11-26 12:51:47,0.022916666666666665,1,2,2,4
2021-11-26 09:35:08,0.0006828703703703704,1,18,10,28
2021-11-26 09:09:31,0.0012731481481481483,1,5,5,10
2021-11-26 08:46:08,0.533449074074074,6,46,24,70
2021-11-25 17:59:33,0.1022337962962963,1,5,5,10
2021-11-29 09:19:12,3.755011574074074,2,38,21,59
2021-12-02 14:05:31,7.050162037037037,7,753,543,1296
2021-11-25 08:15:35,0.24400462962962963,1,12,9,21
2021-11-24 14:03:21,0.0032407407407407406,1,4,2,6
2021-11-29 09:15:08,4.884293981481481,7,12,8,20
2021-11-24 11:22:03,0.8845601851851852,1,7,1,8
2021-12-06 16:44:11,12.782210648148148,8,117930,13170,131100
2021-11-22 21:00:44,0.05578703703703704,1,4,4,8
2021-11-29 17:36:19,6.960578703703704,19,155,74,229
2021-12-08 13:20:34,128.07358796296296,147,11586,4994,16580
2021-11-22 15:35:49,0.2065625,1,7,7,14
2021-11-21 22:39:20,0.025034722222222222,2,89,1,90
2021-11-29 16:30:17,7.885277777777778,1,1,1,2
2021-11-21 15:31:10,0.7981712962962964,2,3,3,6
2021-11-22 21:17:27,2.1732291666666668,4,112,97,209
2021-11-22 16:33:43,2.6596527777777776,2,37,9,46
2021-11-22 17:17:38,2.919386574074074,7,289,30,319
2021-11-22 09:40:46,2.7780671296296298,4,27,27,54
2021-11-19 14:15:02,0.09375,2,49,8,57
2021-11-19 13:43:49,0.08600694444444444,4,3,5,8
2021-11-24 14:22:21,5.116701388888889,2,9,5,14
2021-11-18 19:47:49,0.05496527777777778,2,7,7,14
2021-11-18 15:25:06,0.043912037037037034,1,5,1,6
2021-11-19 14:35:06,1.1178935185185186,7,2716,2657,5373
2021-11-18 10:26:56,0.10150462962962963,1,3,3,6
2021-11-18 01:16:47,0.12162037037037036,1,31,0,31
2021-11-17 18:02:34,0.008657407407407407,1,1,1,2
2021-11-18 13:38:11,0.9668055555555556,6,730,396,1126
2021-11-16 23:58:07,0.06077546296296296,4,34,31,65
2021-11-19 14:37:53,2.9720138888888887,1,22,3,25
2021-11-16 14:24:40,0.016446759259259258,2,2752,685,3437
2021-11-17 20:24:40,1.421875,14,581,430,1011
2021-11-16 21:50:05,0.5811921296296296,5,46,7,53
2021-11-16 13:58:43,0.6583217592592593,5,60,7,67
2021-11-15 20:03:11,0.009212962962962963,2,24,12,36
2021-11-15 13:45:51,0.0010532407407407407,1,1,1,2
2021-11-15 16:35:34,0.1366550925925926,1,3,2,5
2021-12-01 05:27:40,15.80025462962963,9,1183,74,1257
2021-11-17 13:38:56,2.5474189814814814,14,6045,646,6691
2021-11-15 01:19:15,0.09251157407407408,3,84,21,105
2021-11-15 15:34:11,0.8089236111111111,3,173,102,275
2021-11-14 02:34:34,0.17565972222222223,2,32,35,67
2021-11-15 18:25:10,2.079525462962963,1,5,5,10
2021-11-13 15:27:12,0.26402777777777775,4,8,8,16
2021-11-28 23:55:38,15.996342592592592,4,13342,1475,14817
2021-12-06 23:27:32,24.529965277777777,18,656,260,916
2021-11-12 10:26:42,0.017037037037037038,1,4,4,8
2021-11-13 08:51:58,0.9580555555555555,1,17,6,23
2021-11-12 15:35:58,0.9494560185185185,3,29,7,36
2021-11-11 15:34:00,0.03328703703703704,2,10,8,18
2021-11-11 11:46:25,0.07480324074074074,1,3,3,6
2021-11-11 15:50:49,0.24965277777777778,7,91,8,99
2021-11-12 18:46:40,1.4707407407407407,3,18,30,48
2021-12-01 19:16:52,20.509953703703705,3,230,220,450
2021-11-11 03:11:45,0.006122685185185185,1,25,3,28
2021-11-11 14:21:50,0.8374537037037038,3,22,1,23
2021-12-08 17:39:57,28.10724537037037,11,1425,878,2303
2021-11-17 14:29:58,8.107592592592592,13,633,616,1249
2021-12-16 17:57:05,36.33318287037037,34,58290,13946,72236
2021-12-17 18:56:44,37.29207175925926,52,66859,19386,86245
2021-11-12 08:20:40,1.949513888888889,2,86,26,112
2021-11-10 12:25:42,0.2257523148148148,1,2,1,3
2021-11-09 23:49:29,0.011805555555555555,1,5,5,10
2021-11-15 21:38:02,5.943645833333333,3,111,8,119
2021-11-09 16:45:22,0.0343287037037037,1,9,9,18
2021-11-09 16:30:17,0.16664351851851852,1,0,6,6
2021-12-08 11:07:55,28.98513888888889,34,86150,15419,101569
2021-11-09 13:04:23,0.24287037037037038,3,203,45,248
2021-11-08 20:40:30,0.050902777777777776,2,20,10,30
2021-11-08 15:56:44,0.013668981481481482,2,5,5,10
2021-11-09 19:26:59,1.1652199074074074,7,12054,1580,13634
2021-11-10 09:18:36,1.8309722222222222,4,113,9,122
2022-02-07 21:25:33,112.24319444444444,19,44377,10251,54628
2021-11-08 10:42:35,0.012881944444444444,1,8,3,11
2021-11-08 12:58:29,0.8142361111111112,2,8,0,8
2021-11-08 11:15:56,0.05559027777777778,1,5,6,11
2021-11-08 13:28:26,0.17168981481481482,3,7,11,18
2021-11-08 15:22:28,0.2589699074074074,3,21,19,40
2021-12-06 13:01:52,29.32521990740741,17,178,198,376
2021-11-10 03:23:08,3.0954282407407407,7,13,9,22
2021-11-06 13:41:02,0.5856365740740741,1,0,7,7
2021-11-09 02:00:06,3.2447800925925927,6,244,184,428
2021-11-08 20:28:25,12.291712962962963,6,279,17,296
2021-11-05 22:58:52,0.21465277777777778,1,51,23,74
2021-11-10 11:49:44,4.931805555555556,2,8,1,9
2021-11-05 13:09:57,0.01258101851851852,1,1,1,2
2021-11-06 14:08:58,1.259085648148148,1,9,3,12
2021-11-06 14:33:47,1.3790046296296297,1,1,1,2
2021-11-05 01:15:42,0.02034722222222222,2,4,4,8
2021-11-04 17:58:28,0.043958333333333335,2,2,4,6
2021-11-06 14:04:31,1.9571643518518518,1,7,1,8
2021-11-04 14:13:23,0.020648148148148148,1,2,1,3
2021-11-04 13:47:53,0.05444444444444444,1,14,4,18
2021-11-03 21:43:19,0.3665625,5,177,126,303
2021-11-03 21:45:41,0.0954050925925926,4,17,10,27
2021-11-03 19:03:10,0.025590277777777778,4,12,10,22
2021-11-04 08:49:55,0.7798379629629629,7,77,72,149
2021-11-03 10:31:40,0.006585648148148148,1,3,3,6
2021-11-23 22:09:16,21.06101851851852,8,203,92,295
2021-11-02 22:58:43,0.17693287037037037,4,71,173,244
2021-11-02 17:07:21,0.0062037037037037035,1,1,1,2
2021-11-02 16:15:15,0.013483796296296296,1,7,1,8
2021-11-02 14:53:50,5.092708333333333,3,2930,103,3033
2021-11-03 16:20:48,1.1832523148148149,4,101,48,149
2021-11-18 15:24:34,18.245196759259258,33,3838,1343,5181
2021-11-01 17:46:12,0.016099537037037037,1,3,1,4
2021-11-03 18:28:57,2.32244212962963,1,4,4,8
2021-12-27 10:26:21,59.059571759259256,28,1485,1128,2613
2021-11-01 12:42:27,0.10524305555555556,1,1,4,5
2021-11-01 12:25:34,0.14046296296296296,1,11,6,17
2021-11-01 12:53:14,1.1280439814814816,3,38,25,63
2021-11-02 08:22:45,2.2065740740740742,2,4,4,8
2021-10-29 17:12:11,0.07109953703703703,1,6,3,9
2021-10-29 13:35:05,0.019085648148148147,2,4,3,7
2021-10-29 15:24:09,0.28888888888888886,2,11,6,17
2021-11-01 13:24:04,3.300752314814815,1,1,1,2
2021-11-30 16:47:33,32.9350462962963,2,58,58,116
2021-10-28 16:01:00,0.015219907407407408,2,38,36,74
2021-11-03 14:48:00,6.01931712962963,3,28,9,37
2021-10-28 12:59:18,0.013171296296296296,1,25,5,30
2021-10-28 13:22:18,0.032511574074074075,3,23,17,40
2021-11-01 17:08:52,4.215821759259259,4,4522,531,5053
2021-10-28 21:17:43,0.6413541666666667,1,20,15,35
2021-10-28 02:01:50,0.23458333333333334,3,7,7,14
2021-10-29 14:32:57,1.956388888888889,7,492,209,701
2021-10-27 14:17:48,0.015648148148148147,1,1,1,2
2021-11-01 10:52:36,4.894814814814815,7,63,20,83
2021-10-27 13:47:20,0.05497685185185185,5,465,393,858
2021-10-27 17:17:31,0.3320949074074074,6,277,9,286
2021-11-01 11:52:22,5.072199074074074,1,178,180,358
2021-10-29 17:43:44,2.6404282407407407,4,13,11,24
2021-11-30 16:34:42,0.11368055555555556,2,18,3,21
2021-10-27 02:20:51,0.1635185185185185,1,2,2,4
2021-10-26 20:36:26,0.06829861111111112,2,2,2,4
2021-10-29 09:50:25,2.7360532407407407,5,66,92,158
2021-10-26 13:59:33,0.02141203703703704,2,13,13,26
2021-10-27 09:21:09,0.8952662037037037,4,7600,343,7943
2021-10-26 14:09:00,4.187280092592593,3,1853,157,2010
2021-10-26 11:08:18,0.07074074074074074,1,16,3,19
2021-10-26 11:36:17,0.6073842592592592,2,2,0,2
2021-10-26 20:23:41,1.0591435185185185,1,1,1,2
2022-01-10 18:30:14,77.08027777777778,39,19085,14171,33256
2021-10-26 21:14:29,1.3527777777777779,1,8,4,12
2021-10-25 14:04:55,0.07984953703703704,1,5,0,5
2021-10-25 14:04:36,0.04398148148148148,1,2,2,4
2021-10-28 13:29:05,3.1326851851851854,10,190,59,249
2021-10-25 11:48:02,0.4320949074074074,2,31,31,62
2021-10-25 11:45:45,0.48689814814814814,1,2,1,3
2021-11-02 17:29:14,8.854895833333334,7,169,78,247
2021-10-27 16:19:10,3.1752430555555557,2,4,3,7
2021-10-25 11:40:44,2.485358796296296,3,11,10,21
2021-10-25 20:53:48,3.1428935185185187,1,6,1,7
2021-10-22 17:05:45,0.16378472222222223,2,9,7,16
2021-10-27 23:22:29,5.470115740740741,13,156,118,274
2021-10-22 17:04:55,0.24980324074074073,1,6,0,6
2021-10-29 13:29:28,7.102893518518519,13,123,59,182
2021-10-22 11:45:33,0.07222222222222222,2,25,20,45
2021-10-22 09:01:27,0.014340277777777778,1,3,1,4
2021-11-03 07:59:45,18.457824074074075,23,5013,723,5736
2021-10-22 19:57:48,0.7284490740740741,3,0,0,0
2021-10-21 21:00:27,0.008784722222222222,1,1,1,2
2021-10-21 19:29:17,0.17883101851851851,1,1,1,2
2021-10-21 16:15:47,3.2213194444444446,5,1747,360,2107
2021-10-21 19:31:00,0.31971064814814815,1,2,3,5
2021-11-01 18:55:46,17.454340277777778,17,837,312,1149
2021-10-21 19:31:32,0.45488425925925924,1,1,0,1
2021-10-21 08:30:02,0.005578703703703704,1,4,3,7
2021-10-21 22:07:18,0.6852199074074075,1,16,17,33
2021-10-22 14:03:09,1.3834027777777778,11,64,41,105
2021-10-21 11:27:32,1.3294791666666668,2,9,6,15
2021-10-20 19:10:57,0.01962962962962963,1,1,1,2
2021-10-21 16:31:29,0.9147337962962963,10,131,65,196
2022-01-08 19:33:56,80.35524305555556,3,103,54,157
2021-10-20 11:01:42,0.006099537037037037,1,6,1,7
2021-10-20 11:54:39,0.08804398148148149,2,30,14,44
2021-11-02 10:02:42,13.084502314814815,5,29,26,55
2021-10-20 11:51:30,0.20224537037037038,1,5,1,6
2021-10-20 11:43:45,0.34025462962962966,3,23,21,44
2021-10-20 02:06:19,0.040324074074074075,1,1,1,2
2021-10-20 09:51:41,0.6461111111111111,2,5,1,6
2021-11-19 18:33:39,31.59755787037037,42,5812,629,6441
2021-10-19 18:30:53,0.08238425925925925,1,1,1,2
2021-11-03 13:53:05,15.047314814814815,8,14311,1494,15805
2021-10-21 11:32:27,1.9761226851851852,2,17,12,29
2021-10-26 09:22:22,7.059930555555556,11,60,27,87
2021-10-18 22:03:39,0.27564814814814814,1,1,1,2
2021-10-20 11:55:14,1.906273148148148,1,24,2,26
2021-10-18 14:22:58,0.02511574074074074,1,0,2,2
2021-10-20 09:22:43,1.9344675925925925,9,34,48,82
2021-10-18 22:03:11,0.44385416666666666,1,1,1,2
2021-10-18 10:58:59,0.0013194444444444445,1,1,1,2
2021-10-25 21:55:08,7.482465277777778,18,4384,2083,6467
2021-10-18 10:59:18,0.031342592592592596,1,0,5,5
2021-10-18 10:52:40,0.061782407407407404,4,49,114,163
2021-10-18 08:24:25,0.021076388888888888,1,1,1,2
2021-10-18 15:43:35,0.7821064814814814,8,1626,442,2068
2021-11-03 08:54:34,17.549560185185186,5,6179,943,7122
2021-11-17 17:37:22,31.933229166666667,2,29503,3502,33005
2021-10-15 19:56:07,0.022152777777777778,1,4,2,6
2021-10-15 22:48:37,0.1548263888888889,5,860,834,1694
2021-10-17 21:01:03,2.1822916666666665,4,84,67,151
2021-10-16 00:08:57,0.3255092592592593,1,11,8,19
2021-10-16 00:09:54,0.4311689814814815,1,7,1,8
2021-10-19 08:56:17,3.843310185185185,1,3,0,3
2021-10-28 12:23:52,56.16204861111111,32,3219,471,3690
2021-10-16 00:28:13,0.6811226851851852,2,8,5,13
2021-11-15 16:48:40,31.423738425925926,1,40,0,40
2021-10-22 11:42:31,7.296388888888889,9,339,10,349
2021-10-21 15:19:30,6.454444444444444,1,3,3,6
2021-10-26 19:25:02,11.62542824074074,3,37,19,56
2021-10-19 11:14:22,4.8593981481481485,2,40,8,48
2021-10-14 13:46:22,0.0076851851851851855,1,35,35,70
2021-10-14 12:57:12,0.07548611111111111,1,5,3,8
2021-10-14 13:07:09,0.48899305555555556,6,95,16,111
2021-10-14 19:30:27,0.9235069444444445,2,94,73,167
2021-10-14 13:07:52,0.6751967592592593,1,3,3,6
2021-10-18 14:22:46,4.830405092592593,14,508,142,650
2021-10-14 08:54:21,0.6214583333333333,1,17,1,18
2021-10-12 22:37:55,0.13761574074074073,1,13,2,15
2021-10-12 16:17:06,0.01513888888888889,4,61,34,95
2021-10-12 16:18:20,0.018136574074074076,1,1,1,2
2021-10-12 14:26:18,0.0674074074074074,1,30,30,60
2021-10-12 03:30:04,0.04572916666666667,1,1,0,1
2021-12-23 16:19:44,73.98246527777778,29,3769,1325,5094
2021-11-11 16:50:21,30.965648148148148,1,3,21,24
2021-10-26 16:59:59,15.030983796296296,30,34101,6311,40412
2021-10-15 15:26:27,8.987858796296296,19,18748,2074,20822
2021-10-11 13:34:02,0.12708333333333333,2,32,3,35
2021-10-25 11:58:30,14.173449074074075,2,6,0,6
2021-10-11 14:21:46,0.6631481481481482,1,3,3,6
2021-10-11 17:58:09,0.9289236111111111,16,77,64,141
2021-10-11 08:59:16,0.6720486111111111,4,8,6,14
2021-10-11 13:35:20,1.037824074074074,1,7,0,7
2021-10-11 14:22:35,1.9494097222222222,1,12,6,18
2021-10-09 13:07:39,0.058020833333333334,1,1,1,2
2021-10-11 16:03:58,2.758564814814815,1,19,14,33
2021-10-14 14:12:33,5.775428240740741,5,1535,383,1918
2021-10-11 16:21:50,2.8727430555555555,1,10,10,20
2021-10-14 01:28:11,5.443032407407407,3,1521,360,1881
2021-10-08 14:27:33,0.04033564814814815,1,2,2,4
2021-10-08 18:41:51,0.26578703703703704,5,29,18,47
2021-11-10 10:16:45,33.162581018518516,5,23,13,36
2021-10-26 16:09:54,18.652314814814815,4,63,32,95
2021-10-11 13:12:09,3.6352314814814815,4,76,46,122
2021-11-09 19:12:50,33.00890046296296,5,40548,4068,44616
2021-10-07 16:10:19,0.00863425925925926,1,6,6,12
2021-10-07 16:07:33,0.034027777777777775,2,93,2,95
2021-10-08 15:28:19,1.2095601851851852,3,76,29,105
2021-10-08 08:10:39,1.016898148148148,2,63,16,79
2021-10-07 13:22:11,0.3255092592592593,1,101,101,202
2021-10-07 17:29:02,0.5381365740740741,2,25,2,27
2021-10-06 16:40:52,0.00962962962962963,1,7,4,11
2021-10-07 13:09:01,0.8988310185185185,3,48,36,84
2021-10-07 07:14:23,0.667349537037037,1,6,3,9
2021-10-22 11:11:40,16.03101851851852,10,10685,799,11484
2021-10-20 12:15:47,14.105231481481482,3,69,4,73
2021-10-06 15:52:28,0.5990393518518519,1,5,1,6
2021-10-06 11:54:54,0.44403935185185184,3,8,7,15
2021-10-05 22:08:48,0.025983796296296297,1,2,1,3
2021-10-06 00:42:12,0.12260416666666667,7,26,11,37
2021-11-03 14:36:42,28.740162037037038,2,40,11,51
2021-10-05 20:27:23,0.030694444444444444,1,4,0,4
2021-10-15 01:46:09,9.290914351851852,3,10,3,13
2021-10-06 02:43:16,0.360625,1,66,12,78
2021-10-08 18:25:33,3.0350810185185186,1,3,3,6
2021-10-07 16:30:15,2.001412037037037,4,17,36,53
2021-10-11 22:46:32,6.566516203703704,28,15692,7892,23584
2021-11-10 20:34:52,36.290925925925926,4,44505,4875,49380
2021-10-13 08:28:56,17.936631944444443,38,4848,1571,6419
2021-10-05 14:08:58,0.1867476851851852,5,210,109,319
2021-10-05 11:00:13,0.03890046296296296,1,8,8,16
2021-10-06 03:02:45,0.7483449074074074,1,4,4,8
2021-10-04 20:28:53,0.22555555555555556,6,29,14,43
2021-10-06 02:47:12,49.289722222222224,22,5191,1498,6689
2021-10-05 10:26:54,0.8786111111111111,1,53,29,82
2021-10-05 11:46:10,1.0530671296296297,3,16,2,18
2021-10-06 03:10:25,1.760324074074074,1,1,1,2
2021-10-06 02:44:31,1.7828819444444444,1,26,5,31
2021-10-06 03:06:47,1.8145023148148147,1,21,4,25
2021-10-04 10:30:21,0.22127314814814814,1,0,128,128
2021-10-04 10:30:50,0.2722453703703704,1,0,5,5
2021-10-04 15:57:55,1.1352083333333334,3,17,17,34
2021-10-05 12:09:10,3.590763888888889,2,18,12,30
2021-10-01 18:42:08,0.005046296296296296,1,17,0,17
2021-10-01 14:41:27,0.01085648148148148,1,1,1,2
2022-02-10 10:18:41,58.7790625,250,129719,79368,209087
2021-10-01 13:29:08,0.16236111111111112,4,7,4,11
2021-10-08 07:59:54,13.91494212962963,6,761,248,1009
2021-10-04 18:49:51,3.4797800925925926,2,35,42,77
2021-10-05 13:04:39,4.580706018518518,2,35,30,65
2021-10-08 14:07:09,7.797731481481481,20,3671,849,4520
2022-01-19 11:04:51,110.7754861111111,10,153544,63961,217505
2021-09-30 15:32:41,0.02851851851851852,1,2,0,2
2021-09-30 16:52:53,0.19622685185185185,1,142,125,267
2021-09-30 19:44:33,0.3449652777777778,1,4,2,6
2021-10-06 07:20:42,6.101388888888889,4,13,22,35
2021-09-30 16:26:49,0.6933796296296296,1,43,15,58
2021-10-01 17:36:58,1.9072685185185185,1,2,2,4
2021-09-30 16:55:21,0.9632291666666667,3,67,38,105
2021-09-29 18:13:46,7.103229166666667,4,26,7,33
2021-09-29 16:07:11,0.01675925925925926,1,15,1,16
2021-09-29 15:48:49,0.019849537037037037,2,31,2,33
2021-10-18 14:16:46,23.19849537037037,31,21615,2984,24599
2021-09-29 15:19:00,0.32653935185185184,5,52,33,85
2021-09-28 22:22:38,0.017013888888888887,1,7,0,7
2021-11-09 12:54:37,41.83277777777778,24,1935,534,2469
2021-09-29 08:30:00,0.7495023148148148,1,16,0,16
2021-09-29 11:47:35,0.9598032407407407,21,178,58,236
2021-09-29 20:45:19,1.8342013888888888,2,2,0,2
2021-09-28 18:21:17,0.9540856481481481,1,1,1,2
2021-09-27 19:26:55,0.01923611111111111,1,3,1,4
2021-10-07 10:07:02,36.99472222222222,6,64593,11527,76120
2021-09-27 11:33:08,0.03173611111111111,1,1,1,2
2021-10-05 09:15:19,8.030451388888888,1,220,164,384
2021-09-26 19:58:23,0.01747685185185185,1,35,17,52
2021-09-27 10:29:12,1.115925925925926,2,5,5,10
2021-09-26 07:02:46,0.18510416666666665,1,1,0,1
2021-09-25 19:20:21,0.07378472222222222,1,1,0,1
2021-09-25 16:47:39,0.6039467592592592,1,4,2,6
2021-09-26 16:51:40,1.8106712962962963,1,5,6,11
2021-09-27 11:43:38,2.695,1,1,1,2
2021-09-24 16:32:36,0.003761574074074074,1,2,8,10
2021-09-24 13:51:46,0.14710648148148148,5,136,102,238
2021-09-24 12:57:49,0.1171412037037037,1,51,0,51
2022-01-29 12:42:37,127.41695601851852,27,189936,71913,261849
2021-09-24 11:38:17,0.15253472222222222,1,12,0,12
2021-10-29 09:34:18,37.75625,31,845,280,1125
2021-10-01 16:52:45,7.713981481481482,10,2839,764,3603
2021-10-29 13:19:02,38.644444444444446,19,38802,4336,43138
2021-09-23 20:56:34,0.20957175925925925,1,1,1,2
2021-09-23 21:04:15,37.0515625,15,1020,262,1282
2021-09-29 13:50:16,6.329305555555556,4,18,22,40
2021-09-23 21:08:30,0.9095949074074074,1,37,38,75
2021-09-22 23:02:54,0.009085648148148148,1,9,4,13
2021-09-22 19:33:18,0.00920138888888889,2,9,4,13
2021-09-22 21:18:13,0.23131944444444444,1,5,0,5
2021-09-22 09:02:54,0.04349537037037037,3,31,19,50
2021-09-22 13:14:29,0.28052083333333333,10,1696,1695,3391
2021-09-21 22:28:43,0.014155092592592592,1,0,1,1
2021-09-22 15:51:53,0.7925347222222222,1,12,11,23
2021-09-22 22:36:24,1.0921296296296297,1,1,1,2
2021-09-26 07:03:46,4.597627314814815,5,5673,796,6469
2021-09-21 21:36:13,0.2078935185185185,1,4,4,8
2021-09-22 13:14:55,0.8629745370370371,1,1,1,2
2021-09-27 13:47:08,5.9596527777777775,11,180,74,254
2021-09-22 20:17:57,1.3002314814814815,8,7930,674,8604
2021-09-21 13:11:26,0.0362962962962963,1,14,14,28
2021-09-30 11:08:08,9.021342592592593,11,227,336,563
2021-09-21 22:29:38,0.5656712962962963,2,85,5,90
2021-10-26 22:02:58,35.653506944444445,2,9,2,11
2021-09-21 16:05:05,0.5433217592592593,1,8,8,16
2021-09-21 17:13:30,0.7948726851851852,4,320,28,348
2021-09-22 11:51:38,1.6837962962962962,12,621,399,1020
2021-09-21 06:50:33,0.7548726851851851,8,101,18,119
2021-09-20 15:11:04,0.02232638888888889,1,1,1,2
2021-09-21 14:10:13,2.8344212962962962,8,236,249,485
2021-09-21 13:04:49,1.1116087962962964,6,1475,7,1482
2021-09-20 07:52:26,0.007893518518518518,1,1,1,2
2021-09-20 19:01:35,0.5770949074074074,1,17,11,28
2021-09-20 16:31:46,0.7877199074074074,1,1,1,2
2021-09-20 19:10:33,0.9040972222222222,1,1,1,2
2021-09-20 11:53:32,0.8276736111111112,2,5,3,8
2021-09-24 08:31:23,4.970347222222222,1,5,5,10
2021-09-20 11:50:03,1.800162037037037,1,2,1,3
2021-11-30 12:06:55,73.89351851851852,28,71436,8256,79692
2021-09-17 19:35:34,0.0019328703703703704,1,2,2,4
2021-09-17 19:36:23,0.03707175925925926,1,4,4,8
2021-09-17 14:44:33,0.08133101851851852,5,21,20,41
2021-09-24 05:01:11,7.544409722222222,33,10007,1934,11941
2021-09-17 14:21:59,0.23056712962962964,7,1613,1569,3182
2021-09-17 14:57:28,0.7282291666666667,1,1,1,2
2021-09-17 15:05:49,0.6358217592592592,1,2,2,4
2021-09-17 15:39:36,0.8576157407407408,1,6,6,12
2021-09-16 17:00:59,0.9578356481481481,4,34,19,53
2021-09-16 15:33:09,0.02167824074074074,1,2,2,4
2021-09-16 19:13:01,0.1928587962962963,5,44,7,51
2021-09-16 18:02:55,0.2655439814814815,3,92,11,103
2021-09-24 06:52:15,7.856608796296296,1,8,4,12
2021-12-03 07:39:10,77.97097222222222,14,57921,6251,64172
2021-09-16 08:07:47,0.027372685185185184,1,21,30,51
2021-09-16 00:18:34,0.006400462962962963,1,5,4,9
2021-09-16 19:12:17,0.8354050925925925,3,168,68,236
2021-09-16 15:55:37,0.7062847222222223,1,8,4,12
2021-09-16 07:07:20,0.3910763888888889,1,14,6,20
2021-09-16 14:35:57,0.8571180555555555,2,12,5,17
2021-10-05 12:19:47,26.89068287037037,13,19687,4620,24307
2021-09-16 20:30:05,1.382650462962963,3,14,3,17
2021-09-23 16:15:28,120.65162037037037,5,34,17,51
2021-10-04 11:37:09,19.452824074074073,26,9786,1155,10941
2021-09-23 15:01:51,132.7324074074074,5,201,48,249
2021-09-14 17:33:41,0.007627314814814815,2,26,22,48
2021-09-15 05:33:53,0.5469444444444445,1,20,20,40
2021-09-15 13:25:03,0.9104745370370371,4,107,96,203
2021-09-21 19:39:37,25.315590277777776,30,6853,3226,10079
2021-09-14 13:36:41,0.1299537037037037,1,1,0,1
2021-09-15 17:03:57,1.2883333333333333,5,2328,1928,4256
2021-09-13 20:17:29,0.04684027777777778,7,303,28,331
2021-09-13 12:02:23,0.04358796296296296,2,26,7,33
2021-09-14 15:27:32,1.204351851851852,2,8,3,11
2021-09-13 11:32:32,0.04997685185185185,2,3,0,3
2021-09-13 10:48:55,0.012650462962962962,1,16,1,17
2021-09-13 11:07:59,0.053391203703703705,1,6,2,8
2021-09-13 09:30:10,0.011342592592592593,1,4,0,4
2021-09-13 08:08:38,0.01659722222222222,1,1,1,2
2021-09-13 05:48:50,0.8006712962962963,1,1,1,2
2021-09-15 11:08:42,4.230231481481481,2,26,74,100
2021-09-13 11:31:35,2.3236805555555557,2,16,5,21
2021-09-13 07:06:08,2.4144328703703706,1,1,0,1
2021-09-10 16:19:10,0.009652777777777777,2,3,3,6
2021-09-21 11:34:20,10.900868055555556,10,8589,475,9064
2021-09-14 16:07:36,4.094513888888889,5,2801,641,3442
2021-09-10 13:49:17,2.026423611111111,4,15,9,24
2021-09-10 13:27:16,0.20186342592592593,7,184,99,283
2021-11-30 16:51:48,81.44844907407408,51,4547,1904,6451
2021-09-24 13:14:24,14.390891203703704,4,4458,2068,6526
2021-09-20 15:50:54,10.506099537037038,7,6543,2393,8936
2021-09-14 12:02:15,4.677650462962963,9,240,57,297
2021-09-10 06:15:57,0.4401967592592593,1,2,2,4
2021-09-14 08:11:55,4.640358796296296,2,3,1,4
2021-09-09 14:54:08,1.0714583333333334,4,23,13,36
2021-11-09 12:49:54,61.00674768518518,23,72143,10282,82425
2021-09-09 12:00:06,0.7851736111111111,3,9,9,18
2021-09-09 17:36:09,0.3221412037037037,1,55,1,56
2021-09-10 17:22:20,1.449861111111111,3,158,511,669
2021-09-17 14:28:28,8.418252314814815,7,96,46,142
2021-09-09 17:04:38,0.8539930555555556,1,79,21,100
2021-09-08 18:24:10,0.05188657407407407,2,4,4,8
2021-09-08 16:51:51,0.06429398148148148,1,10,14,24
2021-09-08 14:06:05,0.03809027777777778,2,10,5,15
2021-09-08 13:09:22,0.031296296296296294,1,2,5,7
2021-09-08 15:26:07,0.17858796296296298,1,1,1,2
2021-09-08 07:27:19,0.006412037037037037,1,1,1,2
2021-09-08 08:09:44,0.14725694444444445,6,487,478,965
2021-09-07 20:47:52,0.015127314814814816,1,1,0,1
2021-09-20 17:59:21,13.041539351851851,10,431,45,476
2021-09-23 02:33:09,19.01462962962963,11,320,240,560
2021-09-08 12:03:36,4.829965277777778,10,254,120,374
2021-09-08 11:45:36,0.781724537037037,1,1,1,2
2021-09-07 09:58:45,0.35758101851851853,3,4,6,10
2021-09-07 20:57:58,1.0270717592592593,3,115,57,172
2021-09-06 21:19:02,0.09032407407407407,1,2,2,4
2021-09-06 16:16:26,0.014537037037037038,1,2,0,2
2021-09-07 14:45:45,1.0183101851851852,1,41,8,49
2021-09-06 14:09:24,0.03346064814814815,1,2,0,2
2021-09-06 14:11:23,0.035625,4,48,15,63
2021-09-06 13:17:54,0.2832060185185185,1,1,0,1
2021-09-08 08:51:13,2.1339930555555555,2,45,6,51
2021-09-07 14:51:04,2.1449189814814815,3,60,36,96
2021-10-25 11:42:53,50.09449074074074,12,31928,3715,35643
2021-09-06 12:55:14,1.8156597222222222,2,159,138,297
2021-09-06 21:32:24,2.2298032407407407,1,2,0,2
2021-09-14 15:15:19,10.011145833333334,17,3466,888,4354
2021-09-08 15:48:00,4.6571643518518515,1,2,2,4
2021-12-14 10:04:43,101.70910879629629,2,5,5,10
2021-09-06 17:19:30,3.175763888888889,2,80,15,95
2021-09-06 12:51:45,3.0014814814814814,1,2,2,4
2021-09-06 21:12:43,3.372662037037037,1,2,2,4
2021-09-08 12:28:22,5.0865277777777775,2,51,17,68
2021-09-09 18:23:52,6.342118055555556,2,40,8,48
2021-09-02 16:47:09,0.0006365740740740741,1,2,2,4
2021-09-02 16:11:26,0.0014699074074074074,1,4,4,8
2021-11-30 10:07:56,88.76799768518518,39,5285,562,5847
2021-09-02 09:32:18,0.09972222222222223,1,2,2,4
2021-09-02 11:49:13,0.27532407407407405,2,7,7,14
2021-09-02 00:54:50,0.006469907407407408,1,7,3,10
2021-09-01 21:12:01,0.0012731481481481483,1,1,0,1
2021-09-01 16:33:54,0.024872685185185185,2,2,1,3
2021-09-02 09:37:42,0.771712962962963,1,10,7,17
2021-09-01 15:11:32,0.016307870370370372,1,2,1,3
2021-09-01 15:10:49,0.013784722222222223,1,3,0,3
2021-09-02 07:46:06,0.7096296296296296,1,9,0,9
2021-09-01 14:57:44,0.017152777777777777,1,4,0,4
2021-09-01 14:43:00,0.23385416666666667,1,1,1,2
2021-09-01 10:57:43,0.0006481481481481481,1,1,1,2
2021-09-22 23:00:47,21.51101851851852,4,30,6,36
2021-09-01 15:09:02,0.20810185185185184,2,3,0,3
2021-09-09 04:42:57,7.8440625,12,988,239,1227
2021-09-01 07:37:51,0.0008564814814814815,1,1,1,2
2021-09-01 11:54:28,0.6141666666666666,1,32,14,46
2021-11-09 09:44:29,69.68866898148148,35,1687,161,1848
2021-08-31 13:01:35,0.007094907407407407,3,15847,496,16343
2021-09-01 08:44:31,1.0047916666666667,3,28,4,32
2021-09-01 08:43:09,1.0069328703703704,2,28,5,33
2021-09-01 08:42:22,1.0044097222222221,2,27,4,31
2021-09-01 08:41:47,1.016851851851852,2,27,4,31
2021-08-31 10:28:37,0.299375,1,6,5,11
2021-09-01 08:03:48,1.4679976851851853,9,6396,446,6842
2021-08-31 07:57:01,0.4995601851851852,6,26,4,30
2021-08-31 12:42:00,0.7290046296296296,4,57,39,96
2021-08-31 10:34:31,0.657349537037037,1,19,11,30
2021-08-30 16:09:14,0.011550925925925926,2,3,3,6
2021-08-30 15:55:18,0.011793981481481482,2,10,4,14
2021-08-30 14:35:10,0.004201388888888889,1,9,0,9
2021-08-30 13:43:23,0.0125,1,3,3,6
2021-08-30 12:16:18,1.047824074074074,9,1312,111,1423
2021-08-30 16:39:06,1.9410185185185185,5,25,13,38
2021-08-28 14:22:29,0.17944444444444443,3,23,15,38
2021-08-30 13:59:17,2.155266203703704,1,1,0,1
2021-08-31 09:08:22,3.4472222222222224,7,247,56,303
2021-08-30 14:45:57,2.8772106481481483,2,11,8,19
2021-08-31 10:01:12,3.7164930555555555,1,1,1,2
2021-09-10 12:47:49,29.911261574074075,26,2024,1755,3779
2021-08-27 15:38:34,100.27157407407407,14,109225,28168,137393
2021-08-30 10:02:08,2.8022685185185185,1,3,0,3
2021-08-30 10:03:02,103.03856481481482,28,196673,50015,246688
2021-08-27 15:22:06,0.05320601851851852,2,11,5,16
2021-08-27 13:46:12,0.12195601851851852,4,253,379,632
2021-08-27 10:26:17,0.03181712962962963,2,87,27,114
2021-08-30 15:29:28,3.2965162037037037,6,1499,59,1558
2022-01-18 12:24:13,145.40810185185185,114,251548,96547,348095
2021-08-31 10:19:04,4.301388888888889,12,1624,638,2262
2021-08-31 10:49:05,4.324479166666666,1,1,1,2
2021-08-27 09:24:57,0.7453935185185185,2,188,116,304
2021-08-26 15:30:04,0.032094907407407405,3,85,49,134
2021-08-26 14:26:59,0.03150462962962963,1,38,7,45
2021-08-26 14:09:53,0.005462962962962963,1,2,2,4
2021-08-26 14:09:48,0.01957175925925926,1,38,7,45
2021-08-26 13:09:58,0.016689814814814814,1,204,150,354
2021-08-26 12:47:11,0.07724537037037037,2,74,83,157
2021-08-26 10:13:48,0.0023148148148148147,1,1,1,2
2021-08-26 10:37:55,0.023159722222222224,2,245,219,464
2021-08-30 10:04:31,4.014479166666667,1,1,0,1
2021-08-27 13:09:57,2.8988425925925925,7,93,63,156
2021-08-26 09:52:49,0.04724537037037037,1,200,158,358
2022-02-18 13:17:09,177.0154513888889,72,24888,7493,32381
2021-08-25 16:14:44,0.0062268518518518515,1,17,14,31
2021-08-26 08:32:58,0.6968518518518518,4,30,18,48
2021-08-26 15:25:21,115.87804398148148,19,457,177,634
2021-08-25 16:14:03,0.12547453703703704,1,2,1,3
2021-08-25 16:41:27,0.2513078703703704,1,1,1,2
2021-08-25 16:56:25,0.2864583333333333,1,2,1,3
2021-08-25 16:56:16,0.2924421296296296,2,4,2,6
2021-08-25 16:56:08,0.30496527777777777,1,7,0,7
2021-08-25 09:32:51,0.00980324074074074,1,1,0,1
2021-08-26 08:29:15,1.1783449074074075,3,27,2,29
2021-08-30 12:18:51,5.350856481481482,2,5,3,8
2021-08-31 10:47:23,6.317719907407407,1,5,2,7
2021-09-01 13:05:40,27.915590277777778,14,510,213,723
2021-08-24 11:55:22,0.03498842592592592,1,2,2,4
2021-08-30 12:08:16,55.61365740740741,5,40943,10902,51845
2021-08-24 13:52:39,0.7062847222222223,1,1,1,2
2021-08-24 07:05:33,0.5789236111111111,2,22,9,31
2021-08-23 17:16:49,0.001388888888888889,1,7,0,7
2021-10-12 22:10:34,56.510162037037034,90,5080,1543,6623
2021-09-09 15:26:16,17.270983796296296,12,320,140,460
2021-09-02 06:45:57,11.323090277777778,2,5,6,11
2021-08-30 17:01:06,9.815439814814814,11,6348,1741,8089
2021-08-30 11:46:55,8.741412037037037,1,82,0,82
2021-08-30 12:09:15,8.971388888888889,3,405,66,471
2021-08-23 11:27:24,2.312349537037037,1,3,3,6
2021-08-24 09:43:42,3.3331944444444446,5,5370,1259,6629
2021-12-01 02:00:47,109.0996412037037,48,109519,11958,121477
2021-08-30 15:19:50,10.030243055555555,1,3,3,6
2021-08-30 15:40:25,10.350081018518518,11,17,17,34
2021-08-30 10:09:25,10.31045138888889,1,2,2,4
2021-08-30 15:12:35,11.684861111111111,1,3,0,3
2021-09-01 11:33:31,105.10140046296296,69,224774,52713,277487
2021-08-24 13:01:01,5.135821759259259,34,337,349,686
2021-08-23 07:41:36,3.7712731481481483,1,6,0,6
2021-08-23 08:18:07,4.0421875,7,27,22,49
2021-09-02 09:58:23,14.068344907407408,42,39321,3130,42451
2021-08-19 12:29:52,0.9379050925925926,4,47,50,97
2021-08-18 14:18:14,0.019097222222222224,2,35,9,44
2021-08-23 16:08:33,5.477916666666666,1,1,1,2
2021-08-27 17:52:51,10.190335648148148,11,3274,1589,4863
2021-08-31 10:51:25,13.92199074074074,2,15,28,43
2021-08-27 09:35:45,10.013483796296295,2,26,8,34
2021-08-23 16:07:42,6.5001851851851855,1,0,14,14
2021-09-01 12:03:17,15.703402777777777,1,1,0,1
2021-08-16 15:40:38,0.0071875,3,7,2,9
2021-09-02 19:29:42,17.967662037037037,18,720,191,911
2021-08-20 09:01:54,5.815081018518518,2,2,8,10
2021-08-16 08:17:37,1.065625,1,1,1,2
2021-08-16 16:36:08,1.8032291666666667,1,1,1,2
2021-08-31 10:32:47,17.76306712962963,7,2151,45,2196
2021-08-17 08:11:58,3.723888888888889,4,44,72,116
2021-08-16 13:45:19,2.9244560185185184,3,23,23,46
2021-08-26 07:50:45,12.898101851851852,7,830,813,1643
2021-08-13 06:57:30,0.004930555555555555,1,1,1,2
2021-08-13 08:45:53,0.7055555555555556,6,58,63,121
2021-08-13 06:14:04,0.6438194444444445,4,50,35,85
2021-08-31 12:06:49,18.900729166666668,36,2268,1037,3305
2021-08-12 14:45:06,0.01949074074074074,3,8,8,16
2021-08-12 12:59:02,0.10486111111111111,4,67,447,514
2021-08-12 13:05:01,0.039560185185185184,2,18,7,25
2021-11-11 09:15:20,90.99043981481482,36,55052,5809,60861
2021-08-12 09:38:14,0.004895833333333334,3,2155,140,2295
2021-09-17 14:07:52,36.239074074074075,3,12,6,18
2021-08-12 16:45:54,0.7838425925925926,5,138,128,266
2021-08-11 16:09:42,0.017916666666666668,4,8,4,12
2021-08-12 12:49:46,0.8826157407407408,4,2180,144,2324
2021-08-12 07:42:25,0.7829398148148148,6,81,54,135
2021-08-12 07:37:32,0.7038078703703704,1,1,1,2
2021-08-12 09:23:01,0.8012152777777778,1,2,1,3
2021-08-11 11:45:25,0.9216319444444444,7,190,154,344
2021-09-30 16:48:56,50.37153935185185,5,54951,6364,61315
2021-08-12 12:19:48,1.6977893518518519,2,6,6,12
2021-08-10 16:37:01,0.0005324074074074074,1,49,46,95
2021-08-10 14:17:06,0.0016782407407407408,1,4,1,5
2021-08-10 10:20:04,0.02396990740740741,2,15,5,20
2021-08-09 17:17:06,0.012824074074074075,1,1,1,2
2021-08-10 16:39:48,1.0094907407407407,2,8,4,12
2021-08-23 12:35:18,13.843680555555556,27,7316,1151,8467
2021-08-10 12:54:52,0.9196296296296296,5,426,35,461
2021-08-13 10:24:53,3.932071759259259,3,43,14,57
2021-08-16 14:02:35,7.1082986111111115,1,1,8,9
2021-08-10 07:36:44,0.9354976851851852,4,5,4,9
2021-08-09 12:56:05,0.10770833333333334,4,47,6,53
2021-08-09 13:51:49,0.15931712962962963,3,31,1,32
2021-09-20 11:24:31,42.801759259259256,89,65409,10338,75747
2021-08-10 07:29:35,1.8848726851851851,2,13,6,19
2021-08-06 18:41:39,0.14126157407407408,9,84,54,138
2021-08-06 16:41:34,0.1647685185185185,1,2,2,4
2021-09-06 14:30:13,47.08128472222222,33,64384,12509,76893
2021-08-09 11:37:50,82.10439814814815,29,89625,23998,113623
2021-08-06 11:12:30,0.8668634259259259,23,1581,2648,4229
2021-08-31 15:53:02,26.94798611111111,133,47108,12201,59309
2021-08-12 07:57:34,6.715335648148148,1,1,1,2
2021-08-06 13:37:29,62.929837962962964,3,17,26,43
2021-08-06 13:46:26,1.1329050925925925,3,131,62,193
2021-08-05 13:55:14,0.08271990740740741,1,1,1,2
2021-08-06 09:21:38,79.00981481481482,25,89365,23944,113309
2021-08-23 15:57:30,18.785081018518518,35,1804,361,2165
2021-08-05 16:38:50,0.8556018518518519,9,267,83,350
2021-08-05 06:56:13,0.4565625,1,1,1,2
2021-08-31 12:21:39,26.765520833333333,1,2,2,4
2021-08-04 13:49:21,0.07908564814814815,2,2,2,4
2021-08-04 16:29:23,7.0376157407407405,28,3625,2407,6032
2021-08-04 14:03:14,1.0841898148148148,5,203,24,227
2021-08-04 14:00:09,1.1036921296296296,3,429,451,880
2021-08-03 08:10:34,0.6692708333333334,6,22,7,29
2021-08-03 06:28:25,0.9807986111111111,1,76,76,152
2021-08-02 06:26:38,0.01716435185185185,1,13,2,15
2021-08-02 10:58:43,0.5896759259259259,2,10,10,20
2021-08-12 09:01:26,12.548263888888888,11,2040,55,2095
2021-08-01 06:35:47,1.1887847222222223,1,1,0,1
2021-08-08 14:06:05,8.541574074074074,2,2,2,4
2021-08-17 12:29:02,78.92873842592593,74,98076,26683,124759
2021-08-02 06:08:57,2.6285300925925927,1,1,1,2
2021-07-30 13:31:29,0.008587962962962962,1,10,3,13
2021-07-30 12:56:14,0.05197916666666667,6,845,422,1267
2021-07-30 12:20:39,1.7832523148148147,2,439,84,523
2021-07-30 16:27:53,0.30854166666666666,1,2,2,4
2021-08-13 10:04:18,24.689664351851853,8,376,313,689
2021-08-04 09:48:39,5.781122685185185,5,13,9,22
2021-07-29 19:05:16,0.24210648148148148,3,142,17,159
2021-07-29 16:02:29,0.7617476851851852,14,56,28,84
2021-07-28 15:37:21,0.04041666666666666,1,4,1,5
2021-07-28 13:38:12,0.00866898148148148,1,8,0,8
2021-07-28 13:47:49,0.020497685185185185,1,45,0,45
2021-07-28 17:01:38,0.1753587962962963,1,2,0,2
2021-07-28 11:45:30,0.7876504629629629,1,1,1,2
2021-07-28 16:47:16,1.0184143518518518,1,1,1,2
2021-07-27 14:18:04,0.01653935185185185,2,4,4,8
2021-08-05 08:12:13,9.664606481481481,11,537,260,797
2021-07-28 18:11:39,1.244675925925926,2,11,13,24
2021-07-28 18:16:35,1.6345254629629629,1,1,1,2
2021-07-28 18:17:20,1.686261574074074,1,1,1,2
2021-07-27 12:37:46,0.4911111111111111,3,16,12,28
2021-07-28 01:01:40,1.0317013888888888,5,17,13,30
2021-07-28 18:17:57,1.7951273148148148,1,1,1,2
2021-07-26 21:10:34,0.06090277777777778,1,4,3,7
2021-08-13 08:12:59,17.616689814814816,5,12802,5413,18215
2021-07-28 18:19:34,2.1207523148148146,1,1,1,2
2021-07-26 14:11:25,0.01037037037037037,1,2,2,4
2021-07-26 13:57:34,0.002916666666666667,1,6,0,6
2021-09-08 15:17:32,47.08056712962963,41,53647,9587,63234
2021-07-26 14:15:52,2.9049537037037036,3,513,842,1355
2021-07-23 15:05:48,0.015381944444444445,1,0,2,2
2021-07-23 12:16:04,65.13094907407407,19,33876,14459,48335
2021-07-30 07:06:34,6.962314814814815,2,6673,1012,7685
2021-07-26 12:30:53,3.322858796296296,1,4,0,4
2021-08-04 15:58:30,12.898773148148148,1,6,3,9
2021-07-29 17:35:55,10.28630787037037,12,252,123,375
2021-07-21 22:11:02,0.10591435185185186,2,7,3,10
2021-07-22 06:14:15,0.568599537037037,1,1,1,2
2021-07-21 16:44:41,0.001875,1,2,1,3
2021-07-21 17:49:29,0.05320601851851852,5,12,11,23
2021-08-18 14:51:54,28.25021990740741,2,23421,7912,31333
2021-07-21 10:37:49,0.2760763888888889,4,20,14,34
2021-07-21 16:36:03,0.6388541666666666,1,15,4,19
2021-07-21 08:13:11,0.7653819444444444,2,1276,1220,2496
2021-07-21 12:29:43,0.9493287037037037,2,28,9,37
2021-07-20 13:28:50,0.05306712962962963,1,102,3,105
2021-07-20 12:17:21,62.131840277777776,19,76451,19570,96021
2021-09-01 14:32:57,43.1459375,23,216,117,333
2021-07-23 15:53:31,65.28195601851851,30,34342,14593,48935
2021-08-23 07:44:42,33.9906712962963,2,64,10,74
2021-07-26 13:48:19,6.245555555555556,2,10,8,18
2021-07-20 16:05:27,0.9053356481481482,6,25,16,41
2021-07-26 12:30:05,6.828703703703703,13,190,45,235
2021-07-20 07:32:02,0.6515162037037037,1,16,0,16
2021-07-19 17:50:48,0.23719907407407406,4,34,14,48
2021-07-22 13:19:35,6.178703703703704,8,338,156,494
2021-08-04 14:31:23,77.22491898148148,20,32355,13366,45721
2021-07-19 08:55:40,0.002824074074074074,1,1,1,2
2021-07-17 13:52:33,0.20271990740740742,1,70,29,99
2021-07-30 07:11:31,13.2596875,2,2,2,4
2021-07-16 17:07:09,58.33309027777778,18,31722,13096,44818
2021-07-16 16:26:54,0.13393518518518518,3,14,6,20
2021-07-16 13:09:15,0.0831712962962963,4,15,11,26
2021-07-16 11:14:59,0.0010532407407407407,1,1,1,2
2021-09-02 05:49:49,48.03826388888889,1,6,3,9
2021-07-16 09:54:49,0.48443287037037036,1,1,0,1
2021-07-19 08:32:41,3.492777777777778,2,31,2,33
2021-07-15 20:40:25,57.481192129629626,22,76455,19573,96028
2021-07-15 16:59:48,0.022581018518518518,1,4,4,8
2021-07-15 15:40:17,0.09927083333333334,1,1,1,2
2021-07-15 13:14:12,0.0011226851851851851,1,1,0,1
2021-07-15 13:06:48,0.000925925925925926,1,1,0,1
2021-07-15 15:39:35,0.11769675925925926,1,1,1,2
2021-07-15 12:29:50,0.0007986111111111112,1,1,1,2
2021-07-15 15:48:50,0.14400462962962962,2,6,5,11
2021-07-15 15:48:37,0.23440972222222223,1,1,1,2
2021-07-15 13:06:12,0.12340277777777778,1,10,4,14
2021-07-15 15:49:02,0.2732175925925926,1,1,3,4
2021-07-15 16:39:34,0.6741550925925925,1,12,0,12
2021-07-15 23:18:57,0.9876273148148148,4,24,7,31
2021-07-15 06:42:37,56.89938657407407,18,30209,13000,43209
2021-07-14 22:18:02,0.03702546296296296,2,5,2,7
2021-07-15 06:44:03,0.3992361111111111,1,2,2,4
2021-07-21 12:24:37,6.6382060185185185,7,2623,1431,4054
2021-07-15 16:38:51,0.8384722222222222,1,43,0,43
2021-07-14 20:04:58,0.04949074074074074,2,22,39,61
2021-07-15 08:17:47,0.5949305555555555,1,2,0,2
2021-07-14 14:59:14,0.0673263888888889,2,11,2,13
2021-07-14 14:30:19,0.03181712962962963,1,7,6,13
2021-07-14 14:15:25,0.07225694444444444,6,76,28,104
2021-07-15 15:35:39,1.1947800925925927,8,379,25,404
2021-07-14 11:17:34,0.4706018518518518,4,3,25,28
2021-07-14 03:18:51,0.17038194444444443,1,12,11,23
2021-07-20 11:38:26,6.599641203703704,2,41,0,41
2021-07-13 19:13:18,0.10476851851851852,3,22,20,42
2021-07-13 16:08:16,0.01646990740740741,1,3,3,6
2021-07-14 07:35:18,0.7876736111111111,1,2,2,4
2021-07-13 12:40:27,0.14144675925925926,6,21,15,36
2021-08-24 18:34:05,42.77488425925926,1,2,1,3
2021-07-13 16:19:04,0.7354861111111111,5,32,22,54
2021-07-13 18:08:25,0.9466898148148148,6,739,50,789
2021-07-13 14:15:15,0.8107175925925926,5,238,77,315
2021-07-12 17:50:12,0.0003587962962962963,1,1,1,2
2021-07-13 17:53:30,55.36527777777778,25,32645,14108,46753
2021-07-12 19:24:59,0.11528935185185185,1,5,3,8
2021-07-12 16:02:52,0.04344907407407408,1,5,383,388
2021-07-12 15:42:59,0.03576388888888889,1,3,1,4
2021-07-13 10:31:56,0.8342592592592593,2,9,1,10
2021-07-12 15:15:54,0.056712962962962965,3,260,155,415
2021-07-13 06:53:06,0.7096759259259259,1,1,1,2
2021-07-12 15:51:35,0.1065625,2,16,680,696
2021-07-12 13:47:06,0.019386574074074073,1,2,0,2
2021-07-12 13:11:32,0.009212962962962963,3,4,0,4
2021-07-12 16:03:13,0.16238425925925926,1,1,1,2
2021-07-14 14:56:55,6.812268518518518,49,676,174,850
2021-07-12 16:24:32,0.36755787037037035,1,1,1,2
2021-07-12 09:48:43,0.12090277777777778,1,2,2,4
2021-07-13 12:39:57,1.6367361111111112,6,22,22,44
2021-07-12 06:45:14,1.0541087962962963,1,4,0,4
2021-07-12 11:51:59,2.110474537037037,1,3,0,3
2021-07-10 01:48:28,0.030625,1,1,4,5
2021-07-17 13:52:22,8.693993055555556,12,22854,5701,28555
2021-07-12 14:58:38,2.8524652777777777,7,762,59,821
2021-07-09 17:28:57,51.34822916666667,12,24087,11413,35500
2021-07-09 17:01:58,51.32949074074074,11,24052,11395,35447
2021-07-09 16:33:04,51.30942129629629,11,24010,11394,35404
2021-07-26 14:21:26,16.978564814814813,4,28,3,31
2021-07-09 13:24:43,0.012256944444444445,1,13,1,14
2021-07-09 12:51:28,51.15553240740741,11,24006,11397,35403
2021-08-30 10:35:42,54.929085648148146,114,13692,5609,19301
2021-07-12 06:46:23,3.2663078703703703,1,2,2,4
2021-07-08 21:11:01,0.017673611111111112,1,3,3,6
2021-07-12 17:19:54,4.2120138888888885,11,416,82,498
2021-07-09 10:42:13,51.06577546296296,24,24012,11443,35455
2021-07-09 06:52:30,0.6145023148148148,1,20,1,21
2021-07-08 15:12:18,0.013680555555555555,1,7,32,39
2021-07-14 17:25:44,6.116701388888889,9,885,85,970
2021-07-09 13:02:34,1.7328587962962962,7,153,162,315
2021-07-08 15:17:51,47.97435185185185,10,63547,15179,78726
2021-07-07 22:05:47,0.04972222222222222,1,0,4,4
2021-07-08 11:20:46,0.8060648148148148,3,185,1115,1300
2021-07-07 17:20:28,0.0009606481481481482,1,4,0,4
2021-08-09 06:11:17,32.58393518518518,1,1,1,2
2021-07-07 16:50:42,0.09607638888888889,2,4,2,6
2021-07-08 11:24:46,0.8804861111111111,1,2,1,3
2021-07-07 14:30:47,0.013668981481481482,1,18,0,18
2021-07-07 13:43:44,49.191828703703706,10,70484,16362,86846
2021-07-08 11:23:41,0.9226388888888889,1,20,10,30
2021-07-07 12:07:46,0.11579861111111112,1,8,4,12
2021-07-09 07:36:05,1.9487152777777779,6,53,26,79
2021-07-08 08:17:34,1.1914814814814816,2,14,2,16
2021-07-07 06:20:31,0.47333333333333333,2,49,28,77
2021-07-06 18:41:51,48.398854166666666,12,17597,10108,27705
2021-07-06 15:31:45,0.004699074074074074,1,1,1,2
2021-07-06 14:12:16,0.009432870370370371,1,25,25,50
2021-07-10 00:38:28,4.024525462962963,1,16,6,22
2021-07-10 00:39:09,12.212824074074074,7,9041,1069,10110
2021-07-05 22:49:47,47.57103009259259,7,66529,16123,82652
2021-07-06 05:42:47,0.46293981481481483,2,127,16,143
2021-07-07 13:05:44,1.8238310185185185,13,381,139,520
2021-07-05 17:35:22,47.35268518518519,6,66503,16112,82615
2021-07-05 17:21:00,47.342708333333334,5,66501,16110,82611
2021-07-05 17:14:50,47.338425925925925,7,66505,16114,82619
2021-07-07 15:17:31,2.026111111111111,1,18,28,46
2021-07-07 08:32:49,1.7961458333333333,1,7,0,7
2021-07-05 14:03:14,0.0440625,1,1,1,2
2021-07-05 07:51:12,0.00042824074074074075,1,1,0,1
2021-07-05 12:35:21,0.39922453703703703,1,6,0,6
2021-07-06 15:44:48,148.95930555555555,3,38,11,49
2021-07-06 13:25:18,2.3326967592592593,4,1071,10,1081
2021-07-05 07:56:44,1.7059259259259258,4,1174,15,1189
2021-07-20 11:36:47,17.70564814814815,1,4,1,5
2021-07-02 08:35:10,0.010902777777777779,1,1,1,2
2021-07-13 19:07:33,11.593229166666667,28,1029,8296,9325
2021-07-02 06:29:52,0.5244907407407408,1,19,7886,7905
2021-07-05 14:13:10,47.21226851851852,26,58437,8648,67085
2021-07-05 14:42:18,3.8955787037037037,8,570,33,603
2021-07-02 18:35:18,1.0886921296296297,5,468,7964,8432
2021-07-01 16:52:00,0.02466435185185185,2,13,1,14
2021-07-02 06:57:40,0.6802199074074075,1,1,1,2
2021-07-01 14:19:23,0.010104166666666666,1,1,1,2
2021-07-01 14:17:38,0.015034722222222222,1,8,2,10
2021-07-01 16:11:54,0.11207175925925926,4,42,9,51
2021-08-04 16:24:54,34.122511574074075,1,1,0,1
2021-07-01 17:25:40,0.16619212962962962,4,12,7,19
2021-07-01 12:59:32,43.161134259259256,7,12465,1829,14294
2021-08-04 07:29:35,33.997511574074075,1,1,2,3
2021-07-01 13:26:46,0.2558912037037037,1,84,84,168
2021-07-09 13:24:55,8.479270833333333,4,25,12,37
2021-07-01 10:41:22,43.065185185185186,9,10051,1826,11877
2021-07-01 17:31:19,0.9616087962962963,6,2819,146,2965
2021-06-30 14:58:03,0.012997685185185185,1,10,2,12
2021-09-01 07:49:04,62.77699074074074,64,69456,23158,92614
2021-07-01 10:37:07,1.0011574074074074,3,6010,83,6093
2021-06-30 11:14:11,0.06475694444444445,1,22,2,24
2021-06-30 14:24:06,0.20077546296296298,1,1,1,2
2021-06-30 12:03:58,1.0083564814814814,4,524,63,587
2021-06-30 11:57:05,0.582025462962963,2,7,3,10
2021-06-29 21:59:03,0.027164351851851853,1,1,1,2
2021-06-30 06:41:47,0.48506944444444444,3,65,27,92
2021-06-30 16:10:12,0.960787037037037,11,365,73,438
2021-06-29 15:01:17,0.012083333333333333,1,84,1,85
2021-06-29 12:15:36,0.016435185185185185,1,2,2,4
2021-06-29 11:01:08,41.078912037037036,9,5779,1693,7472
2021-07-01 17:22:42,2.5552199074074076,21,7151,339,7490
2021-06-28 18:43:25,0.010486111111111111,1,8,3,11
2021-06-28 16:18:42,40.29944444444445,9,2665,1321,3986
2021-07-06 07:31:57,7.733321759259259,18,54821,14745,69566
2021-06-29 12:39:48,0.9348726851851852,1,3,3,6
2021-06-28 16:30:06,0.16118055555555555,4,215,224,439
2021-06-29 08:32:33,0.862199074074074,3,77,6,83
2021-06-28 18:23:35,40.38616898148148,13,3129,1620,4749
2021-06-28 11:39:56,2.0486689814814816,2,21,8,29
2021-06-26 16:31:25,0.35509259259259257,1,3,3,6
2021-06-28 16:14:00,2.3927430555555556,4,251,222,473
2021-06-26 03:50:30,0.011331018518518518,1,20,16,36
2021-06-28 15:55:59,2.677337962962963,5,13,6,19
2021-06-25 21:41:08,0.03782407407407407,2,2,2,4
2021-06-29 19:00:08,3.9550578703703705,19,444,115,559
2021-06-25 20:20:16,0.02255787037037037,1,59,59,118
2021-06-25 21:58:42,0.12957175925925926,6,232,195,427
2021-06-28 18:31:44,3.2242592592592594,9,1282,70,1352
2021-06-25 18:12:05,0.0712037037037037,2,12,4,16
2021-06-25 11:49:30,0.009733796296296296,1,1,1,2
2021-06-28 19:11:29,40.41943287037037,38,49233,8352,57585
2021-06-25 21:58:03,0.7825578703703704,3,86,39,125
2021-06-25 14:55:15,0.6214930555555556,6,5,3,8
2021-06-28 11:49:22,3.6625694444444443,1,2,1,3
2021-06-24 16:04:18,0.22671296296296295,1,3,1,4
2021-06-24 10:33:37,0.0005324074074074074,1,12,14,26
2021-06-24 08:13:18,0.01545138888888889,1,2,2,4
2021-06-24 13:52:28,0.3809375,3,26,5,31
2021-08-03 19:02:59,5.9452893518518515,1,2,0,2
2021-07-08 14:58:16,14.932604166666666,3,167,39,206
2021-06-23 17:39:43,0.05371527777777778,1,2,2,4
2021-06-23 16:39:22,0.029849537037037036,2,133,103,236
2021-06-23 16:16:25,0.019710648148148147,1,3,3,6
2021-06-23 15:07:08,0.06505787037037038,1,4,0,4
2021-06-23 13:45:30,0.20327546296296295,1,12,0,12
2021-06-29 03:11:21,6.1525694444444445,20,1539,381,1920
2021-06-23 14:40:54,0.7178472222222222,4,532,51,583
2021-06-22 20:37:05,0.013842592592592592,1,5,5,10
2021-06-28 14:02:54,5.793888888888889,1,30,0,30
2021-06-23 13:50:36,35.19659722222222,12,46624,7348,53972
2021-06-22 18:13:23,0.07517361111111111,2,112,18,130
2021-06-22 17:02:52,34.33011574074074,14,46479,7359,53838
2021-06-23 06:53:09,3.574664351851852,5,48,9,57
2021-06-22 13:58:13,0.08837962962962963,4,61,39,100
2021-07-05 12:53:03,13.146099537037037,6,689,113,802
2021-06-22 12:56:05,0.2646527777777778,1,27,2,29
2021-06-22 02:51:36,0.11484953703703704,6,331,150,481
2021-06-21 23:50:12,0.0203125,1,6,1,7
2021-09-01 08:46:58,82.44361111111111,3,16634,2758,19392
2021-06-22 12:47:31,0.6654745370370371,1,1,1,2
2021-09-01 08:47:25,71.56456018518519,3,15,3,18
2021-06-29 08:15:57,7.649756944444444,3,42,33,75
2021-06-29 07:57:46,7.576712962962963,2,78,3,81
2021-09-01 08:47:58,82.50883101851852,5,57,18,75
2021-06-21 14:54:34,4.148900462962963,3,603,569,1172
2021-06-23 13:51:31,2.158738425925926,2,4,3,7
2021-06-29 07:07:47,10.90787037037037,5,25,31,56
2021-06-21 06:52:12,0.012708333333333334,3,426,428,854
2021-06-22 02:30:50,1.0084606481481482,8,200,59,259
2021-06-30 17:44:23,42.35894675925926,42,64058,9434,73492
2021-08-11 14:10:59,54.93246527777778,9,56873,19574,76447
2021-06-22 22:34:19,4.157881944444444,5,359,27,386
2021-06-21 15:17:00,2.8867708333333333,1,7,1,8
2021-06-21 15:37:13,33.270636574074075,9,44526,6869,51395
2021-06-21 14:56:43,4.150393518518518,7,640,575,1215
2021-06-21 15:37:28,3.056226851851852,5,1182,297,1479
2021-06-21 16:12:12,33.29493055555555,8,44483,6858,51341
2021-06-18 09:29:42,0.9232986111111111,3,570,572,1142
2021-06-18 13:13:46,0.5269328703703704,2,13,11,24
2021-06-18 17:00:20,28.045520833333335,7,37189,5425,42614
2021-07-07 06:50:38,19.492395833333333,19,26704,10174,36878
2021-06-25 17:05:49,8.01795138888889,9,2020,1044,3064
2021-06-23 10:19:31,5.957893518518518,12,1539,742,2281
2021-06-17 15:14:53,0.001712962962962963,1,3,1,4
2021-06-18 07:50:10,0.8541782407407408,2,610,569,1179
2021-07-13 13:17:31,55.17362268518519,7,44070,6749,50819
2021-06-17 19:37:31,0.3248611111111111,4,383,102,485
2021-06-17 15:29:01,0.24466435185185184,3,27,14,41
2021-06-17 15:54:00,0.5133333333333333,4,15,12,27
2021-06-17 16:39:22,0.8566435185185185,3,169,11,180
2021-06-17 07:41:16,0.4883564814814815,1,36,1,37
2021-07-09 17:55:26,22.931655092592592,5,2297,51,2348
2021-06-16 19:14:53,0.06671296296296296,3,5,3,8
2021-06-16 14:28:46,0.07049768518518519,1,2,0,2
2021-06-16 11:24:00,0.13011574074074075,1,23,13,36
2021-06-23 14:11:19,7.590532407407407,14,979,442,1421
2021-06-16 17:17:45,0.8395601851851852,3,57,38,95
2021-06-15 20:16:51,0.006377314814814815,1,6,6,12
2021-06-15 20:03:58,0.12783564814814816,5,17,13,30
2021-06-15 14:36:11,0.01125,1,5,5,10
2021-06-15 11:12:51,0.01761574074074074,1,2,1,3
2021-06-15 10:50:12,27.071319444444445,6,39861,6414,46275
2021-06-15 18:13:00,0.5815393518518519,2,33,2,35
2021-06-15 10:37:37,0.5758680555555555,1,167,26,193
2021-06-14 20:34:33,0.04784722222222222,1,9,9,18
2021-06-15 13:25:50,0.780625,2,4,0,4
2021-06-14 19:28:25,0.050694444444444445,2,130,126,256
2021-06-14 19:18:23,0.04957175925925926,3,4796,135,4931
2021-06-14 18:19:10,26.38310185185185,8,37524,6517,44041
2021-06-14 18:41:24,0.04423611111111111,1,15,16,31
2021-06-23 12:13:32,8.998032407407408,19,19356,4087,23443
2021-06-14 13:12:18,0.11186342592592592,1,2,1,3
2021-06-17 14:37:54,7.106458333333333,4,14166,2629,16795
2021-06-14 10:00:29,26.03679398148148,7,34257,5754,40011
2021-06-15 12:39:06,1.146087962962963,1,61,0,61
2021-06-23 09:52:11,10.869363425925926,18,13968,1480,15448
2021-06-13 11:02:57,0.0865625,2,8,8,16
2021-06-14 12:12:23,2.4972916666666665,3,59,27,86
2021-06-15 18:11:29,2.631076388888889,5,47,20,67
2021-06-14 12:11:13,1.7858564814814815,3,36,32,68
2021-06-16 08:43:54,27.98361111111111,18,42243,7261,49504
2021-06-21 13:36:45,9.20835648148148,2,19,7,26
2021-06-14 16:44:29,2.7095949074074075,3,909,907,1816
2021-06-14 16:43:49,2.7988425925925924,4,77,3,80
2021-06-15 20:01:37,3.9447453703703705,8,486,35,521
2021-06-14 12:03:33,2.6324189814814813,2,171,171,342
2022-02-23 08:41:42,256.53697916666664,12,809,408,1217
2021-06-15 13:33:21,3.8956712962962965,1,27,12,39
2021-06-23 08:38:05,11.865613425925925,5,93,42,135
2021-06-14 09:33:55,2.971574074074074,4,73,11,84
2021-06-11 08:04:07,22.955983796296298,6,29375,4592,33967
2021-06-10 14:25:05,0.012708333333333334,1,8,0,8
2021-06-11 16:27:10,1.3799884259259259,6,3520,1469,4989
2021-06-09 19:41:59,21.440613425925925,5,27734,4301,32035
2021-06-09 18:02:53,0.025243055555555557,1,9,28,37
2021-06-09 17:49:27,0.021527777777777778,1,11,1,12
2021-06-10 12:03:20,4.765347222222222,2,44,10,54
2021-06-23 18:07:38,14.709016203703703,10,30488,3550,34038
2021-06-09 12:21:03,0.47725694444444444,1,38,15,53
2021-06-09 16:23:47,0.8732175925925926,2,6,3,9
2021-06-08 14:27:02,0.04902777777777778,1,1,1,2
2021-06-08 09:21:38,0.014710648148148148,1,2,2,4
2021-06-08 09:22:31,0.10690972222222223,2,2,3,5
2021-06-08 03:48:41,0.018703703703703705,1,2,1,3
2021-06-08 15:36:15,0.6221180555555555,4,71,45,116
2021-06-08 02:34:10,0.12878472222222223,2,15,5,20
2021-06-07 12:04:18,19.122777777777777,8,20595,3903,24498
2021-06-07 09:54:03,0.15224537037037036,1,230,62,292
2021-06-07 15:47:13,1.085925925925926,4,9,5,14
2021-06-08 13:02:35,2.815613425925926,2,2,1,3
2021-06-07 06:14:25,1.8812615740740741,4,326,140,466
2021-06-10 13:14:37,31.04628472222222,11,757,468,1225
2021-06-08 12:58:39,71.83952546296297,3,65628,12680,78308
2021-06-07 15:22:00,3.100173611111111,2,52,52,104
2021-06-07 15:41:27,19.273576388888888,14,9185,1948,11133
2021-06-30 12:05:44,32.656793981481485,52,9813,3452,13265
2021-06-11 09:46:20,7.115289351851852,28,803,189,992
2021-06-04 15:58:24,0.6198726851851852,5,269,180,449
2021-06-04 16:39:39,0.6900462962962963,4,13,9,22
2021-06-07 08:55:55,3.567835648148148,1,4,1,5
2021-06-03 15:31:32,15.266689814814814,9,14027,3398,17425
2021-06-14 09:31:21,26.0165625,16,14174,3418,17592
2021-06-14 08:57:56,10.990810185185186,5,229,87,316
2021-06-09 11:27:06,6.25613425925926,1,2,0,2
2021-06-02 19:06:38,0.038217592592592595,2,17,0,17
2021-06-10 13:10:41,7.930416666666667,8,5689,2148,7837
2021-06-02 14:12:53,0.013483796296296296,1,15,1,16
2021-06-02 16:56:00,0.5423148148148148,4,1941,1708,3649
2021-06-02 07:40:20,0.16207175925925926,1,1,1,2
2021-06-23 10:34:18,6.812858796296296,2,3,1,4
2021-06-01 22:58:31,0.13392361111111112,4,18,16,34
2021-06-01 18:58:49,0.012627314814814815,1,1,1,2
2021-06-02 16:53:09,0.966400462962963,1,6,6,12
2021-06-01 16:24:59,0.14582175925925925,2,6,6,12
2021-06-01 18:07:37,0.31711805555555556,11,783,89,872
2021-06-14 19:01:03,15.876990740740741,29,10796,2856,13652
2021-06-01 20:24:53,1.0665277777777777,8,6336,363,6699
2021-06-03 10:35:26,2.7323032407407406,3,26,34,60
2021-06-02 08:17:14,13.965092592592592,9,8854,1704,10558
2021-05-31 15:54:33,0.15748842592592593,2,2,0,2
2021-06-01 13:27:54,1.2388425925925926,1,1,1,2
2021-06-10 15:47:13,11.12804398148148,18,1145,245,1390
2021-06-01 13:18:33,2.225532407407407,1,1,0,1
2021-06-01 16:21:21,2.581898148148148,3,37,9,46
2021-06-01 13:40:53,3.2032175925925928,1,74,0,74
2021-05-31 08:02:10,2.0208333333333335,1,5,4,9
2021-06-10 19:59:55,13.252349537037038,4,20320,2876,23196
2021-05-28 11:52:01,0.04835648148148148,1,9,0,9
2021-06-01 13:04:51,4.141898148148148,1,1,1,2
2021-05-31 14:29:04,3.2906944444444446,2,0,2,2
2021-05-28 10:46:56,0.2398611111111111,8,153,117,270
2021-06-10 14:28:07,13.737222222222222,7,11991,2317,14308
2021-05-28 10:27:02,0.807650462962963,2,160,5,165
2021-05-27 09:46:10,0.0012962962962962963,1,1,0,1
2021-07-13 21:18:54,47.692939814814814,1,8,6,14
2021-05-27 11:53:33,0.3155324074074074,2,5,0,5
2021-06-01 06:32:27,5.263900462962963,11,3545,475,4020
2021-05-26 19:44:40,0.017326388888888888,1,3,3,6
2021-05-26 15:59:06,0.029502314814814815,2,1,1,2
2021-06-16 11:14:13,28.087997685185186,29,76927,12295,89222
2021-05-26 14:01:13,7.203969907407408,8,7573,1588,9161
2021-06-01 04:14:31,5.847615740740741,18,1854,123,1977
2021-05-25 21:06:14,0.25685185185185183,1,1,1,2
2021-05-26 08:19:37,2.7321180555555555,1,1,0,1
2021-06-01 12:28:42,6.94681712962963,2,69,61,130
2021-05-25 08:06:06,7.920347222222222,1,5,0,5
2021-05-25 08:06:19,0.003275462962962963,1,3,3,6
2021-05-25 08:23:46,0.05425925925925926,1,1,1,2
2021-05-25 08:18:55,0.13164351851851852,1,1,1,2
2021-05-25 15:11:26,0.5890509259259259,4,62,26,88
2021-05-24 18:26:03,0.012777777777777779,2,2,2,4
2021-05-24 17:30:40,0.048240740740740744,2,6,5,11
2021-05-24 13:26:40,0.0036226851851851854,1,1,1,2
2021-05-24 18:15:52,0.28563657407407406,2,2,1,3
2021-05-24 09:41:11,5.023391203703704,4,7254,1394,8648
2021-05-22 14:27:20,0.6984143518518519,1,1,1,2
2021-05-21 22:11:58,2.5447685185185187,4,7249,1389,8638
2021-05-21 15:52:23,2.2811689814814815,5,1016,1001,2017
2021-05-25 12:03:43,3.9211689814814816,2,83,51,134
2021-05-24 23:51:43,3.418159722222222,4,39,18,57
2021-05-21 12:06:11,0.023587962962962963,1,1,1,2
2021-05-21 10:50:01,0.02150462962962963,1,8,2,10
2021-06-14 09:58:44,24.84803240740741,23,31285,5612,36897
2021-06-08 12:42:49,18.341527777777777,10,16694,1650,18344
2021-05-21 16:07:46,0.5009490740740741,2,51,5,56
2021-05-25 17:40:49,4.887037037037037,14,259,92,351
2021-07-08 14:54:43,49.059560185185184,69,4320,2884,7204
2021-05-20 13:55:13,0.022372685185185186,2,65,15,80
2021-05-20 13:30:31,0.01765046296296296,1,1,1,2
2021-05-20 07:16:04,0.527337962962963,1,43,7,50
2021-05-21 08:36:56,1.6335300925925926,4,28,29,57
2021-05-26 23:18:18,7.590833333333333,22,2526,1467,3993
2021-05-26 13:02:44,7.902962962962963,10,1693,237,1930
2021-05-19 13:48:57,0.1441550925925926,1,1,0,1
2021-05-19 09:31:18,0.016527777777777777,2,1002,995,1997
2021-05-25 12:59:52,6.50087962962963,2,89,118,207
2021-05-20 16:02:29,1.9194907407407407,7,279,133,412
2021-05-18 18:38:36,0.04167824074074074,1,1,1,2
2021-05-18 14:27:29,0.08842592592592592,3,33,6,39
2021-05-18 13:38:57,0.1203587962962963,5,16,13,29
2021-05-18 13:28:13,0.12996527777777778,1,1,2,3
2021-05-18 16:45:16,0.8323263888888889,9,86,24,110
2021-05-18 13:47:29,0.7684027777777778,3,807,521,1328
2021-05-17 18:54:34,0.012326388888888888,1,1,1,2
2021-05-18 11:42:39,0.8087615740740741,1,49,10,59
2021-05-17 14:10:13,0.009293981481481481,1,4,2,6
2021-05-19 11:00:58,1.9598032407407406,19,419,343,762
2021-05-17 10:30:54,0.014988425925925926,3,778,771,1549
2021-05-17 10:17:31,0.05510416666666667,1,2,0,2
2021-05-17 09:28:57,0.026238425925925925,2,16,1,17
2021-05-17 08:42:37,0.03512731481481481,1,0,123,123
2021-06-01 13:24:39,15.753483796296296,19,702,189,891
2021-05-17 08:26:33,4.722581018518518,5,755,308,1063
2021-05-14 11:02:57,0.0032175925925925926,1,6,9,15
2021-05-13 20:11:12,0.06915509259259259,1,15,14,29
2021-05-14 09:44:03,0.6996296296296296,1,1,1,2
2021-07-21 08:28:31,68.795,1,6,11,17
2021-05-13 07:35:45,0.0065625,1,4,0,4
2021-05-14 13:51:25,1.9481828703703703,3,731,281,1012
2021-05-12 14:52:54,0.03916666666666667,5,3923,89,4012
2021-05-12 13:11:11,0.029270833333333333,1,18,18,36
2021-05-12 12:52:53,0.05108796296296296,1,23,13,36
2021-05-12 13:48:53,0.14265046296296297,1,7,8,15
2021-05-13 09:58:19,1.0200347222222221,3,18,12,30
2021-05-12 09:58:30,0.02929398148148148,2,3,3,6
2021-05-20 12:00:34,8.835590277777778,56,12450,1505,13955
2021-05-11 16:02:48,0.04271990740740741,2,21,3,24
2021-05-18 07:53:21,6.734699074074074,6,886,643,1529
2021-05-11 14:49:34,0.03827546296296296,3,26,26,52
2021-05-11 16:01:04,0.3017361111111111,1,3,1,4
2021-05-11 09:42:21,0.06648148148148147,1,1,0,1
2021-05-11 11:58:38,0.21729166666666666,1,15,4,19
2021-05-11 12:12:02,0.24363425925925927,1,1,1,2
2021-05-10 16:38:17,0.011840277777777778,1,2,0,2
2021-05-10 14:58:30,0.01105324074074074,1,6,0,6
2021-05-10 13:28:05,0.055081018518518515,1,1,1,2
2021-05-10 08:48:21,0.004733796296296297,1,1,0,1
2021-06-09 15:51:13,30.349895833333335,31,5819,770,6589
2021-05-13 10:51:30,3.143622685185185,1,8,8,16
2021-05-10 05:46:48,0.40930555555555553,1,7,6,13
2021-06-08 19:32:04,33.85712962962963,30,42671,5397,48068
2021-05-07 21:06:33,0.00829861111111111,1,3,1,4
2021-05-07 21:44:22,0.07337962962962963,4,90,89,179
2021-05-10 05:49:52,2.523645833333333,1,1,0,1
2021-05-07 15:55:21,0.002534722222222222,1,4,2,6
2021-05-10 05:48:44,2.7394328703703703,2,10,4,14
2021-05-10 17:28:10,3.3007407407407405,6,5667,481,6148
2021-05-07 11:48:52,0.11748842592592593,1,19,24,43
2021-05-07 07:02:30,0.06689814814814815,1,1,1,2
2021-05-18 23:44:54,12.116898148148149,7,11386,551,11937
2021-05-06 21:14:12,0.018125,2,5,2,7
2021-05-06 20:35:28,0.02494212962962963,2,9,6,15
2021-06-14 17:58:55,39.694710648148146,15,4117,1880,5997
2021-05-06 18:42:51,0.02625,1,8,1,9
2021-05-06 18:24:19,0.16506944444444444,1,190,240,430
2021-05-06 11:39:28,0.017280092592592593,1,1,1,2
2021-05-06 06:50:11,0.0004050925925925926,1,1,0,1
2021-05-06 07:02:54,0.10760416666666667,1,1,1,2
2021-05-11 15:30:34,5.853159722222222,12,633,110,743
2021-05-07 12:08:41,1.765787037037037,3,516,162,678
2021-05-06 06:18:02,0.7405208333333333,2,3,1,4
2021-05-05 18:44:30,0.2561574074074074,1,1,0,1
2021-05-05 07:36:18,0.9938194444444445,2,4,0,4
2021-05-20 23:54:23,16.065231481481483,4,7,7,14
2021-05-04 21:17:12,0.043541666666666666,6,23,9,32
2021-05-04 18:31:19,0.10528935185185186,2,0,292,292
2021-05-05 07:35:15,0.6187384259259259,1,1,0,1
2021-05-04 20:20:57,0.8532407407407407,18,249,123,372
2021-05-04 13:53:44,0.5730208333333333,7,51,22,73
2021-05-03 20:12:06,0.04101851851851852,1,3,1,4
2021-05-03 15:42:56,0.015173611111111112,1,1,1,2
2021-05-03 16:48:13,0.17190972222222223,1,0,6,6
2021-05-11 18:03:02,8.293194444444444,19,24859,2516,27375
2021-05-03 10:02:33,0.0005555555555555556,1,0,1,1
2021-05-03 09:53:30,9.881273148148148,4,7006,2415,9421
2021-05-03 11:43:30,0.16479166666666667,2,2,1,3
2021-05-03 08:35:06,0.05168981481481481,2,12,17,29
2021-05-18 21:50:51,15.707071759259259,25,21651,2143,23794
2021-05-03 05:26:31,1.385162037037037,1,2,2,4
2021-05-03 15:19:12,1.9430902777777779,6,163,24,187
2021-06-14 09:46:08,47.83391203703704,93,83258,14086,97344
2021-05-03 17:18:46,3.0252199074074073,6,310,212,522
2021-04-30 12:47:13,0.004363425925925926,1,3,0,3
2021-04-30 13:03:13,0.021377314814814814,1,1,1,2
2021-07-07 14:06:48,68.13579861111111,5,76,31,107
2021-04-30 12:47:01,0.11655092592592593,1,4,0,4
2021-04-30 07:54:58,0.0008796296296296296,1,1,1,2
2021-04-29 19:47:26,0.15243055555555557,1,2,2,4
2021-04-30 13:06:47,0.8703819444444445,4,68,36,104
2021-04-30 12:35:12,0.8897222222222222,2,79,79,158
2021-04-30 13:02:50,0.8888541666666666,8,66,40,106
2021-05-09 19:42:38,10.467071759259259,1,3,3,6
2021-04-30 06:57:50,0.9262615740740741,1,2,2,4
2021-04-30 19:51:48,1.884236111111111,11,158,89,247
2021-04-29 10:04:51,0.7972222222222223,14,4202,2190,6392
2021-04-29 11:51:10,0.6816782407407408,2,32,37,69
2021-04-30 12:45:33,7.875393518518519,18,618,604,1222
2021-04-30 07:42:13,1.677326388888889,1,1,1,2
2021-04-28 15:16:42,0.04037037037037037,1,0,6,6
2021-04-29 22:33:48,1.382824074074074,3,88,95,183
2021-04-30 08:29:59,1.8787384259259259,1,1,1,2
2021-04-28 14:11:18,0.2734027777777778,5,18,10,28
2021-05-03 17:18:27,5.720092592592593,1,9,8,17
2021-05-27 12:22:58,29.857465277777777,3,94,13,107
2021-05-14 18:57:30,17.189618055555556,16,3747,1275,5022
2021-04-28 13:10:06,0.9665856481481482,2,18,18,36
2021-05-05 15:22:21,8.08332175925926,29,6779,3112,9891
2021-05-04 17:57:59,7.249317129629629,18,14168,3906,18074
2021-04-27 14:04:12,0.35564814814814816,5,31,19,50
2021-04-27 14:06:37,0.3635185185185185,2,25,25,50
2021-04-27 02:18:38,0.0847337962962963,2,15,16,31
2021-04-26 15:52:23,0.015497685185185186,1,30,26,56
2021-04-26 15:29:36,0.2165625,2,18,14,32
2021-05-12 08:18:16,15.967037037037038,64,22569,3657,26226
2021-04-26 17:30:48,0.37697916666666664,1,2,2,4
2021-04-26 11:50:34,0.19905092592592594,2,242,207,449
2021-04-26 07:05:53,1.630462962962963,1,40,5,45
2021-04-26 15:37:32,0.4446412037037037,4,1067,582,1649
2021-04-26 15:42:43,0.4484490740740741,2,1061,574,1635
2021-04-26 04:58:51,0.33417824074074076,1,1,1,2
2021-04-26 13:14:25,0.817962962962963,1,164,164,328
2021-04-30 12:27:46,4.963171296296296,1,40,2,42
2021-04-30 07:44:59,4.77287037037037,1,22,4,26
2021-04-26 13:08:43,1.0851851851851853,1,1,1,2
2021-05-04 18:56:10,9.358877314814816,14,13792,3087,16879
2021-04-26 17:40:33,2.522152777777778,14,4627,2413,7040
2021-05-13 06:44:55,18.4903125,56,1226,829,2055
2021-04-24 00:19:15,0.012881944444444444,1,1,1,2
2021-04-26 12:55:14,2.95787037037037,6,27,9,36
2021-04-26 14:26:53,2.7021875,2,6,1,7
2021-04-23 18:50:00,0.03644675925925926,1,2,0,2
2021-04-23 13:36:27,0.036099537037037034,1,2,1,3
2021-04-23 11:37:20,0.0077083333333333335,1,1,1,2
2021-04-23 11:49:10,0.07672453703703704,1,1,0,1
2021-04-23 09:59:34,0.024710648148148148,1,1,1,2
2021-04-23 09:34:59,0.012256944444444445,1,1,1,2
2021-04-23 11:48:42,0.19796296296296295,1,2,2,4
2021-04-30 12:08:16,7.448078703703704,1,271,5,276
2021-04-23 11:53:33,0.8441550925925926,2,16,16,32
2021-04-22 15:16:24,0.023483796296296298,2,2,2,4
2021-04-26 16:24:31,4.962256944444444,13,3342,1561,4903
2021-04-22 12:50:00,0.02021990740740741,1,4,1,5
2021-04-26 22:28:40,5.115266203703704,8,21386,8321,29707
2021-04-22 11:11:44,0.031041666666666665,2,2,2,4
2021-04-22 12:18:59,0.13413194444444446,1,1,1,2
2021-04-22 12:17:11,0.17386574074074074,1,1,1,2
2021-04-22 14:10:17,0.48260416666666667,1,1,1,2
2021-05-24 07:38:59,32.40083333333333,1,2,2,4
2021-04-23 07:53:09,1.6369097222222222,15,2376,1353,3729
2021-04-21 16:36:18,0.041631944444444444,5,623,91,714
2021-04-21 16:04:55,0.019837962962962963,4,621,91,712
2021-04-21 15:51:00,0.009618055555555555,2,10,12,22
2021-04-21 17:37:57,82.28497685185185,10,82543,17294,99837
2021-04-30 08:43:55,23.132164351851852,10,3877,1766,5643
2021-04-21 14:48:16,0.45332175925925927,1,1,1,2
2021-04-21 15:11:20,0.7854398148148148,11,1531,917,2448
2021-04-22 10:23:09,1.5376736111111111,2,32,5,37
2021-04-21 15:12:09,0.8069097222222222,7,31,27,58
2021-04-21 17:10:11,0.9177893518518518,2,11,4,15
2021-04-20 18:12:02,0.095,2,21,27,48
2021-04-21 16:34:39,1.0553935185185186,4,138,368,506
2021-04-30 09:54:08,9.900046296296296,9,280,29,309
2021-04-20 13:07:44,1.0454282407407407,2,86,69,155
2021-04-20 12:16:02,0.1698148148148148,4,27,67,94
2021-05-26 13:07:23,36.26712962962963,8,10381,3593,13974
2021-04-21 13:47:27,1.4553703703703704,4,124,58,182
2021-04-23 13:17:38,3.6592592592592594,30,944,205,1149
2021-05-04 12:13:58,14.639155092592592,4,143,33,176
2021-04-19 23:04:52,0.10341435185185185,1,13,1,14
2021-04-19 18:55:34,0.050150462962962966,2,58,57,115
2021-04-20 00:31:29,0.45296296296296296,2,121,72,193
2021-04-21 09:56:46,2.004189814814815,6,148,106,254
2021-05-12 15:46:03,25.27107638888889,4,26321,3914,30235
2021-06-09 17:40:56,51.96578703703704,35,45726,24238,69964
2021-04-25 09:45:47,7.487291666666667,9,137,80,217
2021-04-23 16:24:26,5.948819444444444,1,1,1,2
2021-04-19 12:25:40,2.2573958333333333,1,8,5,13
2021-04-16 20:01:58,0.9517939814814815,7,552,113,665
2021-04-19 15:24:43,3.4004861111111113,3,7,9,16
2021-04-30 18:15:47,20.701215277777777,26,24046,7773,31819
2021-04-16 02:10:29,0.005115740740740741,1,1,1,2
2021-04-16 03:21:18,0.22350694444444444,1,47,3,50
2021-04-15 11:36:33,0.5972685185185185,1,18,4,22
2021-04-14 21:02:27,0.24319444444444444,4,202,57,259
2021-06-22 09:21:31,68.6896875,45,98933,15239,114172
2021-04-14 15:47:54,0.02443287037037037,1,1,1,2
2021-04-15 07:51:24,0.7206828703703704,2,31,14,45
2021-04-14 14:31:04,0.4686226851851852,1,6,3,9
2021-04-14 14:39:38,0.6154282407407408,2,5,5,10
2021-04-14 18:06:59,0.8238194444444444,6,20,15,35
2021-04-14 15:39:24,0.8057523148148148,7,43,6,49
2021-04-13 21:58:09,0.08875,2,6,0,6
2021-04-15 13:32:33,1.8879513888888888,4,85,31,116
2021-04-13 19:36:37,0.07221064814814815,3,383,358,741
2021-04-13 19:34:01,0.10951388888888888,1,1,1,2
2021-04-14 14:13:25,0.9117939814814815,1,1,1,2
2021-04-14 14:58:55,1.0222685185185185,2,69,69,138
2021-04-13 15:45:24,0.07481481481481482,4,145,105,250
2021-04-13 16:14:25,0.09171296296296297,1,22,39,61
2021-05-03 13:07:29,19.99766203703704,41,5815,1136,6951
2021-04-13 12:58:08,0.13202546296296297,1,38,54,92
2021-04-13 16:35:19,0.2927199074074074,1,37,27,64
2021-04-13 13:49:15,0.38484953703703706,9,149,69,218
2021-04-12 22:56:17,0.0065625,1,1,0,1
2021-04-13 12:53:04,0.6203125,2,12,2,14
2021-04-13 12:52:30,0.6619907407407407,1,1,1,2
2021-04-13 14:33:52,0.9822800925925926,5,23,22,45
2021-04-12 23:08:33,0.3434490740740741,2,4,6,10
2021-05-13 11:02:27,48.82700231481481,2,35,1,36
2021-04-20 11:18:47,13.165451388888888,12,1835,707,2542
2021-04-12 21:35:32,1.346261574074074,1,1,1,2
2021-04-12 22:08:28,1.9290046296296297,1,1,1,2
2021-04-12 11:55:40,1.506724537037037,1,3,3,6
2021-04-13 09:54:46,2.917777777777778,1,16,6,22
2021-04-13 19:47:07,3.9577662037037036,4,160,12,172
2021-04-09 18:28:43,0.09193287037037037,2,33,12,45
2021-04-09 18:39:12,0.07625,2,4,2,6
2021-04-09 19:18:00,0.10283564814814815,2,49,30,79
2021-04-09 15:57:44,0.08277777777777778,1,90,385,475
2021-04-09 15:52:22,0.14846064814814816,1,1,1,2
2021-04-12 13:06:41,3.2834837962962964,3,477,473,950
2021-04-09 02:47:32,0.016516203703703703,2,4,4,8
2021-04-08 22:46:54,0.04487268518518518,5,48,21,69
2021-04-08 22:41:36,0.12006944444444445,3,204,88,292
2021-04-23 21:52:31,15.117916666666666,15,92,50,142
2021-04-08 22:10:44,0.12525462962962963,4,47,43,90
2021-04-08 18:36:45,0.031180555555555555,2,3,0,3
2021-04-08 20:13:17,0.10872685185185185,10,82,33,115
2021-04-08 16:46:28,0.03563657407407408,4,13,4,17
2021-04-08 18:28:49,0.11162037037037037,3,7,3,10
2021-04-09 06:40:37,0.6568171296296297,2,2,1,3
2021-04-08 20:12:36,0.2757986111111111,1,11,3,14
2021-04-08 20:05:53,0.31546296296296295,1,2,5,7
2021-04-08 12:22:26,0.1270486111111111,3,6,6,12
2021-04-08 12:22:58,0.2961111111111111,1,1,1,2
2021-04-09 07:09:44,1.6854398148148149,4,8,8,16
2021-04-08 20:12:49,0.9646643518518518,2,67,9,76
2021-04-07 21:56:21,0.09907407407407408,1,13,35,48
2021-04-07 18:33:00,0.1932638888888889,5,36,26,62
2021-04-07 14:06:45,0.028564814814814814,2,7,1,8
2021-05-10 06:45:29,32.749398148148146,5,14,6,20
2021-04-07 14:00:34,0.03497685185185185,1,2,9,11
2021-04-20 22:23:37,13.410613425925925,1,4,0,4
2021-04-07 16:09:38,0.3963773148148148,3,36,22,58
2021-04-07 14:07:27,0.3239236111111111,1,21,21,42
2021-04-07 13:20:06,0.3637962962962963,2,68,66,134
2021-04-07 11:50:47,0.32003472222222223,1,1,1,2
2021-04-07 13:56:40,0.6926851851851852,5,1548,1302,2850
2021-04-07 13:20:58,0.6832291666666667,1,2,2,4
2021-04-06 20:42:06,0.014004629629629629,1,2,2,4
2021-04-06 23:20:08,0.28256944444444443,7,361,86,447
2021-04-06 23:35:21,0.4413773148148148,4,1756,195,1951
2021-04-06 13:12:22,0.01070601851851852,1,14,0,14
2021-04-06 12:56:18,0.17510416666666667,1,75,48,123
2021-04-06 12:03:00,0.2571875,1,2,2,4
2021-04-07 12:05:20,1.2874537037037037,3,6,2,8
2021-05-10 07:01:23,34.34730324074074,19,37782,8107,45889
2021-04-05 22:02:29,0.008611111111111111,1,11,7,18
2021-04-06 00:56:12,0.16518518518518518,1,26,8,34
2021-04-05 20:21:49,0.027800925925925927,1,52,22,74
2021-04-05 19:29:02,0.03246527777777778,1,18,7,25
2021-04-09 18:07:47,4.000983796296296,15,9656,2606,12262
2021-04-05 19:28:52,0.11747685185185185,1,104,0,104
2021-04-05 13:37:49,0.004050925925925926,1,8,7,15
2021-04-05 13:35:22,0.010439814814814815,2,5,1,6
2021-04-05 19:12:19,0.2553125,3,32,27,59
2021-04-05 13:36:20,0.02820601851851852,1,1,1,2
2021-04-12 22:07:10,11.203136574074074,24,3062,899,3961
2021-04-05 13:06:07,0.6918865740740741,1,1,1,2
2021-06-02 16:21:06,59.81736111111111,5,84301,14477,98778
2021-04-05 01:08:42,1.192662037037037,1,19,19,38
2021-04-13 10:24:33,10.816064814814816,4,49,3,52
2021-04-05 14:51:16,3.7321643518518517,3,129,25,154
2021-04-05 14:11:29,3.7392476851851852,9,869,2499,3368
2021-04-05 16:27:53,3.854814814814815,4,467,11,478
2021-04-02 13:22:22,0.7506018518518518,1,1,1,2
2021-04-05 00:41:34,3.233587962962963,1,237,5,242
2021-04-01 21:13:47,0.39533564814814814,2,8,10,18
2021-05-04 06:23:40,32.88740740740741,23,28990,10791,39781
2021-03-31 22:49:46,0.7858564814814815,9,539,39,578
2021-03-31 22:28:07,0.24873842592592593,1,1,1,2
2021-03-31 15:36:00,0.008194444444444445,1,2,0,2
2021-03-31 14:00:57,0.002673611111111111,1,1,0,1
2021-03-31 12:02:52,0.0009953703703703704,1,1,1,2
2021-03-31 12:08:57,0.00951388888888889,1,7,7,14
2021-03-31 12:03:20,0.006724537037037037,1,2,0,2
2021-05-07 07:27:43,37.737800925925924,56,49054,17383,66437
2021-03-31 11:23:15,0.049386574074074076,2,6,9,15
2021-03-31 11:44:22,0.08769675925925927,2,3,3,6
2021-04-06 16:24:15,6.371944444444445,10,15721,9318,25039
2021-03-31 14:00:27,0.6854282407407407,9,1808,1467,3275
2021-03-31 06:45:59,0.48974537037037036,5,682,79,761
2021-03-31 14:01:30,0.8357638888888889,6,218,52,270
2021-03-31 13:36:07,0.9165277777777778,6,191,124,315
2021-03-30 17:47:12,0.01945601851851852,3,4,3,7
2021-03-30 17:26:35,0.009988425925925927,1,1,1,2
2021-03-30 15:15:55,0.015347222222222222,3,18,16,34
2021-03-30 14:03:49,0.008657407407407407,1,13,17,30
2021-03-30 16:00:52,0.09530092592592593,2,6,4,10
2021-03-30 18:26:23,0.3383449074074074,1,2,2,4
2021-03-30 12:28:58,0.24707175925925925,1,1,1,2
2021-03-29 21:25:47,0.011516203703703704,1,1,1,2
2021-03-29 19:44:19,0.047280092592592596,1,18,1,19
2021-03-29 21:36:14,0.21270833333333333,3,27,25,52
2021-04-01 15:16:05,5.837256944444444,20,20139,2739,22878
2021-04-12 15:59:47,14.778009259259258,7,126,42,168
2021-03-28 16:48:12,0.14737268518518518,1,1,1,2
2021-03-29 20:47:02,1.6271180555555556,9,189,90,279
2021-03-29 14:26:16,1.3904166666666666,1,1,1,2
2021-03-29 20:41:09,1.9961111111111112,7,688,114,802
2021-03-29 12:47:09,1.7795833333333333,1,5,5,10
2021-04-05 16:27:23,9.536226851851852,3,28,2,30
2021-03-30 06:28:02,20.867233796296297,59,9262,2726,11988
2021-03-26 12:07:59,0.23936342592592594,3,21,20,41
2021-03-26 13:06:12,0.5622800925925926,1,1,1,2
2021-04-08 18:09:12,14.352233796296296,43,10047,5757,15804
2021-04-14 11:52:06,19.652314814814815,1,4,3,7
2021-03-29 12:00:23,3.8082523148148146,1,3,0,3
2021-03-26 15:23:57,0.9644560185185185,5,558,40,598
2021-03-29 19:11:23,5.841643518518518,19,804,164,968
2021-03-25 13:01:31,0.12894675925925925,1,5,2,7
2021-03-25 12:28:17,0.20974537037037036,1,3,3,6
2021-03-24 20:44:51,0.027569444444444445,1,1,1,2
2021-03-24 19:21:40,0.01443287037037037,2,19,23,42
2021-03-24 19:13:56,0.01579861111111111,2,12,1,13
2021-03-29 14:39:14,4.828587962962963,4,74,21,95
2021-03-25 18:23:56,1.1036342592592592,1,1,0,1
2021-03-24 15:03:38,0.24413194444444444,1,1,0,1
2021-03-24 15:00:14,0.3645138888888889,1,1,1,2
2021-03-24 13:45:08,0.5824074074074074,1,3,0,3
2021-03-23 23:03:06,0.0044675925925925924,1,2,2,4
2021-03-23 19:07:55,1.3585185185185185,14,80,41,121
2021-03-23 17:37:59,0.0802199074074074,5,118,29,147
2021-03-23 14:56:44,0.19023148148148147,4,396,5,401
2021-03-23 14:02:40,0.022118055555555554,1,409,3,412
2021-03-23 13:08:40,0.09398148148148149,1,1,1,2
2021-03-23 17:48:22,0.399537037037037,1,3,3,6
2021-03-23 12:15:28,0.3088194444444444,1,3,3,6
2021-03-23 16:41:41,0.593599537037037,2,15,22,37
2021-03-23 02:16:39,0.19809027777777777,1,3,3,6
2021-03-22 19:05:39,0.027476851851851853,1,6,10,16
2021-03-22 11:58:59,0.11211805555555555,1,2,2,4
2021-03-30 13:42:30,8.219618055555555,46,13228,3578,16806
2021-03-22 07:32:21,0.0008217592592592593,1,1,1,2
2021-03-22 13:15:39,0.6096759259259259,1,1,1,2
2021-03-21 08:41:44,0.0006481481481481481,1,34,13,47
2021-03-21 07:55:34,0.011666666666666667,1,79,1,80
2021-03-22 14:45:17,1.7927314814814814,8,42,70,112
2021-03-22 18:04:52,2.0459375,2,6,2,8
2021-03-22 13:12:45,1.849699074074074,1,27,27,54
2021-03-22 12:54:50,2.3046759259259257,1,1,1,2
2021-03-22 13:05:24,2.3480902777777777,2,108,6,114
2021-03-23 02:23:24,2.9317824074074075,1,2,1,3
2021-03-22 13:14:22,2.7053935185185187,2,9,5,14
2021-03-19 15:26:32,2.005011574074074,6,11,9,20
2021-03-30 09:13:59,10.828877314814815,12,899,826,1725
2021-03-19 16:48:54,0.1822800925925926,2,15,5,20
2021-03-19 09:52:54,0.004363425925925926,5,17,13,30
2021-03-19 02:02:10,0.03607638888888889,1,1,1,2
2021-03-19 20:17:13,0.8388541666666667,6,364,119,483
2021-03-19 14:06:09,0.7113541666666666,3,25,13,38
2021-03-18 17:12:04,0.023506944444444445,2,14,4,18
2021-03-21 07:59:53,2.6235416666666667,2,2,1,3
2021-04-01 18:25:47,14.152789351851851,1,2,2,4
2021-03-19 13:42:17,0.9409143518518519,3,167,53,220
2021-03-18 21:22:43,0.5589699074074074,13,1522,539,2061
2021-03-18 14:25:57,0.6254282407407408,1,1,1,2
2021-03-18 00:25:47,0.15208333333333332,1,6,2,8
2021-04-01 12:56:12,14.764618055555555,2,24,4,28
2021-03-17 23:18:11,1.2080902777777778,20,142,80,222
2021-03-17 18:16:37,0.021342592592592594,1,28,13,41
2021-03-17 19:48:36,0.1172337962962963,4,26,11,37
2021-03-17 22:11:21,0.24063657407407407,6,102,97,199
2021-03-17 15:10:17,0.08412037037037037,1,2,2,4
2021-03-17 13:15:14,0.0421412037037037,1,1,1,2
2021-03-22 22:00:05,5.483587962962963,5,181,61,242
2021-03-18 11:51:16,1.1708564814814815,8,1720,692,2412
2021-03-17 17:21:03,0.49537037037037035,1,0,5,5
2021-03-17 13:23:38,0.3424537037037037,2,22,7,29
2021-03-17 17:22:58,0.5416319444444444,3,177,42,219
2021-04-08 16:53:01,22.83943287037037,40,21243,4118,25361
2021-03-16 19:58:20,0.004074074074074074,2,26,4,30
2021-03-16 19:37:52,0.018217592592592594,2,6,3,9
2021-03-16 15:31:29,0.0025578703703703705,1,15,7,22
2021-03-16 15:22:39,0.05767361111111111,3,95,22,117
2021-03-16 14:50:01,0.008263888888888888,1,4,1,5
2021-03-16 14:48:54,0.006238425925925926,1,7,7,14
2021-03-16 15:18:20,0.03930555555555556,2,2,2,4
2021-03-16 12:55:07,0.011921296296296296,1,3,3,6
2021-03-16 12:41:47,0.7673148148148148,15,386,121,507
2021-03-18 16:55:39,2.63400462962963,8,1243,370,1613
2021-03-17 18:33:14,1.8902662037037037,3,10,6,16
2021-03-15 22:02:47,0.06278935185185185,1,17,9,26
2021-03-16 05:05:37,0.40967592592592594,9,101,21,122
2021-03-15 23:29:55,0.21784722222222222,4,120,11,131
2021-03-15 14:20:38,0.015555555555555555,1,2,0,2
2021-03-15 13:50:05,0.2416087962962963,1,4,1,5
2021-03-15 23:35:27,1.0241435185185186,2,5,2,7
2021-03-15 11:39:10,0.8308796296296296,1,1,1,2
2021-04-01 17:53:54,18.503391203703703,9,2217,2078,4295
2021-04-26 12:16:21,44.599212962962966,7,54586,12491,67077
2021-03-15 17:11:17,2.7004050925925926,4,6,5,11
2021-07-24 15:31:43,63.04471064814815,250,56728,7987,64715
2021-03-15 10:50:37,2.7223842592592593,2,6,0,6
2021-03-15 13:27:56,2.9547569444444446,3,24,1,25
2021-03-15 13:28:15,11.71704861111111,9,168,34,202
2021-03-19 02:13:45,6.5245601851851855,6,4038,1513,5551
2021-03-15 12:28:15,2.9553935185185187,1,6,0,6
2021-03-15 21:28:01,3.7235532407407406,4,460,419,879
2021-03-15 07:07:12,2.826909722222222,1,0,56,56
2021-03-12 12:50:20,0.6923611111111111,2,15,8,23
2021-03-11 22:42:54,0.16773148148148148,2,3,3,6
2021-03-11 18:35:50,0.012627314814814815,1,1,1,2
2021-03-11 18:43:53,0.12483796296296296,2,50,58,108
2021-03-12 06:09:46,0.4962152777777778,1,1,1,2
2021-03-11 18:56:47,0.07012731481481481,2,2,0,2
2021-03-11 17:13:38,0.01752314814814815,1,4,4,8
2021-03-11 17:56:13,0.08237268518518519,3,6,4,10
2021-03-12 11:16:41,0.7989467592592593,3,7,11,18
2021-03-11 18:38:30,0.09796296296296296,6,34,23,57
2021-03-11 18:45:07,0.11314814814814815,1,2,2,4
2021-03-11 17:58:15,0.1037037037037037,1,4,2,6
2021-03-12 14:18:19,0.9576273148148148,3,11,3,14
2021-03-15 13:10:44,3.987951388888889,2,28,1,29
2021-03-11 14:53:36,0.013657407407407408,3,11,2,13
2021-03-11 19:29:02,0.22805555555555557,2,3,3,6
2021-03-11 13:34:09,0.0011921296296296296,1,4,4,8
2021-04-23 16:14:20,43.22820601851852,1,3,1,4
2021-03-11 14:44:18,0.1133912037037037,5,4820,350,5170
2021-03-11 13:58:05,0.09422453703703704,1,1,1,2
2021-03-11 16:11:57,0.809537037037037,3,57,75,132
2021-03-25 16:32:39,29.651724537037037,33,2878,1098,3976
2021-03-10 19:58:22,0.01513888888888889,1,13,1,14
2021-03-10 19:53:49,0.17300925925925925,8,46,21,67
2021-03-11 14:00:23,0.8434722222222222,1,26,4,30
2021-03-10 16:26:23,0.5523148148148148,5,391,330,721
2021-03-10 03:13:45,0.0979050925925926,2,7,20,27
2021-03-09 21:25:32,0.001238425925925926,2,2,2,4
2021-03-15 13:11:43,5.8896296296296295,25,6487,1463,7950
2021-03-09 16:31:46,4.96244212962963,19,110,44,154
2021-03-10 04:22:31,0.8472685185185185,1,1,13,14
2021-04-23 16:58:07,45.34305555555556,19,54255,13479,67734
2021-03-09 14:35:08,0.29908564814814814,1,6,0,6
2021-03-09 17:06:56,0.49373842592592593,1,60,28,88
2021-03-09 02:44:08,0.26709490740740743,3,8,1,9
2021-03-09 04:16:34,0.10814814814814815,2,53,13,66
2021-03-12 16:13:11,3.7227430555555556,5,45,37,82
2021-03-08 21:40:12,0.020092592592592592,2,73,5,78
2021-03-09 19:42:07,0.9910300925925926,3,51,47,98
2021-03-08 15:19:23,0.010023148148148147,2,2,2,4
2021-03-09 09:16:59,0.8210995370370371,10,869,678,1547
2021-03-08 12:11:43,0.0027314814814814814,2,8,12,20
2021-03-08 10:10:04,0.05236111111111111,1,1,1,2
2021-03-08 10:36:19,0.20770833333333333,6,39,19,58
2021-03-18 16:51:42,10.42724537037037,7,12863,2395,15258
2021-03-08 06:09:59,0.007048611111111111,1,1,1,2
2021-03-08 18:28:44,0.7204050925925926,4,62,15,77
2021-03-08 15:15:56,0.4077546296296296,2,18,1,19
2021-03-08 10:15:06,0.2771412037037037,1,2,2,4
2021-03-18 07:20:26,10.278842592592593,17,630,184,814
2021-03-08 03:31:50,1.0344444444444445,1,13,0,13
2021-03-08 16:52:20,1.787789351851852,6,70,21,91
2021-04-14 14:24:33,39.32092592592593,5,38,40,78
2021-03-08 19:11:40,2.689236111111111,4,35,62,97
2021-03-10 14:29:19,4.675381944444444,3,522,12,534
2021-03-05 19:56:37,0.01673611111111111,1,1,1,2
2021-03-08 18:57:10,3.2077199074074074,8,3469,305,3774
2021-03-05 21:18:48,0.19887731481481483,6,213,120,333
2021-03-05 15:17:12,0.002673611111111111,1,1,1,2
2021-03-05 17:10:19,0.11108796296296296,4,29,27,56
2021-03-05 14:24:14,0.03321759259259259,1,2,2,4
2021-03-05 12:44:53,0.14678240740740742,1,14,8,22
2021-04-16 09:31:36,42.03724537037037,14,317,101,418
2021-06-02 12:43:08,89.3996875,78,109004,24525,133529
2021-03-05 20:27:10,0.6899305555555556,1,1,1,2
2021-03-05 23:06:55,2.0850578703703704,31,260,216,476
2021-04-01 04:03:38,27.209386574074074,7,18381,3250,21631
2021-03-04 16:12:38,0.026122685185185186,3,1,19,20
2021-03-04 16:11:39,0.05905092592592592,1,6,3,9
2021-03-05 21:41:50,1.824548611111111,5,111,36,147
2021-03-03 19:55:18,0.031643518518518515,1,1,1,2
2021-03-04 16:46:11,0.9136689814814815,5,255,107,362
2021-03-04 20:27:12,1.2248379629629629,8,2583,2584,5167
2021-03-03 09:42:41,0.037974537037037036,3,30,11,41
2021-03-03 08:27:02,8.419097222222222,1,45,7,52
2021-03-03 08:47:25,0.4761111111111111,1,4,4,8
2021-03-03 17:13:30,0.8584375,2,17,7,24
2021-03-03 16:54:00,0.8213194444444445,6,104,9,113
2021-03-03 16:17:13,1.0429629629629629,2,2,1,3
2021-03-02 07:41:54,0.040775462962962965,1,1,1,2
2021-03-03 17:05:21,1.7800462962962964,2,5,4,9
2021-03-16 22:51:09,15.183020833333334,32,16043,2965,19008
2021-03-01 17:12:31,0.006215277777777778,1,26,22,48
2021-03-01 09:30:12,0.010810185185185185,1,0,4,4
2021-03-01 14:49:52,0.29182870370370373,2,7,6,13
2021-02-28 16:03:50,0.00886574074074074,1,1,1,2
2021-02-28 13:27:55,0.1571412037037037,3,121721,67544,189265
2021-02-27 17:53:44,0.04871527777777778,2,73,193,266
2021-02-27 01:20:30,0.00568287037037037,1,4,4,8
2021-02-27 16:21:50,0.7709259259259259,1,1,1,2
2021-02-27 01:01:02,0.14809027777777778,2,47,21,68
2021-03-03 16:21:17,4.915069444444445,5,48,23,71
2021-02-26 14:53:28,0.018217592592592594,2,23,5,28
2021-02-26 15:18:33,0.15469907407407407,1,56,2,58
2021-02-26 09:35:36,0.03474537037037037,1,2,2,4
2021-03-06 01:27:49,7.948564814814815,14,2298,876,3174
2021-02-27 00:06:08,7.6159375,10,11318,1717,13035
2021-02-26 13:04:55,0.7273842592592593,3,22,12,34
2021-02-25 20:30:38,0.06731481481481481,2,5,4,9
2021-02-25 16:42:25,0.021342592592592594,2,6,8,14
2021-02-25 15:42:27,0.034270833333333334,1,5,1,6
2021-02-25 14:18:47,0.14578703703703705,1,0,2,2
2021-02-25 00:48:01,0.008217592592592592,1,1,2,3
2021-02-25 00:23:39,0.15180555555555555,1,2,3,5
2021-02-25 16:18:33,1.1137962962962964,2,3,2,5
2021-02-24 16:32:52,0.6118055555555556,3,93,84,177
2021-02-24 01:42:25,0.1997800925925926,5,101,55,156
2021-03-08 13:14:31,6.464652777777777,2,110,50,160
2021-02-25 16:07:54,1.9933449074074074,6,242,95,337
2021-02-23 17:30:47,0.06957175925925926,1,3,3,6
2021-02-23 15:49:25,0.20302083333333334,1,1,1,2
2021-02-22 21:39:03,0.01747685185185185,1,8,7,15
2021-02-22 20:33:00,2.208136574074074,1,12,4,16
2021-02-22 14:48:21,0.027476851851851853,1,6,0,6
2021-02-22 12:45:18,0.008888888888888889,1,8,8,16
2021-02-25 14:42:46,3.2676967592592594,34,9157,2956,12113
2021-02-21 15:54:27,0.11697916666666666,2,2,2,4
2021-02-24 11:55:35,3.0130902777777777,7,1145,728,1873
2021-02-22 19:15:59,1.4960532407407408,5,196,59,255
2021-02-20 21:28:43,0.005497685185185185,1,8,8,16
2021-02-20 20:21:33,0.11828703703703704,1,4,3,7
2021-02-22 18:58:50,2.627488425925926,1,165,19,184
2021-02-19 23:04:15,0.020891203703703703,1,14,12,26
2021-02-22 17:36:17,2.8850925925925925,4,355,350,705
2021-02-28 00:34:22,7.663287037037037,1,81,46,127
2021-02-19 19:06:58,0.0038425925925925928,1,1,1,2
2021-02-19 18:36:37,0.05400462962962963,1,38,5,43
2021-02-19 21:06:13,0.3180439814814815,1,65,65,130
2021-02-24 13:38:29,5.120960648148148,1,24,30,54
2021-02-19 00:44:42,0.056979166666666664,1,3,3,6
2021-02-19 01:15:52,0.08738425925925926,2,3,1,4
2021-02-19 01:02:35,0.16189814814814815,4,95,10,105
2021-02-19 16:49:22,1.0763773148148148,1,39,5,44
2021-02-22 21:02:53,4.050925925925926,2,41,29,70
2021-02-19 11:58:08,0.8307175925925926,3,46,29,75
2021-02-19 11:57:16,0.8736921296296296,1,28,34,62
2021-02-19 14:33:25,1.0146643518518519,2,29,34,63
2021-02-19 11:56:41,0.9571296296296297,3,22,19,41
2021-02-19 11:55:25,0.980925925925926,3,15,16,31
2021-02-19 11:54:15,0.9927777777777778,3,18,17,35
2021-02-17 22:12:40,0.08057870370370371,2,2,1,3
2021-02-18 22:08:45,7.188206018518518,18,667,174,841
2021-02-17 23:52:36,0.16778935185185184,3,15,6,21
2021-02-17 23:58:08,0.2421412037037037,1,44,26,70
2021-03-06 16:44:16,36.097800925925924,56,3989,1308,5297
2021-03-18 16:37:45,29.06427083333333,2,13,9,22
2021-02-22 14:41:57,5.050879629629629,5,2203,1308,3511
2021-02-18 08:36:02,0.9491203703703703,4,30,143,173
2021-02-18 17:23:33,1.8149421296296295,1,32,4,36
2021-02-18 17:27:32,1.6816550925925926,15,1092,668,1760
2021-02-24 14:01:29,7.7549421296296295,1,1,1,2
2021-02-16 21:35:39,0.10487268518518518,2,7,6,13
2021-02-16 19:00:05,0.07585648148148148,1,2,4,6
2021-02-18 11:29:43,1.858599537037037,1,12,24,36
2021-02-17 14:53:44,0.9326736111111111,1,34,26,60
2021-02-16 16:15:15,0.014849537037037038,1,8,4,12
2021-02-17 17:02:48,1.1334722222222222,4,86,89,175
2021-02-17 17:54:15,1.2505555555555556,3,21,36,57
2021-02-16 12:59:41,0.0800462962962963,1,0,4,4
2021-02-16 14:39:37,0.3526273148148148,1,1,1,2
2021-02-25 11:33:13,9.341747685185185,21,6144,1967,8111
2021-02-15 18:01:35,0.0011921296296296296,1,1,0,1
2021-02-15 17:57:17,0.008101851851851851,1,1,1,2
2021-02-17 16:48:56,2.166875,16,520,395,915
2021-02-15 14:21:57,0.03894675925925926,2,2,0,2
2021-02-15 11:31:29,0.0005555555555555556,1,2,1,3
2021-02-15 11:22:45,0.0440162037037037,1,60,20,80
2021-03-30 05:51:34,43.390150462962964,88,47458,11482,58940
2021-02-15 10:49:07,0.8032986111111111,1,2,1,3
2021-03-10 16:12:05,25.190868055555555,149,6430,2621,9051
2021-02-13 13:19:56,0.0023148148148148147,1,1,0,1
2021-02-15 14:18:12,2.3101041666666666,1,45,6,51
2021-02-15 17:12:17,2.6562384259259257,9,187,249,436
2021-02-12 20:35:06,0.007152777777777778,2,1,135,136
2021-02-13 13:26:01,0.820462962962963,1,2,2,4
2021-02-13 13:26:26,0.8218981481481481,1,1,1,2
2021-02-15 15:28:55,6.2496527777777775,17,1226,252,1478
2021-02-25 15:06:42,15.870532407407408,83,20300,7765,28065
2021-02-18 14:52:57,7.024907407407407,3,96,171,267
2021-02-12 17:18:39,0.5036574074074074,2,3,3,6
2021-03-01 09:13:18,17.690671296296298,54,16661,4028,20689
2021-02-15 16:18:34,4.1413773148148145,1,415,345,760
2021-02-15 18:48:02,4.396701388888889,9,3598,2024,5622
2021-02-12 11:48:21,1.246388888888889,5,55,30,85
2021-02-11 22:02:05,0.7978819444444445,8,148,40,188
2021-02-11 09:53:40,0.4943518518518519,3,3,2,5
2021-02-13 13:52:30,2.733784722222222,1,1,1,2
2021-02-11 23:44:18,2.1081944444444445,6,1611,1044,2655
2021-02-13 13:24:53,2.9938541666666665,3,66,41,107
2021-02-10 15:50:01,0.3094212962962963,1,681,678,1359
2021-02-11 12:40:55,1.7871180555555555,11,291,91,382
2021-02-10 08:12:27,0.08107638888888889,1,6,5,11
2021-02-10 08:02:40,0.07789351851851851,1,1,1,2
2021-02-10 17:09:49,0.502199074074074,4,91,79,170
2021-02-10 02:48:22,0.036493055555555556,1,1,1,2
2021-02-10 00:03:03,0.1502662037037037,1,4,0,4
2021-02-09 19:22:54,0.011550925925925926,1,3,3,6
2021-02-09 18:43:41,0.014675925925925926,1,5,1,6
2021-02-09 15:38:13,0.022094907407407407,1,18,2,20
2021-02-09 11:07:57,0.013425925925925926,2,4,3,7
2021-02-09 11:10:32,0.03761574074074074,1,3,4,7
2021-02-09 18:57:38,0.3620138888888889,4,486,91,577
2021-02-09 15:27:50,0.2576273148148148,2,4,1,5
2021-02-09 08:49:02,0.01721064814814815,2,109,19,128
2021-02-10 17:09:10,1.4964467592592592,22,367,198,565
2021-02-09 19:47:52,0.6047453703703703,5,48,12,60
2021-02-09 15:11:42,0.47256944444444443,3,68,9,77
2021-02-08 20:41:53,0.0783912037037037,1,7,2,9
2021-02-09 16:48:28,0.9832060185185185,6,80,69,149
2021-02-08 17:27:27,0.021076388888888888,1,2,2,4
2021-02-08 20:42:25,34.64224537037037,5,122766,74389,197155
2021-02-08 14:07:02,0.009016203703703703,1,4,4,8
2021-02-08 16:58:03,3.061400462962963,5,26,18,44
2021-02-08 18:05:33,0.1917824074074074,1,1,0,1
2021-02-08 13:10:51,0.04828703703703704,2,2,2,4
2021-02-08 18:04:22,0.2771064814814815,6,23,24,47
2021-02-08 11:02:06,0.009733796296296296,1,1,1,2
2021-02-08 13:04:29,0.11118055555555556,1,3,17,20
2021-02-08 11:32:32,0.056122685185185185,3,29,5,34
2021-02-08 10:25:09,0.015532407407407408,1,2,7,9
2021-02-08 09:43:26,0.010636574074074074,2,4,2,6
2021-05-02 08:10:47,83.0550462962963,3,25,25,50
2021-02-08 15:08:17,1.651550925925926,2,7,4,11
2021-02-08 01:51:35,1.8199189814814816,1,23,22,45
2021-02-08 01:54:20,1.9153819444444444,1,6,0,6
2021-02-08 17:44:03,2.676226851851852,2,153,38,191
2021-02-05 23:51:19,0.07253472222222222,4,26,1,27
2021-02-08 10:03:56,2.741273148148148,1,68,31,99
2021-02-08 10:02:01,2.761041666666667,1,12,17,29
2021-02-08 09:58:25,2.7960185185185185,1,5,2,7
2021-02-05 13:20:27,0.021747685185185186,2,2,2,4
2021-02-15 12:55:10,13.84712962962963,18,1495,570,2065
2021-02-08 09:36:51,34.1800462962963,4,119265,72154,191419
2021-02-05 10:40:31,0.012997685185185185,2,4,3,7
2021-02-19 23:34:45,14.992581018518518,8,4674,1735,6409
2021-02-04 21:52:27,0.007175925925925926,3,11,9,20
2021-02-10 15:58:38,5.97113425925926,9,3896,2379,6275
2021-02-04 16:41:35,0.08842592592592592,1,3,0,3
2021-02-08 11:29:07,3.8933449074074074,4,199,173,372
2021-02-04 12:47:27,0.08085648148148149,1,32,17,49
2021-02-04 15:24:48,0.22498842592592594,1,6,6,12
2021-02-04 09:25:00,0.20699074074074075,1,18,0,18
2021-02-04 15:44:57,0.505625,3,17,12,29
2021-02-08 13:22:19,4.596747685185186,3,38,8,46
2021-07-05 09:21:25,151.4359375,4,31,8,39
2021-02-09 16:45:19,5.809733796296296,4,3880,226,4106
2021-02-04 08:34:23,0.49372685185185183,1,50,38,88
2021-02-04 14:00:19,0.835324074074074,11,235,48,283
2021-02-03 16:41:11,29.474722222222223,4,115212,72048,187260
2021-02-03 16:39:41,29.473680555555557,4,115219,72048,187267
2021-02-03 16:36:46,29.47165509259259,4,115162,72042,187204
2021-02-03 14:44:43,0.01695601851851852,1,5,1,6
2021-02-03 14:49:19,29.397037037037038,5,115131,72041,187172
2021-02-03 14:51:00,29.39820601851852,5,115163,72043,187206
2021-02-03 09:49:07,0.013136574074074075,1,4,3,7
2021-02-03 10:24:41,0.18927083333333333,1,0,1,1
2021-02-03 14:30:38,0.47899305555555555,4,7,6,13
2021-04-25 09:06:16,81.61502314814815,9,87340,19927,107267
2021-02-02 09:22:42,0.020578703703703703,1,6,6,12
2021-02-02 09:39:34,0.037696759259259256,3,69,22,91
2021-02-03 11:26:33,1.1470486111111111,3,46,16,62
2021-02-02 11:09:25,0.5170138888888889,1,3,3,6
2021-02-02 12:00:17,0.5720138888888889,1,15,15,30
2021-02-02 10:46:33,0.5425462962962962,1,2,2,4
2021-02-02 10:22:21,0.6744791666666666,2,65,23,88
2021-02-02 07:35:28,0.6610185185185186,12,250,163,413
2021-02-01 13:17:46,0.08728009259259259,1,34,43,77
2021-02-01 16:17:15,0.22453703703703703,3,11,4,15
2021-02-01 16:17:51,0.29939814814814814,3,15,15,30
2021-02-05 12:47:55,4.158125,24,9635,3755,13390
2021-02-03 16:42:16,2.776111111111111,1,1,1,2
2021-02-01 08:08:13,1.1702199074074073,1,2,2,4
2021-02-01 08:05:32,1.379236111111111,1,1,1,2
2021-02-01 13:06:33,1.7191319444444444,3,7,35,42
2021-01-31 16:09:31,1.2144212962962964,5,12,10,22
2021-01-30 14:59:20,0.46502314814814816,1,1,1,2
2021-02-13 14:10:22,14.49550925925926,4,14311,4588,18899
2021-02-01 08:14:07,44.39460648148148,10,67357,19228,86585
2021-02-08 11:36:31,10.04800925925926,14,873,2085,2958
2021-02-01 08:38:00,2.910011574074074,6,278,96,374
2021-01-29 16:18:04,0.6484722222222222,1,15,15,30
2021-01-29 16:11:22,0.6724305555555555,1,1,1,2
2021-02-17 16:00:09,19.769861111111112,3,17517,5661,23178
2021-01-29 14:52:27,0.7396643518518519,3,25,7,32
2021-01-29 10:11:54,0.5788773148148149,1,1,11,12
2021-01-28 20:10:46,0.07054398148148149,2,8,6,14
2021-01-28 18:11:05,0.06650462962962964,1,2,2,4
2021-01-28 09:03:54,0.0023148148148148147,1,0,1,1
2021-01-28 15:09:14,0.8595601851851852,3,507,54,561
2021-01-28 07:50:47,0.5340162037037037,6,15,9,24
2021-02-02 19:06:52,6.834907407407408,6,6733,1328,8061
2021-01-28 13:32:46,0.9024884259259259,1,96,78,174
2021-01-28 11:11:53,0.8361226851851852,2,4,5,9
2021-01-29 09:27:33,1.785949074074074,2,35,5,40
2021-01-27 14:11:54,0.0014236111111111112,1,2,1,3
2021-01-27 13:45:55,0.0007407407407407407,1,2,0,2
2021-01-29 10:25:03,1.998576388888889,1,85,0,85
2021-01-31 22:31:29,4.398692129629629,5,7337,1550,8887
2021-03-12 09:11:50,43.843125,12,606,105,711
2021-02-05 17:51:57,9.203969907407407,6,117,72,189
2021-01-27 13:20:59,0.014537037037037038,1,2,4,6
2021-01-27 12:40:30,0.02013888888888889,1,8,4,12
2021-01-28 09:19:56,0.9934490740740741,1,4,1,5
2021-01-27 08:34:21,0.02542824074074074,3,18,6,24
2021-01-27 09:09:57,0.05393518518518518,3,4584,48,4632
2021-02-11 04:57:24,36.68609953703704,52,67548,22058,89606
2021-01-27 07:43:15,0.015046296296296295,2,28,9,37
2021-01-27 10:15:23,0.14276620370370371,1,0,2,2
2021-01-27 13:45:10,0.33782407407407405,2,23,4,27
2021-01-27 14:31:43,0.531863425925926,3,47,11,58
2021-01-27 08:48:19,0.3869328703703704,2,8,4,12
2021-01-27 11:18:06,0.5663425925925926,3,23,10,33
2021-02-01 06:30:22,5.4300347222222225,6,6467,1278,7745
2021-01-27 14:31:19,0.7199768518518519,4,41,28,69
2021-01-28 17:36:47,1.8682291666666666,7,7018,1346,8364
2021-01-27 08:39:12,0.5144791666666667,1,20,9,29
2021-01-26 19:32:20,0.013298611111111112,1,1,1,2
2021-01-27 18:25:12,0.9981365740740741,15,5203,142,5345
2021-01-26 16:30:32,0.08790509259259259,1,4,4,8
2021-01-27 09:10:53,0.7338888888888889,1,50,1,51
2021-01-28 08:29:14,1.7522337962962964,4,30,13,43
2021-01-27 08:36:49,0.7625115740740741,1,105,8,113
2021-01-26 18:21:27,0.17905092592592592,2,5,5,10
2021-01-27 15:12:15,1.4045023148148148,8,55,48,103
2021-02-04 19:18:34,9.749282407407408,9,248,26,274
2021-01-26 15:28:22,0.7959143518518519,11,115,59,174
2021-01-26 09:47:08,1.6310995370370371,15,71,30,101
2021-01-26 08:21:44,0.46751157407407407,4,51,11,62
2021-01-26 08:37:57,0.5499652777777778,3,9,13,22
2021-01-26 15:44:02,0.8490162037037037,1,2,2,4
2021-01-26 17:32:47,3.0619675925925924,6,355,207,562
2021-01-27 10:28:12,1.9367824074074074,7,1982,1746,3728
2021-01-25 16:12:08,0.105625,1,15,0,15
2021-01-26 09:06:28,0.9656365740740741,3,41,30,71
2021-01-25 17:03:52,0.6377083333333333,3,257,170,427
2021-01-25 11:40:04,1.6693287037037037,1,1,1,2
2021-01-23 09:41:47,0.011458333333333333,1,3,3,6
2021-01-27 09:45:43,4.680474537037037,5,313,145,458
2021-01-22 16:40:16,0.01037037037037037,1,1,1,2
2021-02-01 13:07:34,9.91380787037037,1,3,3,6
2021-01-25 10:01:56,2.9380671296296295,1,14,9,23
2021-01-22 12:43:53,0.5047569444444444,1,1,1,2
2021-01-25 13:57:37,3.8165162037037037,6,223,66,289
2021-01-23 04:38:54,1.443113425925926,1,1,0,1
2021-01-22 15:34:34,0.9370949074074074,1,47,32,79
2021-01-22 15:03:58,0.9368171296296296,2,113,4,117
2021-01-21 13:31:52,0.018391203703703705,2,14,11,25
2021-01-22 13:50:46,1.1214814814814815,3,1156,721,1877
2021-01-21 11:16:15,0.02894675925925926,2,8,6,14
2021-01-21 10:16:15,0.028703703703703703,1,4,3,7
2021-01-21 10:17:13,0.03747685185185185,1,2,2,4
2021-01-21 09:17:39,0.04175925925925926,1,12,12,24
2021-01-27 08:20:10,5.997511574074074,52,10151,3958,14109
2021-01-21 17:05:47,0.707962962962963,4,45,18,63
2021-01-21 00:50:22,0.05693287037037037,3,7,4,11
2021-01-21 08:21:02,0.5259606481481481,2,2,2,4
2021-01-21 10:13:38,0.6429398148148148,2,23,1,24
2021-01-26 05:09:01,5.501574074074074,13,139,119,258
2021-01-20 17:07:08,0.008796296296296297,1,1,2,3
2021-01-20 17:30:24,0.028680555555555556,4,4,4,8
2021-01-20 14:04:53,0.1077199074074074,1,5,5,10
2021-01-20 15:19:26,0.17699074074074075,1,4,3,7
2021-01-20 15:18:51,0.2679398148148148,3,690,257,947
2021-01-20 16:59:31,0.7409259259259259,5,34,33,67
2021-01-19 22:11:23,0.025798611111111112,2,32,12,44
2021-01-20 14:50:21,0.7416203703703703,1,9,4,13
2021-01-20 09:54:37,0.5531481481481482,1,44,36,80
2021-01-20 09:17:40,0.5426851851851852,2,7,1,8
2021-01-20 09:52:13,0.6889699074074074,1,3,457,460
2021-01-19 14:55:38,0.008506944444444444,1,3,3,6
2021-01-19 14:56:26,0.013148148148148148,1,1,1,2
2021-01-19 14:40:15,0.008032407407407408,1,75,63,138
2021-01-19 14:19:11,0.01318287037037037,1,1,0,1
2021-01-19 08:06:25,0.007835648148148149,1,13,13,26
2021-02-01 14:55:11,13.697291666666667,26,16853,7075,23928
2021-01-19 10:43:12,0.6021643518518518,3,73,39,112
2021-01-25 09:27:13,6.747361111111111,5,42,44,86
2021-01-19 17:02:58,1.0949189814814815,3,25,13,38
2021-02-02 12:52:11,14.975092592592592,43,20792,8100,28892
2021-01-20 14:34:28,9.214155092592593,9,65,43,108
2021-01-19 16:39:50,1.2609375,1,2,1,3
2021-01-26 08:50:01,9.427465277777777,9,7094,3308,10402
2021-01-19 21:50:25,3.4839467592592595,8,963,194,1157
2021-01-18 09:33:39,2.522546296296296,1,13,0,13
2021-03-12 21:40:08,56.118611111111115,4,50276,11043,61319
2021-01-15 18:12:27,0.020335648148148148,1,8,1,9
2021-01-18 09:24:22,2.692696759259259,1,0,1,1
2021-01-20 11:08:00,5.046701388888889,2,25,6,31
2021-01-15 14:40:23,0.21518518518518517,3,9,9,18
2021-02-10 06:16:20,26.105104166666667,8,22767,5252,28019
2021-01-19 20:22:19,4.915625,7,663,14,677
2021-01-15 11:40:28,0.7567361111111112,2,8,20,28
2021-01-20 09:23:02,5.690763888888889,1,2,3,5
2021-01-19 15:00:15,5.009606481481481,14,258,161,419
2021-01-14 10:51:53,0.007407407407407408,4,9,8,17
2021-01-14 15:16:40,0.2763657407407407,3,13,7,20
2021-01-14 12:57:58,0.18453703703703703,1,11,1,12
2021-01-14 19:05:05,0.5579166666666666,3,250,61,311
2021-01-14 08:23:42,0.3672800925925926,2,14,13,27
2021-01-14 15:38:14,0.79125,3,208,18,226
2021-01-14 09:35:36,0.7004166666666667,2,19,7,26
2021-01-18 12:35:22,5.666296296296296,7,750,75,825
2021-01-14 08:37:07,0.7217592592592592,4,219,202,421
2021-01-13 14:54:42,0.015335648148148149,2,23,2,25
2021-01-14 09:56:54,0.8766550925925926,1,2,2,4
2021-01-15 13:06:30,2.062800925925926,8,95,133,228
2021-01-13 11:24:11,0.008680555555555556,1,1,1,2
2021-01-13 14:55:49,0.2279050925925926,13,87,57,144
2021-01-13 12:47:48,0.23836805555555557,2,3,4,7
2021-01-13 12:46:48,0.4994560185185185,1,1,3,4
2021-01-14 10:04:09,1.4034027777777778,3,25,5,30
2021-01-13 13:02:54,0.5351851851851852,1,7,3,10
2021-01-12 23:55:46,0.02931712962962963,7,11,11,22
2021-01-13 10:58:06,0.5883333333333334,2,3,4,7
2021-01-12 21:21:30,0.2326388888888889,1,1,1,2
2021-01-12 15:03:51,0.014895833333333334,1,3,3,6
2021-01-13 05:23:44,0.6226736111111111,3,1,4,5
2021-01-12 10:53:32,0.015,1,8,6,14
2021-01-12 23:19:39,1.141701388888889,8,200,731,931
2021-01-11 21:00:09,0.05700231481481482,1,1,1,2
2021-01-12 09:15:17,0.7122569444444444,1,7,0,7
2021-01-11 15:25:25,0.022627314814814815,1,16,3,19
2021-01-12 09:10:06,0.8180671296296296,2,14,14,28
2021-01-11 13:14:49,0.018194444444444444,1,7,1,8
2021-01-11 13:03:29,0.014791666666666667,1,1,1,2
2021-01-12 09:49:16,0.9684722222222222,1,1,0,1
2021-01-11 13:02:42,0.16574074074074074,2,16,24,40
2021-01-11 14:42:19,0.27699074074074076,1,3,3,6
2021-01-11 10:21:25,0.1038425925925926,1,1,5,6
2021-01-11 01:34:17,0.038657407407407404,1,5,4,9
2021-01-12 01:06:33,1.43875,34,24598,15897,40495
2021-01-11 13:34:39,2.0695833333333336,1,1,0,1
2021-01-11 18:17:49,2.7955208333333332,4,2089,1121,3210
2021-01-08 19:32:03,0.009166666666666667,1,2,2,4
2021-01-11 13:53:42,2.794386574074074,1,6,2,8
2021-01-12 11:42:33,3.806770833333333,2,13,1,14
2021-01-13 12:48:36,4.804791666666667,5,63,43,106
2021-03-18 06:44:18,91.0368287037037,24,108789,22152,130941
2021-01-10 14:08:21,2.007164351851852,1,3,3,6
2021-01-10 14:10:16,2.035671296296296,1,151,415,566
2021-01-08 13:10:44,0.10642361111111111,1,8,2,10
2021-01-21 16:03:30,13.260011574074074,22,1490,1131,2621
2021-01-12 14:26:32,4.245983796296296,7,10838,2237,13075
2021-01-08 12:41:00,0.6556597222222222,6,3207,830,4037
2021-01-08 10:50:40,0.6387037037037037,2,15,9,24
2021-01-08 10:49:44,0.7853009259259259,2,39,32,71
2021-01-07 15:12:09,0.15284722222222222,3,25,12,37
2021-01-07 11:29:04,0.018020833333333333,2,13,5,18
2021-01-07 10:51:03,0.06574074074074074,1,12,7,19
2021-01-07 10:41:59,0.07032407407407408,4,12,10,22
2021-01-11 14:39:28,4.4041550925925925,12,67,72,139
2021-01-07 09:47:51,0.2484837962962963,1,1,1,2
2021-01-07 14:36:15,0.7271064814814815,15,2505,1456,3961
2021-01-06 18:37:03,0.04701388888888889,8,96,60,156
2021-01-06 17:17:24,0.8473726851851852,12,286,366,652
2021-01-07 09:10:42,0.7411226851851852,1,0,3647,3647
2021-01-06 12:20:42,0.10221064814814815,1,4,4,8
2021-01-08 13:33:26,14.008923611111111,18,518,310,828
2021-01-07 22:10:17,15.368842592592593,7,186,273,459
2021-01-11 14:23:29,19.06653935185185,10,237,168,405
2021-01-06 13:36:56,0.21212962962962964,1,7,3,10
2021-01-06 14:13:44,1.0724421296296296,3,10486,367,10853
2021-01-06 15:04:33,1.1077314814814814,5,23758,6096,29854
2021-01-05 20:02:46,0.005960648148148148,1,1,1,2
2021-01-06 12:46:18,0.7413310185185186,3,75,41,116
2021-01-06 15:34:49,0.9568287037037037,7,14,5,19
2021-01-07 10:48:50,40.75862268518519,27,3351,1646,4997
2021-01-20 11:08:13,19.83855324074074,24,5195,2753,7948
2021-01-06 08:42:51,1.1363078703703704,1,1,1,2
2021-01-06 08:44:53,1.1403587962962962,2,19246,5758,25004
2021-01-05 15:05:33,0.4358912037037037,1,4,0,4
2021-01-05 13:15:07,0.41966435185185186,1,1,1,2
2021-01-05 14:39:39,17.66233796296296,6,13246,1317,14563
2021-01-06 11:49:23,1.5532523148148147,3,235,48,283
2021-01-04 15:02:07,0.0016666666666666668,1,1,1,2
2021-01-04 14:59:08,0.021736111111111112,1,3647,0,3647
2021-01-04 05:51:25,0.48237268518518517,2,90001,78431,168432
2021-01-06 11:50:12,3.253460648148148,7,10432,378,10810
2021-01-04 18:00:09,1.8855555555555557,1,19,48,67
2021-01-05 08:57:57,2.5269097222222223,1,2,0,2
2021-01-02 16:58:17,0.07686342592592593,1,1,1,2
2021-01-02 14:55:07,0.019849537037037037,2,78,66,144
2021-01-04 18:12:59,2.2420601851851854,5,84,21,105
2021-01-04 16:27:30,2.1636458333333333,1,6,3,9
2021-01-05 08:58:26,4.90087962962963,1,12,26,38
2021-01-04 15:22:15,4.1895138888888885,1,1,1,2
2021-01-02 11:39:15,2.7426157407407405,1,1,1,2
2021-01-03 15:00:30,20.570798611111112,7,18270,2478,20748
2021-01-04 20:09:12,5.811516203703704,1,26,20,46
2021-01-04 15:14:33,5.6763310185185185,1,3,2,5
2020-12-30 09:09:52,0.4764699074074074,1,15,19,34
2020-12-29 21:32:07,0.06957175925925926,1,2,2,4
2021-01-05 08:49:55,6.554756944444445,7,198,200,398
2021-01-05 09:01:30,6.577708333333334,6,4029,213,4242
2020-12-29 18:35:06,0.019930555555555556,1,2,0,2
2021-01-05 21:00:06,7.211944444444445,56,33173,16408,49581
2020-12-29 15:48:44,0.002372685185185185,2,117,65,182
2020-12-28 16:51:04,0.08018518518518518,5,92,53,145
2020-12-27 20:57:50,0.007407407407407408,1,3,1,4
2020-12-25 22:28:12,0.055,6,37,33,70
2020-12-25 09:17:50,1.9125578703703703,4,1740,1739,3479
2020-12-28 19:52:19,4.002523148148148,1,2,2,4
2020-12-28 19:51:41,4.034351851851852,3,12,9,21
2021-01-05 10:54:50,11.79431712962963,5,43,34,77
2020-12-24 13:47:53,0.013703703703703704,2,4,5,9
2020-12-24 13:38:09,0.055601851851851854,2,2,2,4
2020-12-24 12:17:36,0.030775462962962963,1,10,0,10
2021-01-08 13:23:30,15.130590277777777,6,28,7,35
2020-12-24 13:43:15,0.1748148148148148,1,1,1,2
2021-01-04 15:06:29,11.234652777777777,1,6,9,15
2021-01-04 14:56:51,11.231597222222222,1,3,3,6
2020-12-24 08:18:34,0.07359953703703703,1,1,1,2
2021-01-11 14:23:51,18.426840277777778,10,379,104,483
2020-12-24 00:44:33,0.027523148148148147,7,215,24,239
2021-01-04 16:26:56,11.983368055555555,4,113,23,136
2020-12-23 16:05:22,0.005011574074074074,1,3,3,6
2021-01-06 08:33:51,13.920069444444444,14,6324,6122,12446
2021-01-05 12:14:31,13.060243055555556,35,14901,3796,18697
2020-12-23 10:40:21,0.015960648148148147,2,28,6,34
2020-12-23 10:34:58,0.027523148148148147,1,2,2,4
2020-12-23 10:34:16,0.11037037037037037,1,1,1,2
2020-12-24 08:01:57,1.0900462962962962,1,1,1,2
2020-12-23 15:15:50,6.935358796296296,17,20,21,41
2020-12-22 20:42:34,0.06211805555555556,1,25,15,40
2020-12-22 19:02:26,0.08868055555555555,1,118,19,137
2020-12-22 16:12:59,0.018125,1,13,2,15
2020-12-22 16:00:05,0.05012731481481481,6,106,70,176
2020-12-22 16:41:24,0.09030092592592592,1,1,1,2
2020-12-22 16:40:48,0.09420138888888889,1,1,2,3
2020-12-22 17:07:05,0.26623842592592595,13,128,124,252
2020-12-22 22:41:21,0.5911689814814814,18,9743,1118,10861
2020-12-22 16:33:44,0.9050810185185185,7,704,215,919
2020-12-21 20:19:41,0.06395833333333334,4,1978,53,2031
2020-12-21 20:23:41,0.16207175925925926,3,135,205,340
2020-12-21 12:52:17,0.008773148148148148,1,19,11,30
2020-12-21 14:41:35,0.1413888888888889,2,57,38,95
2020-12-21 09:41:34,0.007951388888888888,1,4,0,4
2020-12-21 14:26:46,0.282974537037037,2,134,17,151
2020-12-24 12:38:01,54.561331018518516,45,91680,77927,169607
2020-12-21 13:05:24,1.5785648148148148,1,30,2,32
2021-01-05 11:18:48,16.70372685185185,9,5251,781,6032
2021-01-13 03:05:19,24.85298611111111,69,55289,16913,72202
2021-01-06 01:34:16,17.835358796296298,5,48,8,56
2020-12-20 18:28:28,1.7420833333333334,1,3,1,4
2020-12-19 00:03:27,0.05386574074074074,2,5,5,10
2020-12-19 01:09:30,0.13978009259259258,2,21,8,29
2020-12-21 09:39:31,59.63849537037037,46,139177,98720,237897
2020-12-18 20:10:39,0.058611111111111114,4,76,49,125
2021-01-11 11:27:29,26.065555555555555,53,3699,2819,6518
2020-12-18 21:32:10,0.3182523148148148,4,425,37,462
2020-12-18 12:53:24,0.13935185185185187,1,2,2,4
2020-12-23 17:31:33,9.245219907407407,37,1059,416,1475
2020-12-18 00:50:02,0.026898148148148147,1,1,1,2
2020-12-18 14:12:10,0.5935532407407408,1,1,2,3
2020-12-18 00:49:11,0.03837962962962963,1,22,8,30
2020-12-17 22:24:03,0.010972222222222222,1,35,3,38
2020-12-18 13:55:56,0.6596296296296297,1,1,1,2
2020-12-18 19:19:25,0.9355902777777778,5,974,15,989
2020-12-17 16:23:22,0.01392361111111111,2,32,43,75
2020-12-19 13:44:05,2.147615740740741,12,44479,52776,97255
2020-12-17 14:44:24,0.014027777777777778,2,19,10,29
2020-12-17 14:34:07,0.007881944444444445,1,7,0,7
2021-01-21 12:00:12,34.973506944444445,10,32,19,51
2020-12-16 17:14:33,0.06873842592592593,3,163,7,170
2020-12-16 16:06:15,0.039594907407407405,2,9,3,12
2020-12-17 23:10:58,1.6437152777777777,4,41069,52422,93491
2021-01-06 16:11:43,21.147743055555555,45,31068,4829,35897
2020-12-16 14:21:43,0.16354166666666667,1,1,1,2
2020-12-16 17:31:50,0.08074074074074074,9,1132,349,1481
2020-12-16 15:09:57,0.7559027777777778,5,86,18,104
2020-12-15 21:04:00,0.18744212962962964,1,3,0,3
2020-12-16 18:47:48,0.9314236111111112,5,268,92,360
2020-12-15 21:38:10,0.08972222222222222,4,74,57,131
2020-12-16 15:24:31,0.8641782407407408,2,10473,1265,11738
2020-12-15 18:04:31,0.027708333333333335,5,9,7,16
2020-12-15 17:38:32,0.009664351851851851,1,4,3,7
2020-12-15 21:02:44,0.21155092592592592,2,113,16,129
2020-12-15 17:12:29,0.012650462962962962,1,1,1,2
2020-12-15 17:17:17,0.018275462962962962,1,5,0,5
2020-12-15 20:16:57,0.15511574074074075,1,2,2,4
2021-02-04 08:56:13,50.70027777777778,43,89609,22589,112198
2020-12-21 12:10:16,6.834155092592592,8,390,313,703
2020-12-15 15:10:47,0.20565972222222223,6,19,11,30
2020-12-15 22:08:49,8.570578703703704,71,24371,9697,34068
2020-12-15 14:10:42,0.39523148148148146,1,1,1,2
2020-12-15 14:15:49,0.41811342592592593,1,1,1,2
2020-12-15 14:51:13,0.8471643518518519,1,3,3,6
2020-12-15 16:27:09,2.252175925925926,4,30649,51504,82153
2020-12-14 14:12:28,0.05271990740740741,1,2,2,4
2020-12-14 11:32:27,0.03900462962962963,3,36,42,78
2020-12-14 14:02:55,0.2609490740740741,1,1,1,2
2020-12-14 05:39:56,0.008761574074074074,1,6,0,6
2020-12-15 13:46:56,1.5197106481481482,1,1,1,2
2020-12-14 17:00:46,2.8613078703703705,6,28,14,42
2020-12-15 14:00:19,3.1480208333333333,20,915,313,1228
2020-12-14 15:34:59,2.6878935185185187,1,63,0,63
2020-12-11 21:26:05,0.14127314814814815,1,2,4,6
2020-12-11 15:27:32,0.004583333333333333,1,0,49,49
2020-12-14 17:47:01,3.155451388888889,14,186,201,387
2020-12-11 15:32:44,0.01712962962962963,1,1,1,2
2020-12-16 12:03:33,6.119756944444444,48,8332,48301,56633
2020-12-11 14:59:16,0.24537037037037038,1,28,4,32
2020-12-11 09:40:25,0.37694444444444447,1,17,17,34
2020-12-15 01:45:34,4.163888888888889,18,6159,46445,52604
2020-12-10 21:41:00,0.058784722222222224,1,1,1,2
2020-12-10 20:57:40,0.16912037037037037,1,298,114,412
2020-12-11 15:59:55,1.0193981481481482,6,407,143,550
2020-12-11 14:17:30,1.1319907407407408,1,46,0,46
2020-12-15 16:31:29,5.230949074074074,20,7405,47607,55012
2020-12-11 14:18:17,1.141689814814815,2,50,4,54
2020-12-10 07:22:53,0.1607986111111111,1,1,1,2
2020-12-11 15:25:01,1.7124884259259259,2,10,3,13
2020-12-10 14:28:50,0.6850810185185185,1,8,10,18
2020-12-10 14:29:38,0.7083680555555556,1,26,0,26
2020-12-10 16:57:14,0.8505787037037037,2,1314,862,2176
2020-12-11 23:24:42,2.1569560185185184,8,6780,47373,54153
2020-12-11 15:07:03,2.7494328703703705,18,6244,2983,9227
2020-12-09 15:21:41,0.9208217592592592,1,654,32,686
2020-12-09 14:14:34,0.002662037037037037,1,4,3,7
2020-12-09 14:11:40,0.0023032407407407407,1,2,2,4
2020-12-09 14:00:37,22.152835648148148,33,30243,12950,43193
2020-12-09 14:43:19,0.10832175925925926,1,4,0,4
2021-03-08 21:49:51,128.94454861111112,104,190881,102839,293720
2020-12-09 14:13:42,0.5765625,1,1,1,2
2020-12-08 23:00:07,0.7431134259259259,4,808,131,939
2020-12-08 19:39:30,4.189606481481482,23,4656,922,5578
2020-12-08 16:59:40,0.025451388888888888,1,9,9,18
2020-12-10 22:17:19,2.39369212962963,5,11,11,22
2020-12-09 20:36:36,1.6514351851851852,41,181,162,343
2020-12-08 05:59:56,0.13745370370370372,4,8,8,16
2020-12-08 00:55:13,0.07961805555555555,1,188,127,315
2020-12-07 23:35:39,0.04527777777777778,1,2,0,2
2020-12-07 22:32:10,0.013472222222222222,1,9,3,12
2020-12-08 17:04:35,0.8608217592592593,3,1,134,135
2020-12-07 23:36:34,0.21699074074074073,2,3238,90,3328
2020-12-07 16:15:30,0.0018402777777777777,1,0,3,3
2020-12-07 21:04:14,0.2209837962962963,1,12,0,12
2020-12-07 19:26:37,0.18203703703703702,2,21,15,36
2020-12-08 14:14:10,24.82695601851852,44,821,724,1545
2020-12-07 21:01:50,0.32697916666666665,1,18,1,19
2021-01-20 18:28:41,45.10453703703703,6,85665,60501,146166
2020-12-06 16:16:33,0.02462962962962963,2,23,1,24
2020-12-07 14:50:33,4.129560185185185,1,2,0,2
2020-12-05 14:57:38,0.3344212962962963,1,1,1,2
2020-12-04 23:43:36,0.07002314814814815,2,6,2,8
2020-12-05 14:52:17,0.7410185185185185,1,2,2,4
2020-12-04 18:13:43,0.05309027777777778,18,23,34,57
2020-12-04 17:28:48,0.03150462962962963,1,6,19,25
2020-12-03 22:15:47,0.10833333333333334,3,10,13,23
2020-12-03 19:28:50,0.12574074074074074,6,135,9,144
2020-12-03 15:50:14,0.004884259259259259,1,1,0,1
2020-12-03 15:45:08,0.014502314814814815,1,2,3,5
2020-12-03 15:56:55,0.0967361111111111,5,23,14,37
2020-12-02 17:28:44,0.018414351851851852,1,1,1,2
2020-12-02 17:08:32,0.009594907407407408,1,1,1,2
2020-12-02 17:07:43,0.026597222222222223,2,7,6,13
2020-12-09 19:55:25,7.351099537037037,40,1571,1315,2886
2020-12-02 15:06:46,0.7799189814814815,5,7,7,14
2020-12-04 00:05:56,2.1759953703703703,1,5,0,5
2020-12-01 19:40:37,0.025613425925925925,1,4,2,6
2020-12-01 18:13:12,0.015347222222222222,1,7,1,8
2020-12-02 18:19:50,1.0567939814814815,17,350,134,484
2020-12-01 18:45:22,0.08657407407407407,1,65,11,76
2020-12-01 18:46:10,0.10244212962962963,3,40,12,52
2020-12-02 15:08:33,1.2334375,4,10248,4045,14293
2020-12-01 18:01:53,0.8639814814814815,1,10,1,11
2020-12-01 16:45:57,0.8346296296296296,1,94,43,137
2020-12-08 17:04:02,7.924004629629629,1,1,1,2
2020-12-01 18:15:26,1.0359027777777778,10,58,52,110
2020-11-30 16:12:16,0.021354166666666667,2,24,13,37
2020-11-30 15:29:24,0.003310185185185185,1,5,1,6
2020-12-01 09:44:37,1.0414814814814815,1,6,6,12
2020-11-30 14:33:31,0.30559027777777775,1,1,1,2
2020-12-03 15:33:13,3.6125578703703702,1,2,2,4
2021-01-04 14:53:56,36.07679398148148,12,47159,51281,98440
2020-11-28 18:50:49,0.013101851851851852,1,4,0,4
2020-11-30 18:43:18,2.301851851851852,11,80,84,164
2020-11-30 14:21:56,2.5498958333333333,1,4,4,8
2020-11-29 16:31:30,1.7847222222222223,22,114,90,204
2020-11-27 21:41:30,0.0026157407407407405,1,2,2,4
2020-11-27 21:04:55,0.012418981481481482,1,4,3,7
2020-11-30 20:55:56,3.0580555555555557,8,80,53,133
2020-12-11 14:24:21,13.785601851851851,1,11,0,11
2020-11-27 13:40:42,0.011967592592592592,2,2,0,2
2020-11-27 13:34:58,0.05108796296296296,1,1,1,2
2020-12-01 08:49:27,4.539699074074074,7,298,81,379
2020-11-26 22:47:36,0.006828703703703704,1,1,1,2
2020-11-27 15:26:46,0.7445023148148148,5,50,37,87
2020-11-26 22:06:27,0.070625,1,8,8,16
2020-11-26 19:12:02,0.004363425925925926,1,0,6,6
2020-12-02 15:18:28,6.1650578703703705,5,81,30,111
2020-11-27 17:25:21,1.2721412037037036,1,1,1,2
2020-11-29 16:27:01,3.181111111111111,3,11,10,21
2020-12-11 14:38:38,15.79787037037037,10,968,680,1648
2020-11-30 16:11:10,4.316111111111111,3,10,10,20
2020-11-27 12:21:20,1.2810185185185186,8,88,22,110
2020-11-30 19:05:08,5.162638888888889,2,223,31,254
2020-11-26 21:23:37,1.3378587962962962,3,23,12,35
2020-12-04 14:08:29,20.82300925925926,53,2560,2606,5166
2020-11-25 17:02:16,1.3514351851851851,5,262,24,286
2020-11-27 15:52:59,3.0379976851851853,9,44,36,80
2020-11-25 19:02:16,1.1380092592592592,2,50,4,54
2020-11-30 01:13:08,5.423622685185185,5,172,7,179
2020-11-24 22:51:25,0.3935763888888889,1,52,0,52
2020-11-26 17:43:43,2.1832291666666666,1,52,0,52
2020-11-25 22:38:22,1.7037152777777778,1,20,0,20
2020-12-11 14:40:14,17.381215277777777,2,18,0,18
2020-11-25 21:06:05,1.892800925925926,7,203,58,261
2020-11-24 14:35:12,0.6325810185185186,5,6,5,11
2020-11-24 15:11:47,0.6584953703703704,2,14,1,15
2020-11-24 14:50:26,0.6524421296296297,2,4,10,14
2020-11-24 01:14:49,0.1153125,2,12,8,20
2020-11-23 21:02:32,0.055266203703703706,1,9,12,21
2020-11-23 20:33:13,0.04178240740740741,4,203,202,405
2020-11-23 18:56:45,0.058368055555555555,3,30,10,40
2020-11-29 15:57:44,5.958726851851852,25,7638,3940,11578
2020-11-24 16:04:47,0.9817361111111111,1,1,1,2
2020-11-27 17:19:16,4.051122685185185,2,87,2,89
2020-12-09 16:13:57,27.107453703703705,36,1601,546,2147
2020-11-23 16:09:51,0.20585648148148147,3,159,0,159
2020-11-30 07:34:40,7.433217592592593,38,8269,3966,12235
2020-11-23 18:57:28,0.9308912037037037,2,4,11,15
2020-12-07 15:58:38,14.963032407407407,15,12470,5043,17513
2020-11-22 03:58:11,0.13260416666666666,1,51,51,102
2020-11-23 19:41:24,2.917175925925926,13,539,55,594
2020-11-20 21:07:22,0.020104166666666666,1,1,1,2
2020-11-20 14:27:25,0.008564814814814815,1,4,0,4
2020-11-23 10:51:16,2.906840277777778,1,61,0,61
2020-11-20 18:33:55,0.24105324074074075,1,2,2,4
2020-11-23 10:51:54,3.0885300925925927,2,38,0,38
2020-11-20 05:26:33,0.003553240740740741,3,33,29,62
2020-12-01 15:16:49,11.510150462962963,2,8,4,12
2020-11-23 10:52:30,3.5256944444444445,1,20,0,20
2020-11-19 21:44:21,0.027291666666666665,3,16,23,39
2020-11-19 20:45:06,0.04320601851851852,1,1,1,2
2020-11-19 16:56:42,0.0052893518518518515,1,10,6,16
2020-11-19 18:59:31,0.10526620370370371,2,24,13,37
2020-12-07 21:38:40,18.225625,26,539,185,724
2020-11-23 12:28:30,3.9194097222222224,1,13,11,24
2020-11-23 16:15:02,4.143692129629629,10,48,21,69
2020-12-14 04:05:25,24.644131944444446,31,965,513,1478
2020-11-19 10:41:02,0.027800925925925927,1,1,0,1
2020-11-19 14:17:18,0.1943287037037037,1,1,1,2
2020-11-24 18:22:26,5.708240740740741,24,568,218,786
2020-11-19 16:24:12,0.6455092592592593,1,1,1,2
2020-11-18 23:04:25,0.012106481481481482,1,1,1,2
2020-11-18 23:56:48,0.055810185185185185,2,8,4,12
2020-11-18 23:35:23,0.04181712962962963,1,1,1,2
2020-11-19 15:41:42,0.7551388888888889,4,94,48,142
2020-11-19 15:43:15,0.7973842592592593,3,121,17,138
2020-11-18 20:51:29,0.016898148148148148,2,11,9,20
2020-11-23 09:48:11,4.556712962962963,2,93,1,94
2020-11-18 18:22:28,0.042118055555555554,2,133,1,134
2020-11-18 17:00:12,0.014537037037037038,1,42,1,43
2020-11-18 17:15:26,0.04006944444444444,1,29,8,37
2020-11-18 16:14:15,0.05364583333333333,6,300,277,577
2020-11-18 15:02:51,0.015775462962962963,1,1,1,2
2020-11-18 18:06:30,0.15063657407407408,5,191,21,212
2020-11-19 09:47:25,0.9378472222222223,3,1390,181,1571
2020-11-23 14:58:52,5.181226851851852,2,4,4,8
2020-11-18 15:15:54,0.34216435185185184,1,8,1,9
2020-11-18 15:25:01,0.3665625,1,1,1,2
2020-11-18 15:30:29,0.47932870370370373,1,1,1,2
2020-11-18 00:00:44,0.02599537037037037,1,1,1,2
2020-11-17 21:50:59,0.07363425925925926,4,18,7,25
2020-11-17 20:11:30,0.025902777777777778,3,22,610,632
2020-11-24 18:55:01,11.02199074074074,48,14851,6363,21214
2020-11-17 19:01:46,0.07050925925925926,1,13,9,22
2020-11-17 19:03:04,0.14708333333333334,5,87,191,278
2020-11-20 18:59:07,3.103923611111111,3,17,17,34
2020-11-27 17:35:34,10.047789351851852,8,11153,4977,16130
2020-11-17 15:35:38,0.038009259259259257,7,97,46,143
2020-11-18 15:09:26,1.0332060185185186,1,2,2,4
2020-11-17 13:52:13,0.0366087962962963,1,2,6,8
2020-11-17 11:47:57,0.006238425925925926,3,4453,2015,6468
2020-11-17 13:58:45,0.12623842592592593,5,210,186,396
2020-11-20 18:05:04,7.975636574074074,30,395,251,646
2020-11-17 19:00:42,0.5995023148148149,1,3,33,36
2020-11-23 22:25:36,6.749270833333333,20,218,123,341
2020-11-17 02:43:43,0.12711805555555555,16,2844,1764,4608
2020-11-17 08:36:50,0.3299537037037037,1,56,0,56
2020-11-19 20:46:05,3.017326388888889,2,2,2,4
2020-11-16 19:44:19,0.062407407407407404,4,8,5,13
2020-11-16 15:21:20,0.004629629629629629,1,4,2,6
2020-11-25 21:55:00,9.280914351851852,21,15963,7533,23496
2020-11-18 18:17:46,2.1524537037037037,2,9,3,12
2020-11-16 11:59:10,0.031053240740740742,1,5,1,6
2020-11-18 14:58:09,2.171284722222222,5,25,20,45
2020-11-16 10:04:47,0.04125,1,24,0,24
2020-11-16 10:04:38,0.12873842592592594,1,24,0,24
2020-11-19 18:18:07,3.865462962962963,7,8519,3640,12159
2020-11-17 11:23:09,1.5983796296296295,9,4483,2072,6555
2020-11-16 10:01:29,0.6633101851851851,2,45,1,46
2020-11-18 18:19:33,3.5478703703703705,1,3,3,6
2020-11-16 13:05:31,2.289016203703704,2,2,2,4
2020-11-16 16:43:00,3.0261342592592593,18,1360,886,2246
2020-11-18 16:06:26,4.847488425925926,13,5303,3415,8718
2020-11-13 19:31:40,0.012974537037037038,2,20,1,21
2020-11-13 19:07:26,0.035555555555555556,1,76,3,79
2020-11-13 14:58:27,0.014710648148148148,2,17,8,25
2020-11-13 17:10:27,0.1385648148148148,5,38,21,59
2020-11-13 15:57:32,0.8805208333333333,4,386,338,724
2020-11-16 13:18:26,11.421828703703703,13,7750,1981,9731
2020-11-13 16:59:31,37.19778935185185,27,7952,6614,14566
2020-11-12 16:47:23,16.565289351851852,5,36764,13984,50748
2020-11-12 16:53:23,0.06292824074074074,2,59,12,71
2020-11-18 19:42:13,6.2071875,2,50,2,52
2020-11-13 22:07:18,1.4543171296296296,9,96,116,212
2020-11-12 18:52:41,0.34216435185185184,1,26,26,52
2020-11-18 15:48:32,6.2332523148148145,11,100,96,196
2020-11-12 10:29:37,0.014421296296296297,1,2,2,4
2020-11-12 17:19:38,0.7427314814814815,1,54,4,58
2020-11-26 07:03:03,14.261261574074075,2,19692,9907,29599
2020-11-11 23:31:42,0.013229166666666667,2,2,2,4
2020-11-12 14:47:09,0.7255555555555555,1,3,3,6
2020-11-12 19:08:27,1.1111111111111112,7,135,39,174
2020-11-11 15:28:24,0.022222222222222223,1,1,1,2
2020-11-11 14:41:39,0.009664351851851851,1,1,1,2
2020-11-18 18:28:50,7.237025462962963,1,118,0,118
2020-11-11 14:02:07,0.044131944444444446,7,126,19,145
2020-11-11 11:54:15,0.004826388888888889,1,2,2,4
2020-11-12 18:43:00,0.947025462962963,1,140,7,147
2020-11-10 18:23:59,0.01835648148148148,2,117,117,234
2020-11-10 17:01:33,0.012650462962962962,2,4,0,4
2020-11-10 15:07:57,0.03652777777777778,2,10,11,21
2020-11-10 13:35:12,0.02340277777777778,4,132,127,259
2020-11-10 19:21:54,0.3092476851851852,2,1557,934,2491
2020-11-10 16:19:17,0.2648263888888889,5,16,7,23
2020-11-10 17:54:18,0.28216435185185185,1,26,2,28
2020-11-11 17:29:58,1.3552893518518518,1,7,7,14
2020-11-10 16:11:49,0.28425925925925927,3,112,7,119
2020-11-10 14:33:24,0.48172453703703705,1,11,8,19
2020-11-10 18:44:26,0.6924537037037037,1,16,14,30
2020-11-09 20:44:55,0.05421296296296296,1,73,0,73
2020-11-09 18:25:33,0.015393518518518518,1,2,2,4
2020-11-09 19:27:43,0.0625462962962963,4,19,3,22
2020-11-10 15:18:35,0.9216782407407408,6,2731,1192,3923
2020-11-09 17:10:10,0.04024305555555555,1,101,6,107
2020-11-09 16:32:10,0.0349537037037037,1,1,1,2
2020-11-09 17:51:39,0.14663194444444444,2,16,18,34
2020-11-10 01:49:52,0.5312268518518518,4,14,28,42
2020-11-09 17:24:42,0.3356712962962963,10,501,90,591
2020-11-08 21:57:44,0.0018865740740740742,2,1,10,11
2020-11-09 08:36:07,0.5346296296296297,1,1,1,2
2020-11-09 15:23:27,0.8393171296296297,1,1,1,2
2020-11-09 08:43:55,0.7140509259259259,1,6,0,6
2020-11-09 08:44:44,0.8855902777777778,1,2,2,4
2020-11-18 18:23:09,10.289421296296297,2,8,2,10
2020-11-08 10:00:20,0.2894791666666667,2,36,1,37
2020-11-10 16:57:21,2.5847685185185183,11,127,92,219
2020-11-08 21:45:40,0.8008333333333333,1,1,1,2
2020-11-08 14:08:14,0.4986574074074074,1,1,1,2
2020-11-08 21:44:18,0.812974537037037,1,1,1,2
2020-11-08 14:53:02,0.5481134259259259,1,6,2,8
2020-11-08 09:25:15,0.33935185185185185,1,3,3,6
2020-11-27 17:31:43,10.23133101851852,11,1119,354,1473
2020-11-10 20:33:11,3.001550925925926,1,2,2,4
2020-11-09 15:41:40,1.8800462962962963,3,64,31,95
2020-11-10 14:32:02,3.0461574074074074,3,4,3,7
2020-11-07 17:51:57,0.2535648148148148,2,3,21,24
2020-11-09 16:57:43,2.510428240740741,3,10,11,21
2020-11-11 22:58:45,29.895682870370372,25,53487,22263,75750
2020-11-07 17:45:17,0.9325231481481482,3,37,8,45
2020-11-18 18:34:28,11.989618055555555,2,74,0,74
2020-11-06 20:03:25,0.060625,1,1,2,3
2020-11-10 12:29:34,3.8604166666666666,2,105,49,154
2020-11-18 18:33:04,12.129953703703704,1,79,0,79
2020-11-18 18:37:15,12.13349537037037,1,80,0,80
2020-11-06 16:45:47,0.15078703703703702,1,1,1,2
2020-11-09 12:50:38,2.991875,3,11,11,22
2020-11-06 16:19:42,0.5700462962962963,1,1,1,2
2020-11-06 08:17:04,0.4392013888888889,1,404,56,460
2020-11-09 20:47:39,3.9861921296296297,10,3084,510,3594
2020-11-09 16:39:56,3.8157060185185183,13,1031,564,1595
2020-11-06 11:20:58,0.6369675925925926,1,8,4,12
2020-11-05 20:13:52,0.0362037037037037,7,160,38,198
2020-11-06 08:09:55,0.616875,1,65,0,65
2020-11-11 19:53:37,6.164664351851852,10,130,136,266
2020-11-05 22:20:58,0.2645138888888889,5,22,12,34
2020-11-05 16:42:25,0.06099537037037037,1,1,1,2
2021-08-04 12:42:47,57.909432870370374,5,115,40,155
2020-11-06 08:22:53,0.7506481481481482,1,80,0,80
2020-11-10 12:11:03,7.766238425925926,18,553,295,848
2020-11-05 12:48:36,0.15625,1,1,1,2
2020-11-06 04:15:14,1.390787037037037,6,88,71,159
2020-11-05 21:01:16,0.7402199074074074,5,63,15,78
2020-11-06 11:19:59,1.4469791666666667,2,53,12,65
2020-11-09 13:55:23,4.716076388888889,1,2,1,3
2020-11-04 22:24:49,0.0949537037037037,3,138,199,337
2020-11-04 18:17:57,0.04181712962962963,1,1,1,2
2020-11-04 16:51:21,0.03980324074074074,5,8,10,18
2020-11-04 16:41:46,0.016319444444444445,2,151,5,156
2020-11-04 16:20:15,0.01150462962962963,1,66,0,66
2020-11-04 15:42:19,0.006273148148148148,1,5,5,10
2020-11-04 14:44:36,0.011631944444444445,2,10,7,17
2020-11-04 14:38:03,0.1618287037037037,1,2,2,4
2020-11-04 16:30:43,0.2511226851851852,1,151,41,192
2020-11-19 20:06:02,15.611018518518518,7,20605,8107,28712
2020-11-04 14:02:28,0.4758912037037037,1,1,1,2
2020-12-11 14:41:30,37.51726851851852,2,29,1,30
2020-11-24 13:40:54,27.65761574074074,21,18753,7843,26596
2020-11-03 21:57:13,0.05050925925925926,4,158,73,231
2020-11-03 21:33:27,0.02133101851851852,2,214,110,324
2020-11-09 14:01:00,5.757291666666666,3,4,3,7
2020-11-03 20:57:18,0.08501157407407407,8,38,31,69
2020-11-03 20:50:55,0.14179398148148148,1,18,19,37
2020-11-03 20:13:34,0.11907407407407407,1,48,46,94
2020-11-06 08:21:14,2.6436689814814813,2,33,0,33
2020-11-03 17:04:54,0.029699074074074076,1,3,1,4
2020-11-03 14:49:30,0.0011342592592592593,1,3,1,4
2020-11-06 08:19:13,2.7934722222222224,1,5,0,5
2020-11-03 15:10:23,0.17211805555555557,2,35,10,45
2020-11-06 08:34:24,2.8500462962962962,3,44,3,47
2020-11-03 12:56:42,0.08233796296296296,1,1,4,5
2020-11-06 08:15:12,3.5128819444444446,1,63,0,63
2020-11-06 08:13:45,3.529548611111111,2,61,0,61
2020-11-02 19:21:56,0.0014930555555555556,1,2,0,2
2020-11-02 19:10:10,0.008842592592592593,1,1,0,1
2020-11-02 19:12:34,0.025416666666666667,1,1,1,2
2020-11-04 16:21:26,1.9470601851851852,2,120,2,122
2020-11-02 17:27:04,2.8625925925925926,7,195,40,235
2020-11-02 15:43:29,0.005706018518518518,1,3,1,4
2020-11-02 15:26:26,0.0018981481481481482,1,26,22,48
2020-11-02 15:26:38,0.010011574074074074,1,6,1,7
2020-11-02 13:53:18,0.025925925925925925,1,1,1,2
2020-11-19 15:37:28,19.84173611111111,33,23963,10482,34445
2020-11-02 23:50:26,0.9184722222222222,1,6,7,13
2020-11-05 08:03:20,3.590752314814815,3,64,4,68
2020-11-02 13:47:37,1.5647453703703704,1,12,11,23
2020-11-03 15:33:02,3.2310185185185185,4,3863,1418,5281
2020-11-01 15:21:58,1.2497569444444445,1,1,1,2
2020-11-11 17:28:10,11.762824074074073,27,28983,16528,45511
2020-11-02 05:17:44,2.783275462962963,2,345,1,346
2020-10-30 19:27:20,0.002951388888888889,1,4,4,8
2020-11-01 22:31:55,2.1846412037037037,3,1728,289,2017
2020-10-30 20:45:39,1.0050578703703703,5,1765,312,2077
2020-11-02 05:19:39,2.537002314814815,2,6,6,12
2020-10-30 16:37:34,0.03878472222222222,1,14,13,27
2020-10-30 18:20:19,0.12501157407407407,5,465,97,562
2020-11-02 11:33:50,3.0094097222222222,2,131,150,281
2020-10-30 20:25:40,0.4476041666666667,2,40,52,92
2020-10-30 13:15:42,0.16516203703703702,2,11,11,22
2020-11-06 08:25:53,7.213877314814815,1,18,0,18
2020-11-06 08:26:08,7.230439814814815,1,36,0,36
2020-11-06 08:25:34,7.232916666666667,2,39,4,43
2020-11-06 08:24:32,7.254351851851852,2,24,0,24
2020-10-30 19:09:11,0.712650462962963,11,76,57,133
2020-10-30 15:22:04,0.549837962962963,1,8,8,16
2020-10-29 23:30:05,0.04503472222222222,3,2512,2231,4743
2020-10-29 21:04:20,0.03179398148148148,5,15,17,32
2020-10-29 18:05:25,0.005694444444444445,1,5,2,7
2020-10-29 17:38:12,0.9120254629629629,15,3010,5231,8241
2020-10-29 14:43:46,0.021180555555555557,1,2,0,2
2020-10-29 14:56:25,0.03596064814814815,2,22,14,36
2020-10-29 16:01:15,2.0441666666666665,3,332,189,521
2020-10-29 12:49:17,0.009328703703703704,1,2,2,4
2020-10-29 11:45:55,0.0007523148148148148,1,10,0,10
2020-10-29 14:33:33,0.519375,9,347,369,716
2020-11-03 18:17:12,5.920243055555556,3,12,2,14
2020-10-28 20:50:36,0.05820601851851852,3,14,116,130
2020-10-28 19:52:29,0.021284722222222222,1,1,1,2
2020-10-28 17:59:44,0.02141203703703704,1,46,46,92
2020-10-28 17:26:13,0.04024305555555555,3,16,11,27
2020-10-28 16:15:31,0.005509259259259259,1,1,1,2
2020-10-28 17:42:32,0.12243055555555556,1,327,292,619
2021-01-05 08:30:47,69.24244212962962,22,58420,20150,78570
2020-10-28 17:41:57,0.12811342592592592,1,33,5,38
2020-10-29 21:08:39,9.465231481481482,32,18233,11291,29524
2020-10-28 05:45:19,0.0060185185185185185,1,1,0,1
2020-10-28 15:51:33,0.923587962962963,12,420,260,680
2020-10-27 21:32:21,0.0008101851851851852,1,27,24,51
2020-10-28 14:38:59,0.7297453703703703,7,409,32,441
2020-10-27 18:39:49,0.0020601851851851853,1,4,1,5
2020-12-11 14:45:13,45.01006944444445,2,124,52,176
2020-10-27 13:52:36,1.4300925925925927,1,3,1,4
2020-10-27 18:14:13,0.23806712962962964,1,1,3,4
2020-10-27 13:07:42,0.04,2,29,18,47
2020-10-27 14:34:52,0.10534722222222222,1,1,1,2
2020-10-29 12:31:33,2.054664351851852,1,2,2,4
2020-10-29 12:23:43,2.0502083333333334,1,41,0,41
2020-10-29 12:23:30,2.051134259259259,2,46,0,46
2020-10-27 11:29:26,0.34449074074074076,1,7,7,14
2020-10-27 13:42:07,0.44149305555555557,1,1,1,2
2020-10-27 17:54:57,0.6603356481481482,1,12,2,14
2020-10-29 12:22:34,2.435613425925926,2,61,0,61
2020-10-27 11:54:50,0.4846875,3,52,45,97
2020-11-15 21:50:59,19.98550925925926,26,16752,6580,23332
2020-11-06 18:34:49,10.914618055555556,8,7176,2152,9328
2020-10-27 18:09:32,0.9080208333333334,2,10027,9096,19123
2020-10-26 22:26:03,0.11053240740740741,23,29330,28595,57925
2020-10-26 18:39:26,0.0010763888888888889,1,1,1,2
2020-10-27 18:21:55,4.193159722222222,14,12945,10567,23512
2020-10-26 19:01:09,0.11578703703703704,7,190,248,438
2020-10-27 18:09:56,1.0667824074074075,7,10400,9377,19777
2020-10-26 17:19:11,0.01957175925925926,1,2,2,4
2020-10-26 17:53:28,0.048657407407407406,1,3,0,3
2020-10-26 15:05:17,0.011215277777777777,1,1,1,2
2020-10-27 14:37:05,0.9943287037037037,3,9,2,11
2020-10-26 14:04:21,0.0016782407407407408,1,5,6,11
2020-10-26 16:00:19,0.10069444444444445,1,2,2,4
2020-10-26 16:32:28,0.14078703703703704,1,12,0,12
2020-10-26 13:23:13,0.0069560185185185185,1,1,1,2
2020-10-26 14:22:30,0.1878240740740741,2,7,7,14
2020-10-26 12:08:34,0.04936342592592593,1,4,4,8
2020-10-26 16:28:16,0.24881944444444445,9,70,57,127
2020-10-29 12:21:54,3.1412037037037037,1,148,0,148
2020-10-29 12:21:12,3.5194907407407405,4,85,0,85
2020-10-26 12:12:32,0.7279166666666667,2,10,6,16
2020-10-26 12:59:06,0.8301388888888889,1,3,31,34
2020-10-26 12:32:37,0.8609259259259259,1,3,3,6
2020-10-26 18:48:26,1.4668981481481482,27,150,47,197
2020-10-25 07:20:47,0.3196643518518518,2,149,3,152
2020-10-26 13:29:56,1.8568518518518518,2,5,3,8
2020-10-29 12:19:48,4.9946064814814815,1,72,0,72
2020-10-26 13:41:58,2.641840277777778,15,226,28,254
2020-10-29 12:19:35,5.001967592592592,1,72,0,72
2020-10-24 19:33:48,0.4986226851851852,1,3,5,8
2020-10-29 12:19:18,5.223101851851852,11,50,19,69
2020-10-30 14:25:48,7.819467592592592,20,4310,3089,7399
2020-10-26 09:27:48,2.736273148148148,2,121,48,169
2020-10-23 14:58:06,0.10881944444444444,3,97,1,98
2020-10-23 14:53:54,0.3456134259259259,1,9,0,9
2020-10-26 12:56:57,3.347685185185185,1,1,1,2
2020-10-23 14:53:38,0.4854513888888889,1,9,0,9
2020-10-23 14:52:22,0.5230555555555556,1,384,0,384
2020-10-27 13:25:08,4.466076388888889,13,2846,1473,4319
2020-10-26 12:15:06,3.619849537037037,4,26,8,34
2020-10-22 21:19:41,0.0015972222222222223,1,2,2,4
2020-10-23 14:29:15,0.7353009259259259,2,47,14,61
2020-10-23 14:34:07,0.76125,1,2,2,4
2020-10-22 20:10:16,0.011354166666666667,1,4,4,8
2020-10-30 15:23:17,9.013460648148149,47,17001,12234,29235
2020-10-22 19:48:53,0.05709490740740741,2,37,19,56
2020-10-22 19:01:24,0.0465625,7,41,30,71
2020-10-22 18:26:56,0.11076388888888888,2,8,12,20
2020-10-22 13:08:38,0.020671296296296295,1,1,0,1
2020-10-22 14:41:42,0.09079861111111111,1,4,3,7
2020-10-22 15:16:22,0.16506944444444444,2,112,22,134
2020-10-22 11:55:32,0.0665162037037037,1,1,1,2
2020-10-22 16:54:26,0.2778009259259259,3,24,13,37
2020-10-23 13:58:19,3.192199074074074,22,14525,2188,16713
2020-10-29 12:29:55,7.107222222222222,3,310,0,310
2020-10-22 09:48:29,0.013854166666666667,1,4,0,4
2020-10-22 21:26:22,0.7612152777777778,12,2384,699,3083
2020-10-22 13:30:50,0.3426851851851852,2,161,26,187
2020-10-22 09:02:12,0.3534953703703704,3,102402,20252,122654
2020-10-23 14:45:55,1.7831018518518518,8,73,47,120
2020-10-21 17:57:45,0.011574074074074073,4,21,21,42
2020-10-21 17:06:23,0.010115740740740741,1,0,1,1
2020-10-22 20:13:49,1.2122453703703704,3,51,75,126
2020-10-21 15:27:21,0.06077546296296296,2,27,13,40
2020-10-22 13:39:02,1.1305787037037036,8,125,13,138
2020-10-21 09:49:59,0.025925925925925925,3,38,8,46
2020-10-23 13:54:46,2.2109259259259257,1,4,3,7
2020-10-23 14:29:38,2.685474537037037,1,16,5,21
2020-10-20 22:17:40,0.010127314814814815,1,6,5,11
2020-10-21 15:18:52,7.234375,5,396,75,471
2020-10-20 19:07:52,0.0875925925925926,4,145,131,276
2020-10-27 11:31:08,6.774861111111111,6,17438,10974,28412
2020-10-21 12:05:54,0.9759953703703703,1,15,0,15
2020-10-20 15:02:48,0.0050810185185185186,1,40,21,61
2020-10-20 14:11:03,0.005358796296296296,1,37,0,37
2020-10-22 13:19:00,2.139085648148148,24,558,171,729
2020-10-20 11:45:49,0.5855787037037037,1,102,5,107
2020-10-22 15:42:23,2.860520833333333,18,5048,728,5776
2020-10-19 20:02:42,0.021828703703703704,2,3,2,5
2020-10-20 11:55:40,0.6875,3,7,4,11
2020-10-19 19:49:48,0.08776620370370371,1,6,6,12
2020-10-20 13:50:48,0.968738425925926,4,58,12,70
2020-10-19 17:48:49,0.1686574074074074,1,1,1,2
2020-11-05 14:38:30,17.06099537037037,2,5,3,8
2020-10-21 12:23:56,2.1048263888888887,1,79,0,79
2020-10-22 10:34:05,3.40375,10,52,25,77
2020-10-19 13:15:52,0.6291550925925926,14,274,103,377
2020-10-19 00:18:09,0.18908564814814816,2,13,12,25
2020-10-19 12:23:15,0.7393287037037037,2,10,10,20
2020-10-19 10:14:53,0.9042361111111111,1,4,4,8
2020-10-19 12:43:26,1.0104050925925927,1,1,1,2
2020-10-20 11:50:48,2.109398148148148,1,1,1,2
2020-10-21 12:06:08,3.3194328703703704,13,14890,4377,19267
2020-10-17 20:46:48,0.04633101851851852,2,5,9,14
2020-10-21 12:24:13,3.8537268518518517,1,1,1,2
2020-10-19 19:59:31,2.3056134259259258,3,13,10,23
2020-10-19 10:50:53,1.9482986111111111,2,27,4,31
2020-10-21 13:24:44,4.156261574074074,1,333,0,333
2020-10-24 07:16:07,7.191655092592592,3,83,1,84
2020-10-20 08:39:13,3.266875,7,15109,4966,20075
2020-10-19 11:08:35,2.386435185185185,1,16,20,36
2020-10-22 13:14:55,5.49275462962963,5,18607,5179,23786
2020-10-17 18:33:22,0.916875,4,682,702,1384
2020-10-19 15:57:39,2.8188541666666667,7,210,129,339
2020-10-21 12:41:41,4.768506944444445,2,53,1,54
2020-10-17 21:31:53,1.162199074074074,2,0,4,4
2020-10-21 12:31:41,4.801111111111111,1,100,0,100
2020-10-28 18:59:15,12.35679398148148,13,34044,16450,50494
2020-10-16 13:05:29,0.32104166666666667,1,32,52,84
2020-10-16 04:22:44,0.006319444444444444,3,19,11,30
2020-10-16 07:35:39,0.17543981481481483,2,5,0,5
2020-10-15 23:36:32,0.022048611111111113,1,2,2,4
2020-10-16 07:23:45,0.4138310185185185,1,2,1,3
2020-10-16 07:19:51,0.4784027777777778,1,18,9,27
2020-10-21 12:02:41,5.687465277777778,4,117,3,120
2020-10-16 07:11:19,0.5061689814814815,3,30,55,85
2020-10-15 20:21:10,0.04331018518518519,1,1,1,2
2020-10-15 19:23:24,0.022824074074074073,3,11,9,20
2020-10-16 06:57:03,0.5765277777777778,1,2,2,4
2020-10-19 06:14:30,3.6047106481481483,3,3,3,6
2020-10-21 12:30:01,5.892083333333333,1,47,0,47
2020-10-16 07:12:10,0.6845949074074074,1,0,2,2
2020-10-16 08:15:49,0.7447337962962963,1,1,1,2
2020-10-15 14:30:34,0.013020833333333334,1,24,5,29
2020-10-23 21:05:52,8.355254629629629,17,20928,5726,26654
2020-10-15 19:55:01,0.7619444444444444,2,114,0,114
2020-10-16 07:06:52,2.5107060185185186,27,2881,1563,4444
2020-10-14 21:48:51,0.07467592592592592,2,2,2,4
2020-10-15 09:05:09,0.6058680555555556,1,352,2,354
2020-10-14 16:50:43,0.02008101851851852,1,17,3,20
2020-10-14 16:05:03,0.01752314814814815,3,14,13,27
2020-10-14 09:30:03,0.006678240740740741,2,9,4,13
2020-10-14 13:31:02,0.22417824074074075,1,19,0,19
2020-10-14 15:41:46,0.8292824074074074,10,427,61,488
2020-10-19 17:42:46,7.0115625,20,769,204,973
2020-10-13 20:22:30,0.1835763888888889,1,1,1,2
2020-10-13 15:07:03,0.0849074074074074,4,25,8,33
2020-10-13 14:00:20,0.007395833333333333,1,36,36,72
2020-10-13 12:34:23,0.11179398148148148,2,59,9,68
2020-10-13 08:50:41,0.0027546296296296294,1,1,0,1
2020-10-14 17:30:59,1.918298611111111,2,38,1,39
2020-10-14 17:10:31,1.6208564814814814,2,44,1,45
2020-10-13 13:46:45,0.9833333333333333,8,3055,370,3425
2020-10-12 15:56:11,0.027789351851851853,1,2,0,2
2020-10-12 13:10:53,0.016377314814814813,1,1,1,2
2020-10-15 09:26:08,2.9955208333333334,1,7,7,14
2020-10-16 06:49:14,3.8887152777777776,1,1,16,17
2020-10-15 07:42:08,2.9458796296296295,2,59,14,73
2020-10-13 13:42:28,1.190462962962963,2,9,2,11
2020-10-12 12:45:16,14.118344907407407,4,9,9,18
2020-10-14 16:56:13,2.3851851851851853,1,59,0,59
2020-10-12 11:45:13,0.35203703703703704,1,2,1,3
2020-10-12 07:58:59,0.3230208333333333,1,1,1,2
2020-10-12 11:44:02,0.5293287037037037,1,26,10,36
2020-10-12 08:07:00,0.4695023148148148,1,51,51,102
2020-10-14 15:35:00,8.83974537037037,5,10682,2463,13145
2020-10-12 16:24:25,3.0502430555555557,11,10141,8957,19098
2020-10-11 20:45:01,0.5956018518518519,1,3,3,6
2020-10-12 08:10:18,1.525949074074074,1,1,1,2
2020-10-12 10:09:21,1.9024074074074073,1,5,5,10
2020-10-11 01:08:09,0.5310416666666666,1,1,1,2
2020-10-10 00:01:16,0.029594907407407407,1,3,1,4
2020-10-10 07:55:12,0.36689814814814814,1,12,0,12
2020-10-09 23:24:11,0.011157407407407408,1,1,1,2
2020-10-13 09:06:16,3.717175925925926,5,156,7,163
2020-10-09 15:16:36,0.002905092592592593,1,0,50,50
2020-10-09 15:17:16,0.012314814814814815,1,116,112,228
2020-10-09 14:38:25,11.196921296296296,3,13,4,17
2020-10-09 15:10:33,0.4246759259259259,1,51,29,80
2020-10-09 09:15:08,0.21206018518518518,1,1,1,2
2020-10-09 01:22:22,0.018784722222222223,2,5,5,10
2020-10-09 09:16:59,0.5556481481481481,1,2,2,4
2020-10-08 18:12:39,0.044444444444444446,2,20,20,40
2020-10-18 18:51:25,12.390335648148149,55,13838,8204,22042
2020-10-08 11:21:15,0.01724537037037037,2,3,2,5
2020-10-08 03:04:19,0.029131944444444443,3,50,31,81
2020-10-08 02:05:03,0.023680555555555555,2,8,18,26
2020-10-09 16:13:23,1.7087152777777779,9,45,41,86
2020-10-08 12:36:01,0.8549305555555555,2,4,4,8
2020-10-08 17:06:35,1.0785185185185184,5,1414,495,1909
2020-10-07 20:46:04,0.2829050925925926,3,77,3,80
2020-10-07 15:20:44,8.786157407407407,6,11335,1672,13007
2020-10-07 09:20:06,0.0026041666666666665,1,2,1,3
2020-10-07 20:36:09,0.5872800925925926,1,11,6,17
2020-10-21 12:29:40,14.489305555555555,3,28,1,29
2020-11-10 19:02:34,34.91274305555555,5,55662,19907,75569
2020-10-06 22:02:30,0.26329861111111114,1,1,1,2
2020-10-06 12:46:56,0.020439814814814813,2,6,0,6
2020-10-06 13:32:52,0.08773148148148148,1,1,1,2
2020-10-06 22:16:00,0.47822916666666665,2,4,0,4
2020-10-06 12:46:18,0.13337962962962963,2,96,0,96
2020-10-06 10:19:22,0.055636574074074074,2,134,9,143
2020-10-07 20:49:21,1.598125,1,311,0,311
2020-10-06 01:31:49,0.03903935185185185,3,50,43,93
2020-10-06 13:23:32,0.7200347222222222,1,14,4,18
2020-10-07 14:50:22,4.722164351851852,17,1411,554,1965
2020-10-06 13:12:04,0.7523958333333334,1,1,1,2
2020-10-06 15:33:52,0.8926620370370371,1,3,3,6
2020-10-07 20:37:10,2.1946296296296297,1,15,9,24
2020-10-06 09:25:21,0.736550925925926,2,10,10,20
2020-10-06 10:22:04,0.7977083333333334,5,96,86,182
2020-10-05 15:23:57,0.01902777777777778,1,24,8,32
2020-10-05 15:01:04,0.014756944444444444,1,39,25,64
2020-10-06 10:47:17,0.8594097222222222,3,75421,17205,92626
2020-10-07 20:37:40,2.278576388888889,1,12,0,12
2020-10-05 13:45:48,0.0011226851851851851,1,3,1,4
2020-10-19 06:56:09,13.797627314814815,7,48,39,87
2020-10-05 11:50:57,0.03502314814814815,2,17,17,34
2020-10-07 20:38:14,2.4407060185185183,1,64,0,64
2020-10-05 08:49:39,0.006296296296296296,1,1,0,1
2020-10-05 08:49:17,0.2070949074074074,2,8,0,8
2020-11-05 20:10:44,32.77078703703704,13,117168,39395,156563
2020-10-04 21:39:24,1.027638888888889,1,1,1,2
2020-10-07 20:40:53,4.105011574074074,2,37,0,37
2020-10-05 12:21:22,2.002546296296296,1,6,6,12
2020-10-14 11:40:25,11.140069444444444,3,63,5,68
2020-10-02 19:58:14,0.005613425925925926,1,2,2,4
2020-10-07 20:35:28,5.145578703703704,1,131,0,131
2020-10-05 10:33:15,2.769212962962963,1,12,2,14
2020-10-05 13:12:05,2.9907060185185186,8,3494,92,3586
2020-10-04 16:42:31,2.3842824074074076,5,43,26,69
2020-10-05 13:40:45,3.6648032407407407,4,429,189,618
2020-10-05 13:19:17,3.6811574074074076,1,5,8,13
2020-10-05 08:22:13,3.5468865740740743,3,1158,538,1696
2020-10-01 21:27:46,0.09957175925925926,3,46,6,52
2020-10-01 21:18:48,0.10413194444444444,1,1,5,6
2020-10-01 18:13:29,0.03615740740740741,3,7,6,13
2020-10-01 16:51:10,0.011747685185185186,2,6,5,11
2020-10-01 16:15:42,0.0037847222222222223,1,10,3,13
2020-10-01 16:19:29,0.050972222222222224,3,108,106,214
2020-10-01 14:34:32,0.021863425925925925,1,1,1,2
2020-10-01 13:52:37,0.02119212962962963,1,1,2,3
2020-10-05 07:57:16,3.789085648148148,1,1,0,1
2020-10-06 21:31:22,5.407974537037037,3,198,16,214
2020-10-01 11:42:07,0.05571759259259259,1,1,1,2
2020-10-01 12:50:08,0.5749537037037037,1,41,52,93
2020-10-01 17:07:05,1.8141087962962963,14,228,157,385
2020-09-30 21:00:07,0.0004976851851851852,1,2,1,3
2020-09-30 20:58:03,0.06945601851851851,2,12,11,23
2020-09-30 17:44:59,0.009652777777777777,1,1,1,2
2020-10-01 08:41:30,0.6357407407407407,1,16,16,32
2020-09-30 14:43:59,0.0078125,1,114,107,221
2020-09-30 16:39:13,0.09004629629629629,1,2,1,3
2020-09-30 16:12:03,0.0971875,2,9,5,14
2020-10-01 15:38:50,1.1102199074074075,25,761,482,1243
2020-09-30 11:44:41,0.011805555555555555,1,2,2,4
2020-09-30 10:53:20,0.0017592592592592592,1,4,2,6
2020-09-30 10:41:25,0.002037037037037037,1,1,1,2
2020-09-30 17:27:49,0.4383449074074074,2,72,45,117
2020-10-01 12:50:26,1.2665856481481481,1,15,0,15
2020-10-01 04:33:02,1.305925925925926,10,137,152,289
2020-09-30 13:03:25,0.5707523148148148,2,18,25,43
2020-10-01 02:14:15,1.2095486111111111,5,4,5,9
2020-10-01 12:51:26,1.7002662037037037,1,35,2,37
2020-09-29 18:06:42,0.008090277777777778,1,9,6,15
2020-09-30 08:05:14,0.6082291666666667,2,8,9,17
2020-09-29 17:42:10,0.009305555555555555,1,6,2,8
2020-09-30 09:53:35,0.8125462962962963,1,114,2,116
2020-10-05 08:17:15,5.892615740740741,2,10,6,16
2020-09-29 16:26:27,0.744386574074074,6,82,43,125
2020-09-29 07:18:02,0.0171875,1,12,3,15
2020-10-01 12:45:23,2.385196759259259,1,54,0,54
2020-10-01 12:46:27,2.3892708333333332,2,61,1,62
2020-09-28 22:25:25,0.055706018518518516,2,55,0,55
2020-09-29 03:20:04,0.5337268518518519,1,2,3,5
2020-09-29 07:56:58,0.4886226851851852,1,2,1,3
2020-09-29 17:38:47,0.895162037037037,1,135,0,135
2020-09-29 14:41:19,0.7968402777777778,3,319,53,372
2020-09-28 17:40:10,0.018159722222222223,1,13,1,14
2020-10-01 14:54:29,2.939328703703704,6,7,3,10
2020-09-28 14:22:59,0.022974537037037036,2,51,32,83
2020-10-05 13:58:45,10.910856481481481,20,1130,1018,2148
2020-09-28 09:08:39,0.0012847222222222223,1,8,7,15
2020-10-07 23:09:24,9.734930555555556,43,15487,2676,18163
2020-09-28 08:06:39,0.6938888888888889,3,194,68,262
2020-09-27 20:27:19,3.7465277777777777,19,5315,1802,7117
2020-09-28 07:08:04,1.5170949074074074,5,378,332,710
2020-09-28 14:45:43,2.8088888888888888,6,297,85,382
2020-09-28 12:20:11,2.7303935185185186,1,19,3,22
2020-09-29 19:16:44,4.022164351851852,7,2138,674,2812
2020-09-25 17:47:13,0.0071643518518518514,1,7,2,9
2020-09-25 16:20:49,0.03457175925925926,1,157,20,177
2020-09-25 15:47:22,0.0021527777777777778,1,0,4,4
2020-09-28 13:51:49,2.9345833333333333,1,61,2,63
2020-09-25 15:01:08,0.02730324074074074,3,1,6,7
2020-09-25 15:48:13,0.08251157407407407,1,1,1,2
2020-10-01 13:11:43,6.0241087962962965,1,2,2,4
2020-10-05 10:34:14,10.010717592592593,3,11,5,16
2020-09-25 12:35:50,0.13258101851851853,2,3,2,5
2020-09-25 12:00:37,0.1121412037037037,1,7,5,12
2020-09-28 08:09:27,2.984583333333333,1,34,7,41
2020-09-25 09:23:56,0.08439814814814815,3,1125,175,1300
2020-09-25 08:24:14,0.3494791666666667,5,13,9,22
2020-09-28 12:31:47,3.640578703703704,1,115,3,118
2020-09-24 21:07:16,0.011967592592592592,2,3,115,118
2020-09-25 16:20:39,0.8646296296296296,4,10,9,19
2020-09-24 21:22:05,0.14221064814814816,1,30,12,42
2020-09-25 14:12:47,0.9180208333333333,6,132,118,250
2020-09-24 14:59:22,0.025949074074074076,2,33,0,33
2020-09-24 13:56:40,0.04622685185185185,6,7,8,15
2020-09-25 09:09:10,0.9251273148148148,4,188,189,377
2020-09-24 09:37:30,0.11185185185185186,1,1,1,2
2020-09-24 12:53:54,0.6601157407407408,1,676,129,805
2020-09-24 08:34:19,0.5218981481481482,1,49,16,65
2020-10-01 12:48:52,7.717928240740741,1,12,0,12
2020-09-24 13:24:41,0.7629166666666667,3,391,354,745
2020-09-23 17:20:46,1.8979050925925927,21,16040,6499,22539
2020-09-23 17:56:21,0.06886574074074074,1,1,1,2
2020-09-23 17:17:01,0.1290625,2,7,5,12
2020-09-23 09:16:19,0.34511574074074075,7,207,69,276
2020-09-22 22:27:29,0.007453703703703704,2,11,7,18
2020-09-23 17:23:46,0.8103587962962963,5,43,38,81
2020-09-24 08:54:37,1.6645254629629629,3,46,9,55
2020-09-22 16:21:53,0.03864583333333333,4,22,11,33
2020-09-22 18:44:43,0.13796296296296295,2,8,0,8
2020-09-22 14:37:11,0.004421296296296296,1,31,41,72
2020-09-22 22:26:13,0.3709027777777778,1,61,0,61
2020-09-22 14:17:49,0.04681712962962963,1,5,5,10
2020-09-22 16:39:08,0.25243055555555555,1,1,1,2
2020-09-22 10:35:52,0.0030555555555555557,1,1,0,1
2020-09-22 14:19:34,0.2148263888888889,3,28,13,41
2020-09-25 15:37:40,3.4349652777777777,6,19368,7817,27185
2020-09-23 02:12:37,0.8818518518518519,2,6,3,9
2020-09-22 13:20:04,0.5355439814814815,1,2,2,4
2020-09-22 13:52:30,0.6940393518518518,6,79,30,109
2020-09-21 21:26:24,0.019664351851851853,2,3,1,4
2020-09-22 22:26:37,1.0841550925925927,4,8536,336,8872
2020-10-01 12:52:29,9.760173611111112,2,38,1,39
2020-09-21 18:14:26,0.0103125,1,1,1,2
2020-09-21 18:00:41,0.01068287037037037,1,5,5,10
2020-09-22 09:39:07,0.7414930555555556,1,5,4,9
2020-09-22 13:31:14,0.924224537037037,4,82,19,101
2020-09-27 19:10:46,6.173738425925926,16,21951,8656,30607
2020-09-21 14:31:26,0.007268518518518519,1,4,2,6
2020-09-21 20:17:28,0.33219907407407406,2,166,2,168
2020-09-21 20:15:32,0.39600694444444445,1,31,0,31
2020-09-21 13:14:49,0.1540162037037037,1,1,0,1
2020-10-21 21:20:54,30.569525462962964,31,64973,18005,82978
2020-09-21 16:26:19,0.4352314814814815,1,232,0,232
2020-09-24 19:23:48,3.8705555555555557,4,53,34,87
2020-09-25 18:33:21,5.002719907407408,13,22286,8855,31141
2020-09-21 10:12:51,0.8658217592592593,1,220,43,263
2020-09-20 17:12:30,0.25873842592592594,1,2,2,4
2020-09-21 08:53:52,0.9623263888888889,1,1,1,2
2020-09-21 19:13:20,1.565613425925926,5,464,284,748
2020-09-24 21:10:27,4.9703125,3,117,8,125
2020-09-21 08:25:22,1.5412037037037036,1,2,1,3
2020-09-24 21:30:10,5.0877893518518515,10,20806,8603,29409
2020-09-22 17:09:36,2.919652777777778,3,9373,682,10055
2020-09-20 13:17:30,0.7921875,1,7,0,7
2020-09-21 09:34:20,1.850625,3,6,5,11
2020-09-19 18:37:12,0.6338310185185185,2,51,0,51
2020-10-01 08:48:37,12.548645833333333,13,26329,9118,35447
2020-09-18 19:46:01,0.0011458333333333333,1,2,1,3
2020-09-19 06:10:45,0.5614930555555555,1,2,0,2
2020-09-19 06:09:29,0.5622222222222222,1,9,0,9
2020-09-24 12:31:00,5.868159722222222,20,1663,319,1982
2020-09-22 13:34:36,3.967986111111111,2,147,77,224
2020-09-22 16:31:22,4.166516203703703,14,5460,647,6107
2020-09-18 08:52:44,0.005543981481481481,1,1,1,2
2020-09-18 08:23:33,0.2953125,1,1,1,2
2020-09-21 13:13:36,3.614664351851852,18,2396,189,2585
2020-09-17 22:32:32,0.006469907407407408,1,0,5,5
2020-09-19 21:02:05,1.9981712962962963,2,182,82,264
2020-09-17 20:53:14,0.025555555555555557,1,9,0,9
2020-09-22 09:02:27,4.542349537037037,8,4407,589,4996
2020-09-17 20:57:07,0.04168981481481481,2,457,144,601
2020-09-17 19:29:39,0.003946759259259259,1,24,12,36
2020-09-18 07:23:50,0.5718981481481481,1,9,0,9
2020-09-18 07:23:58,0.5759953703703704,1,9,0,9
2020-09-18 07:24:11,0.5794212962962964,1,7,0,7
2020-09-17 18:11:17,0.05482638888888889,3,52,43,95
2020-09-18 07:24:31,0.6348379629629629,1,7,0,7
2020-09-18 07:24:23,0.6405324074074074,1,2,0,2
2020-09-17 16:30:46,0.8318402777777778,4,278,281,559
2020-09-17 09:58:58,0.018078703703703704,2,2,1,3
2020-09-17 01:58:58,0.0025462962962962965,1,1,1,2
2020-09-20 20:54:43,3.834699074074074,9,7371,749,8120
2020-09-17 18:26:39,0.8132291666666667,13,126,116,242
2020-09-17 12:15:37,0.6078125,3,112,31,143
2020-09-16 19:38:38,0.06554398148148148,12,53,36,89
2020-09-18 07:21:40,1.5217592592592593,2,61,0,61
2020-09-18 07:22:12,1.522650462962963,3,62,1,63
2020-09-18 07:21:54,1.5235416666666666,2,61,0,61
2020-09-18 07:22:32,1.524525462962963,2,61,0,61
2020-09-18 07:21:29,1.525486111111111,2,61,0,61
2020-09-18 07:21:17,1.5269907407407408,2,61,0,61
2020-09-18 07:21:00,1.5300462962962964,2,67,6,73
2020-09-18 07:20:29,1.5284837962962963,2,67,6,73
2020-09-18 13:28:57,1.8262037037037038,1,53,25,78
2020-09-16 18:40:36,0.0441087962962963,1,6,6,12
2020-09-17 09:51:41,0.6788310185185186,1,0,3,3
2020-09-17 09:52:13,0.6954513888888889,1,1,1,2
2020-09-16 16:16:01,0.2571643518518518,2,53,0,53
2020-09-16 13:15:11,0.2657060185185185,1,3,2,5
2020-10-19 15:36:09,79.1506712962963,79,77760,28380,106140
2020-09-16 12:45:50,0.4123148148148148,1,78,10,88
2020-09-16 12:41:27,0.5818171296296296,2,845,19,864
2020-09-17 15:58:49,1.7777662037037036,6,2907,874,3781
2020-09-16 11:40:57,0.7536689814814815,1,1,1,2
2020-09-16 11:03:47,0.8026851851851852,5,149,234,383
2020-09-15 14:40:57,0.01173611111111111,1,920,0,920
2020-09-15 12:18:43,0.018368055555555554,1,1,1,2
2020-09-15 11:04:51,0.014108796296296296,1,1,1,2
2020-10-08 09:32:16,24.06341435185185,47,81061,20207,101268
2020-09-16 16:12:13,1.8244328703703703,4,108,605,713
2020-09-15 19:10:08,0.9897337962962963,1,1,1,2
2020-09-15 14:27:25,0.8762384259259259,6,510,232,742
2020-09-15 15:51:51,0.9391666666666667,3,23,8,31
2020-09-14 19:57:56,0.1658912037037037,17,205,139,344
2020-09-15 07:32:44,0.7242824074074075,2,27,34,61
2020-09-14 11:42:13,0.0042592592592592595,2,7,3,10
2020-09-14 11:43:40,0.06954861111111112,1,1,1,2
2020-09-14 03:40:39,0.022766203703703705,8,23,19,42
2020-09-16 17:59:58,2.6595601851851853,19,5163,1710,6873
2020-09-15 00:33:08,0.9907638888888889,5,4857,1630,6487
2020-09-14 00:48:48,0.0016435185185185185,1,1,1,2
2020-09-13 21:28:18,129.15247685185184,58,137069,47532,184601
2020-09-14 04:04:00,0.3591666666666667,1,1,0,1
2020-09-15 23:25:27,2.74337962962963,21,6591,2238,8829
2020-09-15 08:01:14,2.1533449074074076,2,4955,1615,6570
2020-09-14 12:54:23,1.5133449074074075,1,3,9,12
2020-09-15 12:48:26,2.5412268518518517,1,53,0,53
2020-09-18 07:19:46,5.423634259259259,1,30,0,30
2020-09-13 19:11:47,0.9379513888888888,1,9,10,19
2020-09-15 12:48:14,15.757511574074075,3,28,38,66
2020-09-17 10:10:35,5.050925925925926,3,65,99,164
2020-10-05 08:25:44,34.27622685185185,2,1952,16,1968
2020-09-14 13:26:41,2.6618287037037036,1,1042,1574,2616
2020-09-14 11:50:52,2.723009259259259,1,6,0,6
2020-09-11 18:18:46,0.01934027777777778,2,3,12,15
2020-09-23 17:25:25,12.04943287037037,16,31583,5320,36903
2020-09-11 16:06:32,0.00625,1,28,8,36
2020-09-11 16:01:34,0.020011574074074074,2,118,1,119
2020-09-11 19:17:26,0.24561342592592592,2,110,9,119
2020-09-11 07:57:54,0.04663194444444444,1,10,10,20
2020-09-11 19:20:55,0.5249768518518518,1,30,0,30
2020-09-11 19:21:06,0.5277662037037038,1,30,0,30
2020-09-22 13:28:02,13.188333333333333,20,1713,206,1919
2020-09-11 14:42:09,0.8576967592592593,11,702,1170,1872
2020-09-10 22:52:56,0.12635416666666666,3,25,5,30
2020-09-11 08:43:20,0.5570717592592592,1,12,0,12
2020-09-10 19:23:45,0.03428240740740741,3,140,85,225
2020-09-10 18:51:09,0.027858796296296295,5,43,43,86
2020-10-11 20:39:39,31.11199074074074,15,51853,14808,66661
2020-09-10 15:12:34,0.003425925925925926,2,2,2,4
2020-09-10 15:08:41,0.0007291666666666667,1,1,1,2
2020-09-10 14:36:03,0.004907407407407407,1,4,4,8
2020-09-10 12:45:53,0.004537037037037037,1,7,3,10
2020-09-10 15:04:04,0.11788194444444444,2,2,2,4
2020-09-10 08:58:30,0.15114583333333334,1,13,4,17
2020-09-10 17:31:02,0.5829976851851851,1,152,152,304
2020-09-14 11:51:19,4.3505671296296295,3,40,40,80
2020-09-17 19:19:35,51.833587962962966,48,65108,19373,84481
2020-09-10 14:41:57,0.7680208333333334,6,2184,34,2218
2020-09-10 18:11:34,1.9489583333333333,4,4747,79,4826
2020-09-08 17:29:17,0.03546296296296296,3,7,7,14
2020-09-08 16:51:29,0.023819444444444445,2,5,2,7
2020-09-08 14:51:59,0.02826388888888889,4,60,51,111
2020-09-08 07:42:20,0.041261574074074076,1,1,0,1
2020-09-08 05:22:21,0.1395949074074074,1,1,1,2
2020-09-08 12:07:34,0.6822106481481481,4,11,11,22
2020-09-15 09:41:00,7.579085648148149,10,141,105,246
2020-09-09 08:23:00,1.6364467592592593,1,28,1,29
2020-09-08 08:22:58,0.6563078703703704,1,1,1,2
2020-09-07 12:31:07,0.0069097222222222225,1,15,30,45
2020-09-07 20:43:51,0.3617824074074074,1,147,0,147
2020-09-14 14:07:04,7.198773148148148,13,7636,3987,11623
2020-09-07 08:56:08,0.016006944444444445,1,4,2,6
2020-09-09 08:08:37,2.075972222222222,1,12,14,26
2020-09-07 11:28:07,0.35952546296296295,2,4,2,6
2020-09-07 00:41:30,0.050902777777777776,1,4,1,5
2020-09-15 12:54:13,8.741956018518518,1,47,0,47
2020-09-07 11:31:22,0.8365625,1,15,0,15
2020-09-07 10:12:23,1.0218518518518518,1,1,1,2
2020-09-07 10:01:41,1.6370601851851851,2,72,0,72
2020-09-09 08:08:01,4.063935185185185,3,186,27,213
2020-09-05 16:50:20,0.804525462962963,3,103,1,104
2020-09-07 09:16:25,2.3691898148148147,1,1,1,2
2020-09-07 09:50:19,2.4086805555555557,1,1,1,2
2020-09-04 22:22:25,0.07725694444444445,3,579,579,1158
2020-09-12 05:08:22,7.4309259259259255,5,9433,1393,10826
2020-09-04 20:14:38,0.06074074074074074,1,1,1,2
2020-11-03 15:04:23,59.90957175925926,52,116437,35738,152175
2020-09-04 18:19:32,0.04730324074074074,4,104,65,169
2020-09-04 14:08:55,0.006643518518518518,1,5,4,9
2020-09-04 22:24:33,0.5954050925925926,2,28,0,28
2020-09-07 12:12:26,3.2249074074074073,1,1,1,2
2020-09-17 15:31:30,13.376412037037037,118,21459,6450,27909
2020-10-08 08:16:11,34.26858796296296,10,108749,26993,135742
2020-09-07 09:36:17,3.474074074074074,3,6,4,10
2020-09-04 14:09:43,0.6684837962962963,3,4,4,8
2020-09-07 08:54:00,3.502962962962963,2,14,2,16
2020-09-09 08:56:40,5.511574074074074,1,4,3,7
2020-09-03 21:31:36,4.033587962962963,35,9608,1028,10636
2020-09-03 16:42:10,0.015868055555555555,1,1,0,1
2020-09-03 15:11:41,0.04321759259259259,3,15,13,28
2020-09-03 13:13:44,0.012685185185185185,1,70,48,118
2020-09-03 13:29:02,0.4104976851851852,1,1,1,2
2020-09-04 12:29:57,1.6928935185185185,4,10,5,15
2020-09-03 08:14:59,0.5145023148148148,1,53,29,82
2020-09-03 13:47:00,0.7720486111111111,12,114,38,152
2020-09-08 12:08:08,7.493726851851852,41,11334,899,12233
2020-09-03 13:20:04,0.9545254629629629,1,4,1,5
2020-09-03 13:23:42,0.974386574074074,1,1,1,2
2020-09-02 12:11:45,0.011469907407407408,3,76,64,140
2020-09-02 14:18:17,0.407662037037037,1,1,1,2
2020-09-02 10:39:02,0.29077546296296297,1,1,1,2
2020-09-02 08:50:10,0.40091435185185187,3,46,3,49
2020-09-02 07:53:10,0.484375,1,4,3,7
2020-09-02 10:45:20,0.6239814814814815,1,2,2,4
2020-09-01 21:09:02,0.11241898148148148,1,3,0,3
2020-09-01 21:09:10,0.11331018518518518,1,3,0,3
2020-09-01 21:06:15,0.11840277777777777,2,16,3,19
2020-09-01 20:57:49,0.1351388888888889,1,14,0,14
2020-09-02 10:44:52,0.7183564814814815,1,1,0,1
2020-09-01 17:24:46,0.0009490740740740741,2,253,1,254
2020-09-01 15:42:18,0.6841782407407407,2,26,9,35
2020-09-01 19:56:40,0.23925925925925925,3,25,1,26
2020-09-01 09:35:36,0.004594907407407408,1,1,1,2
2020-09-24 10:52:11,23.17673611111111,1,1,1,2
2020-09-02 10:51:52,1.1960763888888888,2,2,2,4
2020-09-02 14:54:40,1.3921180555555555,2,0,11,11
2020-09-01 07:43:28,0.18181712962962962,1,0,1,1
2020-09-01 02:47:23,0.02684027777777778,1,3,3,6
2020-08-31 21:59:34,0.07393518518518519,1,4,4,8
2020-08-31 19:16:39,0.020381944444444446,2,83,73,156
2020-08-31 20:10:43,0.06725694444444444,1,8,4,12
2020-09-01 07:16:35,0.5647916666666667,4,82,18,100
2020-09-03 15:49:15,3.002546296296296,3,7485,628,8113
2020-08-31 15:02:31,0.0026967592592592594,1,1,1,2
2020-08-31 14:52:48,0.007395833333333333,1,1,1,2
2020-08-31 08:53:21,0.04349537037037037,1,1,1,2
2020-09-01 21:35:24,1.6289930555555556,1,270,0,270
2020-09-02 10:55:37,2.3153587962962963,1,2,2,4
2020-09-04 18:05:57,4.890775462962963,43,14661,1184,15845
2020-08-31 20:16:11,0.9662615740740741,2,10,3,13
2020-08-31 19:28:00,0.9691782407407408,2,628,196,824
2020-08-30 10:21:49,0.06929398148148148,1,172,4,176
2020-08-30 10:21:01,0.18645833333333334,1,2,2,4
2020-08-30 10:19:58,0.6735185185185185,1,15,15,30
2020-09-22 16:29:59,83.26178240740741,155,99482,32999,132481
2020-08-29 21:43:33,1.0160185185185184,3,83,105,188
2020-10-06 20:11:57,38.960914351851855,6,65863,13823,79686
2020-08-28 21:05:53,0.0013078703703703703,1,22,2,24
2020-08-28 19:02:25,0.006967592592592593,1,1,1,2
2020-08-31 15:35:52,2.8802083333333335,23,654,160,814
2020-09-01 21:52:32,4.209247685185185,1,63,0,63
2020-08-28 19:22:34,0.1102199074074074,2,0,3,3
2020-08-31 17:48:27,3.046238425925926,14,1406,327,1733
2020-08-29 21:36:32,1.2465972222222221,3,3,6,9
2020-08-30 11:02:47,1.9683564814814816,1,9,5,14
2020-09-01 21:56:19,4.625231481481482,1,3,3,6
2020-08-28 03:38:10,0.0060648148148148145,1,1,1,2
2020-08-28 00:01:17,0.04534722222222222,4,35,2,37
2020-08-28 02:19:47,0.1558101851851852,2,15,4,19
2020-09-24 22:46:59,29.26119212962963,53,1337,458,1795
2020-09-08 14:00:57,42.020752314814814,33,35183,14913,50096
2020-08-27 15:08:15,0.0011111111111111111,1,1,0,1
2020-08-27 09:16:51,0.0016203703703703703,1,49,18,67
2020-08-28 04:12:29,0.8394560185185185,1,141,0,141
2020-08-27 03:25:11,0.009386574074074073,2,6,6,12
2020-09-01 21:38:56,5.95875,1,109,0,109
2020-08-31 20:16:47,4.920787037037037,1,3,1,4
2020-08-27 13:04:51,0.6336111111111111,1,2,2,4
2020-08-26 22:00:27,0.019618055555555555,1,103,0,103
2020-08-26 21:51:11,0.03695601851851852,1,0,0,0
2020-08-31 18:38:46,5.178495370370371,10,8703,4944,13647
2020-08-26 22:59:21,0.28751157407407407,5,5606,4122,9728
2020-09-02 11:34:36,7.150277777777778,13,176,38,214
2020-08-26 09:15:35,0.023773148148148147,1,1,1,2
2020-08-26 08:51:57,0.04805555555555555,1,9,10,19
2020-08-30 20:29:24,4.789768518518518,6,8089,4829,12918
2020-09-01 10:38:26,6.511354166666667,15,495,361,856
2020-08-26 21:27:43,1.1109375,2,65,0,65
2020-08-26 21:27:57,1.1120833333333333,2,65,0,65
2020-08-26 21:27:34,1.1138425925925926,2,65,0,65
2020-08-25 18:58:38,0.010300925925925925,1,1,0,1
2020-08-26 21:26:32,1.1385069444444444,9,153,35,188
2020-08-25 18:06:29,0.014826388888888889,1,3,3,6
2020-08-27 00:19:20,1.3109375,1,141,0,141
2020-08-26 20:06:00,1.163912037037037,3,123,6,129
2020-08-27 08:58:14,1.7113078703703704,17,7281,4968,12249
2020-08-25 16:11:24,0.015752314814814816,1,215,0,215
2020-08-25 15:38:52,0.016898148148148148,1,1,0,1
2020-08-26 21:22:26,1.360775462962963,1,58,0,58
2020-08-26 15:12:45,1.1180324074074075,1,2,2,4
2020-08-25 17:24:41,0.22471064814814815,3,22,24,46
2020-08-25 12:12:54,0.02704861111111111,1,1,1,2
2020-08-27 12:45:35,2.10724537037037,7,50,23,73
2020-08-25 17:32:57,41.148715277777775,2,26,10,36
2020-08-29 22:03:09,4.731597222222222,3,8785,4905,13690
2020-08-25 10:26:30,0.3024074074074074,1,1,0,1
2020-08-25 04:33:12,0.06143518518518518,1,12,12,24
2020-08-26 21:20:56,1.8396990740740742,6,144,6,150
2020-08-25 11:07:36,0.6190625,2,106,15,121
2020-08-24 19:54:57,109.08765046296297,19,107640,38660,146300
2020-08-25 11:06:58,0.692488425925926,1,10,6,16
2020-08-25 01:04:08,0.31342592592592594,1,4,4,8
2020-08-24 17:20:04,0.00525462962962963,1,0,2,2
2020-08-26 08:58:22,1.688622685185185,7,348,352,700
2020-08-24 16:15:01,0.005601851851851852,1,2,0,2
2020-08-25 07:57:29,0.7075694444444445,5,41,6,47
2020-08-25 11:47:09,0.8775694444444444,2,1346,646,1992
2020-08-25 13:39:03,0.9730902777777778,1,1,1,2
2020-08-24 15:03:02,0.09512731481481482,3,563,580,1143
2020-08-24 13:31:44,0.0315625,3,26,12,38
2020-08-24 13:22:03,0.06344907407407407,3,17,3,20
2020-08-24 15:30:06,0.29953703703703705,1,14,8,22
2020-09-14 15:50:23,21.230196759259258,7,61,35,96
2020-09-09 10:55:17,16.083206018518517,2,17,3,20
2020-08-25 02:09:14,0.8310763888888889,5,221,6,227
2020-08-24 09:08:33,1.8490856481481481,6,805,24,829
2020-08-22 16:13:22,0.1440972222222222,4,76,3,79
2020-08-24 16:30:38,2.473611111111111,2,2,0,2
2020-08-24 16:42:35,2.487673611111111,1,1,1,2
2020-08-23 14:03:41,1.650810185185185,1,2,2,4
2020-08-28 15:15:18,8.862662037037037,33,11053,5831,16884
2020-08-21 18:18:16,0.050833333333333335,1,48,0,48
2020-08-21 17:43:00,0.043194444444444445,2,26,1,27
2020-08-25 07:42:33,3.6333333333333333,1,13,12,25
2020-08-31 12:25:00,9.904097222222223,7,9983,5066,15049
2020-08-21 14:22:11,0.039108796296296294,2,26,1,27
2020-08-25 08:57:08,3.969965277777778,2,12,4,16
2020-09-02 11:36:33,12.123275462962964,1,4,4,8
2020-08-21 09:04:30,0.07289351851851852,1,73,0,73
2020-08-21 09:07:33,0.3250462962962963,1,1,1,2
2020-08-24 11:27:58,3.487604166666667,1,10,3,13
2020-09-10 09:32:00,20.61886574074074,1,9,9,18
2020-08-20 17:59:41,0.016087962962962964,2,2,2,4
2020-08-20 17:23:48,0.03116898148148148,2,36,32,68
2020-08-20 16:11:37,0.04010416666666667,2,32,7,39
2020-08-20 12:23:36,0.1366550925925926,2,3,3,6
2020-08-20 19:34:43,0.9758101851851851,4,96,86,182
2020-08-20 15:13:50,0.8038541666666666,5,339,162,501
2020-08-20 04:33:36,0.39231481481481484,1,0,1,1
2020-09-01 21:58:44,13.1684375,1,101,0,101
2020-11-16 13:35:45,69.84753472222222,2,121,2,123
2020-09-01 21:59:16,13.26880787037037,1,101,0,101
2020-08-19 17:04:33,0.15376157407407406,1,8,1,9
2020-08-20 08:17:17,0.8613541666666666,1,2,2,4
2020-09-10 14:40:51,23.949895833333333,29,2327,828,3155
2020-08-19 14:18:52,0.08086805555555555,1,4,1,5
2020-08-19 13:37:46,0.3509143518518518,1,2,9,11
2020-08-19 01:28:10,0.03469907407407408,2,4,5,9
2020-09-23 22:11:06,35.90090277777778,8,54687,11244,65931
2020-08-20 14:32:52,1.7303935185185184,2,78,11,89
2020-08-18 17:10:48,0.022291666666666668,1,1,1,2
2020-08-18 16:47:48,0.02060185185185185,1,1,1,2
2020-08-21 11:52:54,2.8530787037037038,4,25,2,27
2020-08-24 15:48:46,6.017048611111111,19,3912,628,4540
2020-08-18 14:23:25,0.018090277777777778,1,1,1,2
2020-08-18 14:22:44,0.019375,1,0,1,1
2020-09-18 10:18:06,30.882118055555555,2,43623,10362,53985
2020-08-18 17:28:18,0.2263888888888889,2,297,2,299
2020-08-20 17:34:24,2.275266203703704,3,4,3,7
2020-08-18 16:42:14,0.4332638888888889,1,70,0,70
2020-08-18 16:43:20,0.4397685185185185,1,64,0,64
2020-08-18 12:21:53,0.2755902777777778,2,3,3,6
2020-08-18 14:21:14,0.4570601851851852,1,4,0,4
2020-08-17 20:48:05,0.004953703703703704,1,2,0,2
2020-08-17 19:56:57,0.038125,1,21,0,21
2020-08-19 14:37:49,1.9128472222222221,3,232,116,348
2020-08-17 16:27:03,0.0128125,1,14,14,28
2020-08-19 12:23:46,1.9653703703703704,9,1897,1636,3533
2020-08-17 20:04:30,0.3531828703703704,3,33,3,36
2020-08-17 10:24:43,0.001099537037037037,1,3,2,5
2020-08-17 09:13:59,0.022511574074074073,1,2,2,4
2020-08-17 13:04:36,0.2328125,3,7,9,16
2020-08-17 20:24:11,0.5462152777777778,2,96,0,96
2020-08-17 02:49:50,5.9306018518518515,1,203,2,205
2020-08-18 23:15:50,2.1689583333333333,4,15,18,33
2020-08-17 00:31:23,0.17159722222222223,1,9,1,10
2020-08-27 16:22:18,10.920972222222222,4,14211,5875,20086
2020-08-17 07:42:26,0.5897106481481481,2,219,24,243
2020-08-17 13:06:36,0.8133912037037037,2,8,8,16
2020-08-20 09:35:06,3.8291435185185185,1,2,1,3
2020-08-17 04:00:24,14.95888888888889,3,99,17,116
2020-08-20 09:24:26,4.17599537037037,1,19,11,30
2020-08-17 08:04:54,1.1365740740740742,2,133,139,272
2020-08-27 16:25:17,11.579224537037037,4,1893,529,2422
2020-08-17 15:49:16,1.554212962962963,4,153,136,289
2020-08-17 15:07:58,1.7001967592592593,2,29,26,55
2020-08-17 02:57:36,1.302337962962963,1,4,4,8
2020-08-17 03:11:40,1.3172685185185184,1,4,4,8
2020-08-16 08:30:17,0.8582291666666667,1,2,1,3
2020-08-17 03:02:33,1.900949074074074,2,166,4,170
2020-08-17 12:12:19,2.314513888888889,5,145,70,215
2020-08-16 17:36:39,1.933148148148148,1,1,1,2
2020-08-18 12:09:40,3.7675925925925924,4,8,7,15
2020-08-17 16:30:27,2.989201388888889,8,72,15,87
2020-08-18 12:38:54,3.8297685185185184,2,5,3,8
2020-08-14 16:47:38,0.016967592592592593,1,1,1,2
2020-08-20 16:58:44,9.072384259259259,1,253,0,253
2020-08-14 12:16:16,0.06604166666666667,1,1,1,2
2020-08-14 07:34:40,0.19858796296296297,4,29,19,48
2020-08-17 12:33:13,3.4338194444444445,1,5,1,6
2020-08-14 13:46:40,1.0699305555555556,14,1023,683,1706
2020-08-13 19:01:08,0.007268518518518519,1,1,1,2
2020-08-17 13:15:35,3.8367939814814815,5,706,56,762
2020-08-13 16:08:11,0.038125,2,201,35,236
2020-08-13 16:06:44,0.041747685185185186,1,2,2,4
2020-08-13 13:36:49,0.03709490740740741,1,1,1,2
2020-08-14 08:36:58,0.8422800925925926,3,10,10,20
2020-08-13 16:09:51,4.359074074074074,3,475,206,681
2020-08-13 16:34:04,0.39666666666666667,2,16,1,17
2020-08-20 20:29:15,8.035578703703704,11,294,250,544
2020-08-26 18:55:42,14.28775462962963,9,821,698,1519
2020-08-12 15:46:25,0.001875,1,3,4,7
2020-08-13 15:59:36,0.3320601851851852,5,230,64,294
2020-08-12 15:32:28,1.8250462962962963,12,134,20,154
2020-08-14 07:21:16,1.7883101851851853,11,2000,996,2996
2020-08-12 12:47:30,0.0020717592592592593,1,2,2,4
2020-08-13 09:01:17,0.9431018518518518,3,40,1,41
2020-08-26 15:10:36,0.9797800925925926,8,1278,835,2113
2020-08-12 06:52:51,0.0034953703703703705,1,1,0,1
2020-08-27 16:23:28,15.539282407407407,2,11,16,27
2020-08-12 12:42:15,0.6816550925925926,4,633,70,703
2020-08-12 12:03:46,0.6602430555555555,1,37,8,45
2020-08-11 21:58:10,0.07241898148148149,1,1,0,1
2020-08-12 12:00:56,33.80361111111111,6,178,95,273
2020-08-12 11:54:29,0.7216319444444445,2,9,9,18
2020-08-14 07:43:30,2.654189814814815,8,266,87,353
2020-08-11 14:35:32,0.028078703703703703,2,50,6,56
2020-08-11 22:35:27,0.3923726851851852,1,64,0,64
2020-08-12 16:23:30,1.1553935185185185,5,491,177,668
2020-08-11 16:04:17,0.5155208333333333,3,35,31,66
2020-08-17 02:49:42,6.049560185185185,7,7038,1674,8712
2020-08-11 02:49:40,0.03795138888888889,1,48,0,48
2020-08-11 13:03:23,7.216863425925926,5,51,6,57
2020-08-11 14:34:23,0.8685995370370371,1,0,68,68
2020-08-11 06:48:50,0.6093518518518518,1,1,1,2
2020-08-10 15:16:18,0.0014236111111111112,1,4,3,7
2020-08-11 09:31:27,0.7859837962962963,2,10,4,14
2020-08-10 15:12:30,2.7913425925925925,2,67,5,72
2020-08-13 11:12:17,2.893553240740741,3,10,10,20
2020-08-11 20:56:52,1.2948842592592593,2,7,0,7
2020-08-10 14:39:31,0.23737268518518517,2,26,20,46
2020-08-11 22:34:11,1.4468981481481482,1,73,0,73
2020-08-11 22:32:29,1.472962962962963,1,5,0,5
2020-08-11 22:32:19,1.4739236111111111,1,5,0,5
2020-08-11 22:32:38,1.4761574074074073,1,75,0,75
2020-08-10 17:46:48,0.31296296296296294,3,30,11,41
2020-08-10 06:55:12,0.4714467592592593,1,1,1,2
2020-08-10 06:55:52,0.5211574074074075,1,0,1,1
2020-08-19 12:31:11,35.321412037037035,17,50186,17398,67584
2020-08-10 07:08:47,0.7510185185185185,1,1,1,2
2020-08-12 15:41:04,3.3883680555555555,4,4348,684,5032
2020-08-11 21:56:42,2.7442592592592594,27,462,298,760
2020-08-13 16:15:55,4.5827430555555555,1,1,1,2
2020-08-09 01:51:38,0.08140046296296297,3,14,8,22
2020-08-11 14:36:15,2.645208333333333,1,32,0,32
2020-08-08 18:37:29,0.0050810185185185186,1,1,1,2
2020-08-09 07:39:52,0.6159027777777778,2,16,0,16
2020-08-11 22:31:35,3.3249421296296298,3,97,2,99
2020-08-08 08:21:13,0.016631944444444446,1,1,3,4
2020-08-18 03:55:43,9.85650462962963,7,9812,2260,12072
2020-08-08 06:45:56,0.07390046296296296,2,3,3,6
2020-08-11 18:31:24,48.089872685185185,94,26227,12353,38580
2020-08-10 09:31:20,2.2484375,3,49,64,113
2020-08-08 01:30:40,0.02306712962962963,1,0,1,1
2020-08-07 22:40:21,0.00662037037037037,1,2,1,3
2020-08-10 09:37:12,3.060347222222222,1,90,136,226
2020-08-10 14:39:18,3.0171180555555557,4,41,18,59
2020-08-11 22:38:19,4.46261574074074,3,65,4,69
2020-08-28 13:56:18,21.18943287037037,4,22183,7315,29498
2020-08-08 09:47:34,1.0255787037037036,1,1,0,1
2020-08-07 14:36:33,0.5247569444444444,1,5,9,14
2020-08-11 20:27:12,4.774074074074074,3,9,8,17
2020-08-30 11:26:10,23.466064814814814,3,22596,7442,30038
2020-08-11 14:58:55,4.69699074074074,1,1,5,6
2020-08-07 00:32:28,0.10635416666666667,2,3,2,5
2020-08-06 19:43:46,0.005393518518518519,1,0,1,1
2020-08-06 19:14:46,0.1019675925925926,1,2,2,4
2020-08-07 13:18:38,0.8926967592592593,3,362,13,375
2020-08-06 15:47:33,0.012662037037037038,1,8,2,10
2020-08-06 18:58:39,0.17506944444444444,4,23,13,36
2020-08-06 15:42:43,0.0692013888888889,1,3,3,6
2020-08-07 06:49:00,0.8801157407407407,2,103,39,142
2020-08-07 13:30:58,1.1970949074074073,2,12,4,16
2020-08-07 06:58:16,0.9811342592592592,2,4,2,6
2020-08-06 10:52:29,0.25982638888888887,7,67,14,81
2020-08-05 16:36:25,0.003287037037037037,1,26,0,26
2020-08-05 16:27:46,0.002384259259259259,1,26,0,26
2020-08-05 16:27:28,0.036863425925925924,1,206,0,206
2020-08-07 09:44:28,2.0164583333333335,1,3,2,5
2020-08-05 11:34:58,0.23658564814814814,1,1,1,2
2020-08-13 08:29:06,8.172534722222222,12,11040,4074,15114
2020-08-05 11:37:58,0.4347800925925926,1,1,1,2
2020-08-07 09:45:53,2.4590277777777776,1,18,0,18
2020-08-07 09:46:28,2.4594675925925924,1,18,0,18
2020-08-07 09:47:05,2.4599305555555557,1,18,0,18
2020-08-07 09:47:27,2.4602314814814816,1,18,0,18
2020-08-07 09:47:43,2.460451388888889,1,18,0,18
2020-08-07 09:48:10,2.4609722222222223,1,18,0,18
2020-08-07 09:48:39,2.461527777777778,1,18,0,18
2020-08-07 09:51:03,2.4634953703703704,1,18,0,18
2020-08-05 15:34:40,1.929861111111111,17,6214,4620,10834
2020-08-04 21:40:48,0.01357638888888889,1,16,0,16
2020-08-04 20:37:50,0.013564814814814814,1,15,5,20
2020-08-04 17:22:43,0.008576388888888889,3,10,9,19
2020-08-04 17:40:49,6.228159722222222,4,6410,3655,10065
2020-08-05 13:05:53,0.9269560185185185,3,24,12,36
2020-08-12 16:48:30,8.132592592592593,4,112,14,126
2020-08-04 11:02:26,0.005543981481481481,1,1,1,2
2020-08-04 07:20:19,0.019849537037037037,1,10,10,20
2020-08-04 06:37:12,0.007928240740740741,2,10,0,10
2020-08-05 13:01:18,1.3605439814814815,12,160,67,227
2020-08-11 07:56:48,7.1819444444444445,4,119,0,119
2020-08-04 13:53:52,0.6355902777777778,7,242,382,624
2020-08-03 22:22:31,0.0014699074074074074,2,5,7,12
2020-08-05 13:04:28,1.6669560185185186,7,14206,5295,19501
2020-08-04 13:31:50,0.7303703703703703,1,2,2,4
2020-08-04 06:59:21,0.46253472222222225,1,0,4,4
2020-08-03 19:02:52,0.08347222222222223,1,6,2,8
2020-08-07 15:17:08,3.972337962962963,2,281,43,324
2020-08-03 17:17:56,0.07653935185185186,4,7,16,23
2020-08-03 14:21:24,0.021909722222222223,1,7,5,12
2020-08-03 14:19:36,0.06017361111111111,1,2,1,3
2020-08-17 15:44:46,14.12980324074074,11,216,36,252
2020-08-03 14:36:26,3.6249074074074072,11,4854,2523,7377
2020-08-04 21:44:15,2.416608796296296,1,17,2,19
2020-08-04 21:44:06,2.416747685185185,1,16,2,18
2020-08-04 21:43:49,2.4176273148148146,1,17,2,19
2020-08-04 21:43:39,2.4173263888888887,1,13,2,15
2020-08-04 06:42:57,2.020613425925926,10,174,355,529
2020-08-04 07:23:29,2.058125,10,28,13,41
2020-08-02 07:58:26,0.9167708333333333,1,5,4,9
2020-08-01 18:51:08,0.5470023148148148,3,11,5,16
2020-08-01 10:20:49,0.5488425925925926,1,1,1,2
2020-08-06 15:31:31,7.7735763888888885,14,3585,2240,5825
2020-08-03 15:44:47,3.8844444444444446,6,748,566,1314
2020-07-31 08:28:36,0.06628472222222222,1,118,0,118
2020-09-10 11:56:29,42.71741898148148,20,36085,9645,45730
2020-08-07 13:17:33,7.529525462962963,1,1,12,13
2020-07-30 22:00:03,0.022337962962962962,1,1,1,2
2020-07-30 21:18:27,0.04076388888888889,3,5,5,10
2020-07-31 13:43:24,0.8185763888888888,4,2140,726,2866
2020-07-31 13:44:37,0.9096643518518519,2,354,799,1153
2020-07-31 10:19:07,0.9687731481481482,2,162,1,163
2020-07-31 08:23:30,1.0291550925925925,7,206,178,384
2020-07-30 05:09:47,0.09068287037037037,6,148,59,207
2020-07-30 13:13:17,5.970902777777778,4,309,206,515
2020-07-30 15:11:48,0.8424652777777778,2,4,4,8
2020-07-30 13:17:00,0.8456944444444444,9,2435,1524,3959
2020-07-29 16:20:01,0.006840277777777778,1,17,10,27
2020-07-31 14:56:33,1.9948958333333333,4,78,6,84
2020-07-31 07:45:13,1.7547800925925925,14,124,47,171
2020-07-29 16:28:13,0.10290509259259259,2,18,19,37
2020-09-18 17:16:44,51.18024305555556,34,60168,20399,80567
2020-07-29 15:34:17,0.14028935185185185,2,133,0,133
2020-08-04 21:42:54,6.521203703703704,1,33,0,33
2020-08-17 17:57:20,19.368819444444444,9,260,55,315
2020-07-29 15:38:16,0.27650462962962963,1,24,0,24
2020-07-29 09:20:54,0.48790509259259257,1,3,3,6
2020-07-30 18:51:20,2.9424074074074076,12,2253,1192,3445
2020-07-28 18:46:03,0.005763888888888889,1,1,1,2
2020-08-11 19:57:08,14.064398148148149,8,16161,7174,23335
2020-07-28 22:30:17,0.1887037037037037,6,23,24,47
2020-07-28 22:29:36,0.20064814814814816,1,5,4,9
2020-07-28 22:29:18,0.20310185185185184,1,1,0,1
2020-07-28 22:27:59,0.24520833333333333,2,25,1,26
2020-07-28 16:44:26,0.017094907407407406,1,1,1,2
2020-07-28 13:48:39,0.011909722222222223,2,5,4,9
2020-10-01 09:06:02,64.93400462962963,1,1,1,2
2020-07-29 11:21:30,1.0878472222222222,15,434,192,626
2020-07-28 12:33:53,0.17184027777777777,1,12,3,15
2020-07-31 08:41:14,3.067997685185185,6,2512,1087,3599
2020-07-28 15:24:24,0.6108680555555556,4,192,76,268
2020-07-28 00:07:22,0.0010185185185185184,1,3,3,6
2020-07-27 22:26:00,0.0006828703703703704,1,1,11,12
2020-07-28 13:36:00,0.6456597222222222,1,6,0,6
2020-08-04 21:41:23,7.984641203703704,1,6,0,6
2020-07-28 12:34:59,0.6652314814814815,2,2,2,4
2020-07-27 19:17:34,0.04517361111111111,1,1,0,1
2020-07-28 13:08:20,1.2722800925925926,2,10,6,16
2020-08-11 09:56:40,16.048993055555556,17,1726,455,2181
2020-07-28 00:00:44,0.32708333333333334,2,10,3,13
2020-07-27 15:50:09,0.05195601851851852,2,13,10,23
2020-07-28 07:14:31,0.6566435185185185,1,1,1,2
2020-08-03 08:19:04,6.936655092592592,7,141,73,214
2020-07-30 12:53:35,3.137048611111111,1,2,2,4
2020-07-26 21:31:49,0.19962962962962963,1,6,36,42
2020-07-27 09:15:09,0.7885185185185185,1,99,0,99
2020-07-29 18:32:02,12.895462962962963,35,419,386,805
2020-07-27 09:12:46,1.019861111111111,2,54,3,57
2020-07-26 18:29:54,0.7414120370370371,3,21,21,42
2020-07-26 18:09:15,0.8239351851851852,1,1,1,2
2020-08-11 07:16:53,16.444189814814816,11,68,26,94
2020-07-27 20:25:38,2.104699074074074,1,84,0,84
2020-07-28 14:00:24,3.181388888888889,1,44,0,44
2020-08-06 19:46:43,14.04863425925926,9,24,16,40
2020-08-11 08:49:16,17.378969907407406,4,24,8,32
2020-08-11 07:12:45,27.100277777777777,14,39657,15075,54732
2020-07-27 12:31:24,2.7172800925925924,1,0,23,23
2020-07-27 13:19:00,2.8048611111111112,2,44,9,53
2020-07-24 19:34:17,0.11238425925925925,2,2,3,5
2020-07-24 18:11:14,0.11319444444444444,4,59,5,64
2020-07-24 18:15:38,0.1276736111111111,1,989,571,1560
2020-07-24 18:12:29,0.1535300925925926,2,124,4,128
2020-07-24 14:04:26,0.03725694444444445,1,1,1,2
2020-07-24 13:45:22,0.4716898148148148,2,30,5,35
2020-07-24 08:17:53,0.4128703703703704,1,0,1,1
2020-07-23 21:53:48,0.04833333333333333,2,226,0,226
2020-07-24 13:16:29,0.8885416666666667,2,641,259,900
2020-07-28 12:18:12,4.674722222222222,5,2776,864,3640
2020-07-23 21:56:45,0.14305555555555555,11,57,10,67
2020-07-23 17:51:29,0.07460648148148148,1,1,2,3
2020-07-23 19:41:14,2.2095833333333332,4,2357,589,2946
2020-07-27 14:10:44,4.151446759259259,1,9,3,12
2020-07-29 09:02:35,5.988101851851852,8,72,33,105
2020-07-23 15:41:34,0.31730324074074073,1,44,0,44
2020-07-22 22:14:58,0.027164351851851853,1,333,224,557
2020-07-23 16:05:42,0.8384259259259259,3,205,102,307
2020-07-23 15:57:30,0.9312615740740741,3,236,2,238
2020-07-22 18:34:50,0.12479166666666666,12,1293,931,2224
2020-08-05 11:23:56,13.902962962962963,2,9,9,18
2020-11-03 22:21:05,104.48969907407407,23,158001,51323,209324
2020-07-30 10:13:29,7.9405324074074075,1,3,3,6
2020-07-22 16:48:39,0.6600231481481481,8,315,249,564
2020-07-22 01:07:48,0.006655092592592593,1,1,0,1
2020-07-27 16:14:23,5.799710648148148,9,4482,1542,6024
2020-07-27 16:21:25,5.836944444444445,10,4759,1659,6418
2020-07-24 18:12:15,2.9369328703703705,1,74,0,74
2020-07-24 18:12:10,2.942974537037037,1,74,0,74
2020-07-21 20:58:45,0.07496527777777778,3,41,9,50
2020-07-21 22:13:56,1.1351157407407408,2,73,47,120
2020-07-21 18:12:49,0.07711805555555555,1,65,0,65
2020-07-21 13:44:59,0.030428240740740742,1,3,2,5
2020-07-22 14:11:58,1.2080555555555557,6,35,17,52
2020-09-30 11:07:30,90.3170486111111,20,26248,9797,36045
2020-07-21 21:01:08,0.840625,1,9,0,9
2020-07-20 21:54:09,0.04974537037037037,1,2,1,3
2020-07-21 07:41:38,0.5452199074074074,1,73,0,73
2020-07-23 22:13:36,3.8839236111111113,5,2917,714,3631
2020-07-21 07:52:53,0.5729861111111111,1,70,0,70
2020-07-21 07:31:43,0.5635069444444445,1,73,0,73
2020-07-21 20:51:40,1.1228472222222223,15,1380,112,1492
2020-07-20 23:47:07,1.0094444444444444,1,2,2,4
2020-07-20 21:53:22,0.9506134259259259,1,14,0,14
2020-07-20 19:18:26,0.14394675925925926,1,33,8,41
2020-07-20 15:50:41,0.7323958333333334,2,7,3,10
2020-07-20 07:48:22,0.44524305555555554,1,1,1,2
2020-07-20 07:53:03,0.4480324074074074,1,1,1,2
2020-09-07 07:03:46,50.49388888888889,10,74,60,134
2020-07-21 16:54:30,2.9624421296296295,2,292,8,300
2020-07-18 15:33:14,3.0882060185185187,13,791,707,1498
2020-07-18 15:15:41,0.0036342592592592594,1,45,133,178
2020-07-18 14:53:29,3.060601851851852,11,787,699,1486
2020-07-21 17:27:13,3.183148148148148,1,50,0,50
2020-07-21 17:20:47,3.1794907407407407,1,50,0,50
2020-07-21 17:20:44,3.1803819444444446,1,50,0,50
2020-07-21 17:28:23,3.1869791666666667,1,50,0,50
2020-07-21 17:20:33,3.1824652777777778,1,50,0,50
2020-07-21 17:27:31,3.1889583333333333,1,50,0,50
2020-07-21 17:28:07,3.1906018518518517,1,50,0,50
2020-07-21 17:20:22,3.1867592592592593,1,50,0,50
2020-07-21 17:19:49,3.187777777777778,1,50,0,50
2020-07-20 14:44:11,2.122662037037037,1,4,9,13
2020-07-18 12:20:12,0.04349537037037037,1,1,1,2
2020-08-25 18:56:09,39.62306712962963,19,33265,11395,44660
2020-07-18 11:43:58,0.03939814814814815,2,2,1,3
2020-07-21 17:15:07,3.2592476851851853,1,39,0,39
2020-07-21 17:14:28,3.7913194444444445,1,2,0,2
2020-07-21 17:11:08,3.789953703703704,1,2,0,2
2020-09-28 12:17:31,72.61826388888889,4,89962,23703,113665
2020-07-17 18:33:45,0.00020833333333333335,1,45,133,178
2020-07-17 18:03:54,0.10920138888888889,1,50,0,50
2020-07-17 17:50:50,0.21789351851851851,2,101,4,105
2020-07-17 09:41:57,0.012314814814814815,4,203,9,212
2020-07-21 07:54:58,3.959907407407407,2,28,2,30
2020-07-21 07:54:15,3.9788425925925925,2,29,2,31
2020-07-18 02:51:32,0.8235300925925926,4,1154,201,1355
2020-07-20 13:07:38,5.346724537037037,18,21703,7156,28859
2020-07-22 17:22:34,5.610347222222222,2,6,6,12
2020-07-17 06:54:26,0.22697916666666668,1,3,1,4
2020-07-17 05:40:38,0.3136805555555556,2,5,1,6
2020-07-28 13:14:01,11.717986111111111,1,11,4,15
2020-07-28 08:25:12,11.557592592592593,1,1,0,1
2020-07-16 19:13:51,0.06341435185185185,1,28,0,28
2020-07-16 19:18:32,0.05215277777777778,1,80,0,80
2020-07-16 18:06:50,0.034513888888888886,3,97,23,120
2020-07-17 05:53:25,0.551886574074074,1,3,10,13
2020-07-20 08:06:43,3.7505208333333333,1,68,0,68
2020-07-16 14:25:51,0.018761574074074073,1,1,1,2
2020-07-16 14:19:38,0.021921296296296296,1,1,1,2
2020-09-07 12:35:41,52.95570601851852,1,2,0,2
2020-07-16 13:15:11,0.008414351851851852,1,38,4,42
2020-07-16 10:13:11,0.00787037037037037,1,4,4,8
2020-07-18 02:43:07,2.2228819444444445,9,123,147,270
2020-07-28 08:19:17,12.12369212962963,3,7546,1968,9514
2020-09-03 08:02:26,49.26351851851852,37,26714,10265,36979
2020-07-18 17:57:33,3.5480555555555555,13,23072,7611,30683
2020-08-03 07:53:39,18.383136574074076,2,226,0,226
2020-07-28 12:41:28,12.581458333333334,9,485,49,534
2020-07-16 09:26:17,0.45761574074074074,1,1,1,2
2020-07-15 20:17:20,0.10083333333333333,2,9,1,10
2020-07-15 20:17:26,0.1071412037037037,2,9,1,10
2020-07-15 20:19:22,0.1935185185185185,2,232,218,450
2020-07-24 13:37:52,8.953888888888889,6,25,21,46
2020-07-15 18:59:38,0.1827314814814815,2,0,7,7
2020-07-17 18:24:17,2.2069907407407405,11,787,699,1486
2020-07-15 14:11:22,0.06578703703703703,1,1,1,2
2020-08-10 21:25:06,28.530462962962964,32,3182,997,4179
2020-07-16 03:03:05,0.025381944444444443,13,197,29,226
2020-07-15 12:23:23,0.4091898148148148,1,55,97,152
2020-07-27 13:42:59,12.645208333333333,13,375,80,455
2020-07-22 15:38:37,7.6985069444444445,6,4034,1052,5086
2020-07-15 20:13:29,0.9184953703703703,2,20,10,30
2020-07-14 19:49:00,0.03275462962962963,1,10,1,11
2020-07-14 16:39:45,0.0038541666666666668,1,1,1,2
2020-10-09 12:07:29,86.91143518518518,5,37,25,62
2020-07-14 14:48:52,0.07021990740740741,1,177,0,177
2020-07-14 14:58:46,0.16094907407407408,2,5,2,7
2020-07-27 09:34:03,13.031493055555556,1,1,1,2
2020-07-14 14:50:45,0.2622569444444444,1,116,0,116
2020-07-27 14:55:16,13.3828125,1,1,1,2
2020-07-20 13:29:12,6.361064814814815,2,7,2,9
2020-10-05 09:16:30,83.20331018518519,7,96535,24562,121097
2020-07-14 10:12:24,0.26131944444444444,1,1,1,2
2020-07-14 04:02:04,0.4035300925925926,1,1,1,2
2020-09-22 16:05:05,72.26037037037037,4,320,12,332
2020-08-04 06:38:31,22.05758101851852,2,3,3,6
2020-07-14 14:51:54,2.0500694444444445,1,35,0,35
2020-07-14 16:51:58,2.3027430555555557,1,1,10,11
2020-07-13 10:09:50,1.129224537037037,1,3,3,6
2020-07-13 10:10:17,1.6186805555555555,1,11,9,20
2020-07-13 21:12:19,2.2653819444444445,1,2,16,18
2020-07-13 12:37:39,2.008113425925926,2,8,2,10
2020-07-11 13:37:31,0.0661574074074074,4,77,4,81
2020-07-12 04:34:22,0.8402314814814815,6,140,91,231
2020-07-10 21:31:03,0.015636574074074074,2,268,18,286
2020-07-13 06:53:49,2.5090625,1,90,0,90
2020-07-10 21:25:53,0.1407175925925926,1,153,70,223
2020-07-10 20:34:22,0.12311342592592593,1,4,1,5
2020-07-15 07:51:14,4.672835648148149,3,63,23,86
2020-07-10 15:34:24,0.05313657407407407,1,108,0,108
2020-07-13 15:23:23,3.0784143518518516,6,16,14,30
2020-07-10 15:37:56,0.15822916666666667,1,88,0,88
2020-07-10 15:38:04,0.16707175925925927,1,76,0,76
2020-07-10 15:38:12,0.21050925925925926,1,78,0,78
2020-07-10 09:41:11,0.015601851851851851,1,85,0,85
2020-07-31 08:34:47,21.315162037037037,3,22,0,22
2020-07-13 18:59:53,3.782638888888889,4,64,2,66
2020-07-10 14:31:48,0.684837962962963,4,191,108,299
2020-07-14 10:13:06,4.5410763888888885,2,4900,2497,7397
2020-07-10 15:38:23,0.8571527777777778,1,77,0,77
2020-07-09 19:13:22,0.00829861111111111,1,1,0,1
2020-07-09 17:54:33,0.011631944444444445,1,2,1,3
2020-07-09 17:35:21,0.04721064814814815,1,5,0,5
2020-07-10 15:38:37,1.0815046296296296,8,161,127,288
2020-07-09 15:03:08,0.009432870370370371,1,19,19,38
2020-07-09 20:29:33,0.2835416666666667,4,135,133,268
2020-07-14 07:47:41,4.777025462962963,1,2,2,4
2020-07-10 15:39:04,1.3307407407407408,1,74,8,82
2020-07-10 15:43:27,1.3913310185185186,2,2,2,4
2020-07-09 19:12:29,0.6363541666666667,1,2,2,4
2020-07-29 18:26:26,20.748101851851853,8,719,88,807
2020-07-08 23:52:44,0.009583333333333333,1,8,8,16
2020-07-08 20:08:57,0.10076388888888889,1,277,0,277
2020-07-14 09:12:34,5.716585648148148,2,32,3,35
2020-07-08 14:04:00,0.005115740740740741,5,2311,2138,4449
2020-07-08 20:07:49,0.32144675925925925,1,63,0,63
2020-07-08 21:54:52,0.3945138888888889,3,94,3,97
2020-07-08 10:11:10,0.06693287037037036,8,131,43,174
2020-07-27 09:31:38,19.922372685185184,2,26,9,35
2020-07-08 12:46:36,0.638287037037037,1,8,10,18
2020-07-09 13:19:20,1.7670138888888889,5,110,9,119
2020-07-07 17:46:05,0.008703703703703703,1,4,0,4
2020-07-17 14:17:43,2.6606597222222224,16,984,399,1383
2020-07-07 14:35:13,0.03550925925925926,4,33,11,44
2020-07-10 15:39:45,3.0691319444444445,1,117,0,117
2020-07-10 15:42:49,3.1363310185185185,1,96,0,96
2020-07-07 15:06:13,0.43,2,36,36,72
2020-07-06 22:45:01,0.0006597222222222222,1,37,19,56
2020-07-07 08:48:07,0.48082175925925924,4,55,60,115
2020-07-06 21:26:49,0.6007291666666666,2,34,16,50
2020-07-06 22:27:54,0.3136226851851852,3,42,25,67
2020-07-06 15:22:25,0.5953819444444445,1,1,1,2
2020-07-06 15:15:26,0.01306712962962963,2,3,3,6
2020-07-06 16:17:05,0.06547453703703704,1,7,1,8
2020-07-06 15:33:57,0.04908564814814815,2,4,0,4
2020-07-07 10:38:16,1.0938657407407408,2,57,1,58
2020-07-06 13:55:11,0.6609606481481481,1,1,1,2
2020-07-07 10:33:43,2.0113773148148146,1,92,0,92
2020-07-07 08:17:38,21.904560185185186,5,261,89,350
2020-07-07 09:32:29,2.7920717592592594,8,48,27,75
2020-07-30 18:11:40,29.142847222222223,26,29436,9889,39325
2020-07-07 10:39:10,3.043125,1,88,0,88
2020-07-07 10:40:24,3.0503935185185185,1,26,0,26
2020-08-25 10:02:08,52.19934027777778,18,45785,14764,60549
2020-07-06 13:14:58,2.416446759259259,1,1,1,2
2020-07-03 17:25:26,0.19844907407407408,1,8,0,8
2020-07-09 13:11:40,6.063310185185185,8,35,23,58
2020-07-06 13:15:22,3.076724537037037,1,1,1,2
2020-07-07 10:43:10,4.07380787037037,1,102,0,102
2020-07-07 10:43:35,4.075358796296296,1,3,0,3
2020-07-07 10:43:49,4.076122685185185,1,3,0,3
2020-07-03 14:51:21,0.7095254629629629,6,331,251,582
2020-07-08 00:17:59,6.1345833333333335,7,1617,98,1715
2020-07-02 17:57:33,0.007835648148148149,1,2,2,4
2020-08-03 12:10:40,31.88396990740741,13,3560,2094,5654
2020-07-02 21:07:43,0.95375,5,290,45,335
2020-07-02 13:19:34,0.002210648148148148,1,1,1,2
2020-07-02 11:53:33,0.10600694444444445,6,402,232,634
2020-07-03 10:19:50,1.004386574074074,1,86,0,86
2020-07-02 09:56:44,0.02488425925925926,3,241,220,461
2020-07-07 14:06:49,5.4227893518518515,4,7,13,20
2020-07-03 12:16:28,1.3788310185185184,1,1,1,2
2020-07-01 22:20:50,0.0015046296296296296,2,2,1,3
2020-07-07 22:04:15,6.008206018518519,6,183,31,214
2020-07-03 12:25:57,1.6390277777777778,1,11,9,20
2020-07-01 15:42:23,0.021597222222222223,1,1,1,2
2020-07-01 15:03:00,0.029780092592592594,2,1,1,2
2020-07-01 18:30:43,0.15349537037037037,1,4,0,4
2020-07-10 15:36:54,9.070844907407407,38,4473,3307,7780
2020-07-01 16:27:15,0.2445138888888889,1,161,21,182
2020-07-02 14:16:31,1.1569097222222222,1,85,0,85
2020-07-07 10:41:42,6.033784722222222,2,89,2,91
2020-07-03 08:29:21,2.021412037037037,8,15,14,29
2020-07-01 20:43:18,0.15944444444444444,3,136,17,153
2020-07-01 09:01:51,0.3073726851851852,2,79,7,86
2020-07-02 13:23:00,1.6050578703703704,1,1,1,2
2020-07-01 15:00:21,0.6859606481481482,9,1122,371,1493
2020-07-02 23:23:56,2.0872337962962964,1,7,7,14
2020-06-30 20:41:44,0.004826388888888889,1,1,1,2
2020-06-30 20:17:12,0.0008564814814814815,1,1,1,2
2020-10-21 11:10:17,224.54322916666666,88,225682,62333,288015
2020-07-03 18:27:49,2.9430092592592594,4,3281,1150,4431
2020-06-30 20:12:15,0.02494212962962963,2,401,65,466
2020-07-01 12:11:25,0.6920486111111112,1,228,69,297
2020-06-30 19:29:13,0.01287037037037037,3,6,8,14
2020-06-30 19:28:15,0.022083333333333333,1,5,4,9
2020-07-01 08:01:56,0.6459837962962963,1,11,0,11
2020-07-01 12:11:56,0.825162037037037,6,71,16,87
2020-07-03 12:29:10,3.0164699074074073,1,102,0,102
2020-07-07 16:15:54,7.232152777777777,32,13381,8343,21724
2020-06-30 10:11:11,0.0005439814814814814,1,3,0,3
2020-07-01 15:27:47,1.30875,12,73,27,100
2020-06-30 15:43:44,0.7486226851851852,3,378,57,435
2020-06-29 22:27:37,0.17037037037037037,2,19,5,24
2020-06-30 12:59:33,0.8049421296296296,4,36,28,64
2020-06-30 10:01:45,0.6840162037037038,1,5,2,7
2020-06-30 10:01:12,0.6862152777777778,1,1,1,2
2020-06-30 10:00:30,0.6884375,1,2,2,4
2020-06-30 10:02:24,0.6919212962962963,1,3,4,7
2020-06-29 16:54:30,0.06508101851851852,8,2,2,4
2020-06-29 15:34:52,0.009780092592592592,3,2,2,4
2020-06-29 15:08:55,0.0027083333333333334,3,7,5,12
2020-06-29 14:36:04,0.002013888888888889,1,48,46,94
2020-07-07 21:21:24,8.299363425925925,1,10,0,10
2020-06-29 13:51:14,0.003981481481481482,1,2,2,4
2020-06-29 14:08:58,0.8010069444444444,7,457,193,650
2020-06-29 13:02:34,0.07811342592592592,1,12,13,25
2020-06-29 13:01:56,0.07865740740740741,1,113,0,113
2020-06-30 06:05:02,0.9043865740740741,2,3,3,6
2020-06-29 12:58:31,0.5008449074074074,1,59,0,59
2020-06-29 12:41:42,0.4920486111111111,2,62,1,63
2020-06-29 12:36:01,0.48734953703703704,1,59,0,59
2020-07-01 14:31:18,2.590763888888889,1,66,86,152
2020-06-28 16:54:55,0.12520833333333334,1,2,2,4
2020-06-28 12:32:26,0.01542824074074074,1,21,38,59
2020-06-29 12:53:21,1.5310416666666666,3,197,132,329
2020-08-03 13:00:39,37.38060185185185,4,13,10,23
2020-06-28 19:08:29,1.925335648148148,5,359,237,596
2020-06-30 23:45:36,4.029131944444444,1,2,1,3
2020-06-29 08:29:15,2.4278125,3,11,3,14
2020-06-29 09:06:05,2.4972453703703703,2,820,10,830
2020-06-27 15:10:03,0.8211342592592593,1,211,147,358
2020-06-26 23:20:43,0.17396990740740742,8,2384,241,2625
2020-06-27 15:09:52,0.8717476851851852,2,2314,176,2490
2020-06-30 19:01:54,4.968819444444445,5,9897,5721,15618
2020-06-26 19:03:41,0.16327546296296297,9,26,25,51
2020-06-26 16:53:10,0.006342592592592592,1,2,0,2
2020-06-29 05:47:45,2.598009259259259,4,172,0,172
2020-06-26 15:38:13,0.007627314814814815,7,2028,3,2031
2020-06-26 17:48:14,0.14487268518518517,6,193,151,344
2020-06-29 08:58:56,2.7855324074074073,1,432,4,436
2020-06-26 14:58:12,0.11429398148148148,7,12,10,22
2020-06-26 17:59:32,0.9255092592592593,4,2933,3095,6028
2020-06-26 15:43:24,0.8527199074074074,2,14,3,17
2020-06-25 20:17:15,0.047314814814814816,5,67,39,106
2020-06-26 12:08:32,0.8907291666666667,6,392,255,647
2020-06-25 15:45:06,0.028391203703703703,1,1,1,2
2020-07-07 12:56:13,34.653888888888886,65,34917,14708,49625
2020-06-26 12:01:19,0.8857175925925926,5,258,37,295
2020-06-25 14:13:02,0.008460648148148148,3,12,5,17
2020-06-29 06:38:33,3.884537037037037,3,62,15,77
2020-06-25 05:56:08,0.2625810185185185,1,23,0,23
2020-06-28 18:53:48,3.858888888888889,6,7887,4539,12426
2020-06-24 22:43:20,0.06356481481481481,4,382,8,390
2020-06-24 19:16:05,0.0019097222222222222,1,1,1,2
2020-06-30 14:42:08,5.832847222222222,10,11356,6640,17996
2020-06-24 19:06:15,0.14283564814814814,4,580,165,745
2020-06-25 15:24:29,0.942488425925926,10,1030,401,1431
2020-06-24 16:13:44,0.0030555555555555557,1,7,6,13
2020-07-01 16:40:14,7.033402777777778,2,14,5,19
2020-06-24 15:35:55,0.0052662037037037035,1,9,2,11
2020-06-24 14:59:06,0.008101851851851851,2,8,3,11
2020-06-26 13:00:15,1.929699074074074,3,61,23,84
2020-06-24 14:37:02,0.0037962962962962963,1,15,1,16
2020-06-24 13:59:07,0.01646990740740741,1,1,1,2
2020-06-24 13:58:50,0.01818287037037037,1,1,1,2
2020-06-24 13:11:43,0.03619212962962963,4,179,107,286
2020-06-24 15:41:09,59.524791666666665,4,57570,18326,75896
2020-06-24 08:10:37,0.07155092592592592,2,8,13,21
2020-06-25 06:17:03,1.245162037037037,1,20,7,27
2020-06-24 15:37:20,0.6502430555555555,2,492,135,627
2020-06-23 20:40:46,0.030381944444444444,2,15,1,16
2020-06-24 11:56:15,0.6922337962962963,1,39,40,79
2020-06-24 11:55:59,0.7204398148148148,1,6,3,9
2020-06-23 21:30:18,0.12775462962962963,2,10,8,18
2020-06-23 21:05:12,0.12486111111111112,3,133,14,147
2020-07-01 15:43:33,1.9256597222222223,19,2780,2376,5156
2020-06-24 08:40:50,0.739212962962963,1,58,0,58
2020-06-23 08:49:19,0.05648148148148148,2,20,15,35
2020-06-23 03:39:05,0.0013194444444444445,1,0,1,1
2020-06-23 03:31:37,0.0015625,1,1,7,8
2020-06-25 03:58:12,6.377511574074074,57,11625,2899,14524
2020-06-24 08:42:47,1.4294097222222222,1,3,3,6
2020-07-14 07:16:23,21.489143518518517,20,40531,14615,55146
2020-06-24 18:38:15,1.9015856481481481,3,49,14,63
2020-06-22 21:47:34,0.013425925925925926,2,2,1,3
2020-06-24 14:09:18,1.7278935185185185,4,102,33,135
2020-06-22 20:38:53,0.00619212962962963,1,11,2,13
2020-06-23 15:35:43,0.865625,7,2034,1110,3144
2020-06-22 19:49:51,0.04619212962962963,3,3,3,6
2020-06-22 18:43:53,0.03149305555555556,1,479,428,907
2020-06-22 17:00:12,0.008796296296296297,1,2,0,2
2020-06-23 11:37:30,0.8451504629629629,1,8,3,11
2020-07-01 14:32:50,8.988460648148148,6,16330,8250,24580
2020-06-22 17:45:46,0.20671296296296296,1,81,0,81
2020-06-22 13:48:15,0.046469907407407404,5,138,6,144
2020-06-22 22:26:13,0.5634027777777778,1,1,1,2
2020-06-22 21:24:28,0.622800925925926,3,65,4,69
2020-06-22 08:51:17,0.4869675925925926,1,1,1,2
2020-06-22 17:49:14,1.219074074074074,1,20,0,20
2020-06-22 21:59:55,2.1502199074074073,1,20,0,20
2020-06-20 14:56:40,0.11164351851851852,1,1,1,2
2020-06-21 15:51:22,1.212002314814815,3,5,10,15
2020-06-22 21:59:34,2.770347222222222,2,27,1,28
2020-06-20 05:21:20,0.08734953703703703,1,1,1,2
2020-06-22 22:00:54,2.7821296296296296,1,20,0,20
2020-06-22 12:30:50,2.625023148148148,3,151,57,208
2020-06-22 08:49:23,2.517037037037037,1,2,2,4
2020-06-23 00:40:11,3.337962962962963,16,8937,1423,10360
2020-06-22 20:08:09,4.332962962962963,11,1021,560,1581
2020-06-19 17:33:25,0.029733796296296296,2,4,1,5
2020-06-19 13:41:32,0.018287037037037036,1,1,1,2
2020-06-22 08:58:28,3.206099537037037,1,2,2,4
2020-06-20 02:13:34,0.9301851851851852,1,2,0,2
2020-06-29 13:05:09,10.425347222222221,1,1,0,1
2020-07-07 17:23:01,18.707141203703703,37,27181,9872,37053
2020-06-18 22:07:59,0.003287037037037037,1,2,1,3
2020-06-18 22:06:28,0.049699074074074076,3,13,12,25
2020-06-22 15:25:44,3.7736342592592593,5,8419,910,9329
2020-06-18 23:20:05,0.12782407407407406,1,16,4,20
2020-06-19 00:47:38,0.20994212962962963,4,24,18,42
2020-06-19 00:34:49,0.23502314814814815,2,3,11,14
2020-06-18 17:47:06,0.17782407407407408,1,5,1,6
2020-06-18 20:30:24,0.17105324074074074,1,14,18,32
2020-06-24 08:45:52,5.760347222222222,2,49,1,50
2020-06-22 17:47:30,4.1717361111111115,2,69,1,70
2020-06-23 11:36:58,5.161180555555555,13,10125,1712,11837
2020-06-17 20:39:18,0.005069444444444444,1,2,1,3
2020-06-17 20:31:06,0.0067476851851851856,1,4,4,8
2020-06-17 20:08:43,0.0031018518518518517,1,1,1,2
2020-06-20 07:16:31,2.5531828703703705,3,7,3,10
2020-06-18 23:04:04,1.3172569444444444,3,4,4,8
2020-06-17 18:01:11,0.13841435185185186,3,113,63,176
2020-06-17 15:45:06,0.07034722222222223,1,2,1,3
2020-06-18 07:16:30,0.827511574074074,1,5,5,10
2020-06-20 05:41:47,2.8208680555555556,31,3665,2168,5833
2020-06-20 15:00:04,3.3488657407407407,1,1,1,2
2020-06-16 20:46:21,0.001736111111111111,1,1,1,2
2020-06-16 20:50:03,0.022604166666666668,1,188,144,332
2020-06-17 11:55:21,0.7857638888888889,2,140,69,209
2020-06-17 19:24:52,1.2528703703703703,5,99,65,164
2020-06-16 18:06:46,0.2219560185185185,1,7,7,14
2020-06-24 19:53:09,9.41287037037037,5,18668,8033,26701
2020-06-26 09:55:58,10.007233796296296,11,206,107,313
2020-06-16 07:40:44,0.24994212962962964,1,22,30,52
2020-06-16 13:48:20,0.5627662037037037,2,14,7,21
2020-06-16 07:25:26,0.3923263888888889,10,134,24,158
2020-06-25 20:46:00,1.2129282407407407,17,4556,4978,9534
2020-06-25 21:11:11,9.98869212962963,7,16747,3529,20276
2020-06-15 22:31:41,0.039502314814814816,3,151,8,159
2020-06-17 18:48:06,1.9721412037037036,9,11019,9037,20056
2020-06-16 22:14:58,1.0753587962962963,1,11,10,21
2020-06-16 08:17:47,0.49627314814814816,2,12,5,17
2020-06-16 08:19:09,0.49983796296296296,2,12,5,17
2020-06-16 17:03:42,0.8729282407407407,1,18,101,119
2020-06-16 12:06:32,0.6952314814814815,2,237,641,878
2020-06-15 20:50:09,0.08283564814814814,3,12,4,16
2020-06-15 19:50:17,0.12458333333333334,1,5,0,5
2020-06-15 15:58:34,0.04681712962962963,2,61,84,145
2020-06-15 17:29:27,0.11679398148148148,1,20,0,20
2020-06-22 22:40:00,7.334895833333333,1,59,0,59
2020-06-22 22:40:20,7.368576388888889,3,77,1,78
2020-06-22 22:39:30,7.446956018518518,4,204,43,247
2020-06-22 22:39:23,7.468981481481482,2,41,2,43
2020-06-15 17:13:59,0.31050925925925926,2,18,4,22
2020-06-15 09:04:52,0.07162037037037038,2,13,10,23
2020-06-15 17:36:58,0.42461805555555554,1,6,1,7
2020-07-08 20:18:18,24.282037037037036,22,312,232,544
2020-06-22 14:10:45,9.117766203703704,17,1823,918,2741
2020-06-15 09:39:42,1.9435300925925927,2,67,0,67
2020-06-14 19:36:14,1.386412037037037,1,36,38,74
2020-06-15 12:43:51,2.2038078703703703,2,4,1,5
2020-06-16 20:36:59,54.11574074074074,153,80424,51049,131473
2020-06-12 18:20:20,2.9165046296296295,7,338,36,374
2020-06-18 18:59:35,6.47417824074074,8,14234,9853,24087
2020-06-22 13:40:53,79.24760416666666,16,52182,12987,65169
2020-06-17 17:51:35,30.01255787037037,250,37547,20655,58202
2020-06-12 02:11:35,0.05582175925925926,1,1,4,5
2020-06-15 18:06:18,3.808171296296296,4,99,46,145
2020-06-15 12:30:41,3.6686342592592593,2,3,3,6
2020-06-11 19:28:02,0.0068865740740740745,1,5,6,11
2020-06-24 15:18:30,12.865868055555556,1,1,1,2
2020-06-16 12:03:44,2.1158564814814813,4,9331,8368,17699
2020-06-11 17:16:35,0.22846064814814815,1,47,0,47
2020-06-12 08:01:50,1.3599189814814814,10,580,59,639
2020-06-17 21:54:17,6.632916666666667,1,4,3,7
2020-06-17 22:04:12,6.682824074074074,1,2,2,4
2020-06-11 06:11:22,0.15733796296296296,1,8,3,11
2020-06-17 21:46:59,6.8165625,1,2,2,4
2020-06-10 22:38:34,0.07049768518518519,1,46,23,69
2020-06-11 14:31:26,0.7594212962962963,3,73,41,114
2020-06-10 19:53:16,0.007372685185185185,1,1,3,4
2020-06-10 19:17:52,0.0838425925925926,9,246,16,262
2020-06-22 10:06:57,3.8266319444444443,8,1095,418,1513
2020-06-10 17:19:54,0.04005787037037037,1,59,9,68
2020-06-10 16:11:00,0.05644675925925926,6,255,185,440
2020-06-12 19:47:57,2.2263078703703703,12,157,12,169
2020-06-10 18:06:56,0.21832175925925926,1,21,3,24
2020-06-10 13:26:06,0.03391203703703704,2,4,2,6
2020-06-19 20:38:37,10.282638888888888,21,18187,10132,28319
2020-06-10 12:10:21,0.6035532407407408,2,33,21,54
2020-06-09 20:14:02,0.016400462962962964,1,1,1,2
2020-06-10 22:25:56,1.1990162037037038,4,18,7,25
2020-06-30 23:49:12,21.32324074074074,7,159,123,282
2020-06-14 17:04:49,5.010474537037037,3,3047,987,4034
2020-06-09 21:38:28,0.26403935185185184,2,4,62,66
2020-06-10 22:26:43,1.3553356481481482,9,2145,1121,3266
2020-06-12 13:03:13,2.9819444444444443,1,3,0,3
2020-06-10 21:29:42,1.336886574074074,1,3,0,3
2020-07-31 08:44:23,51.85777777777778,2,27,0,27
2020-06-09 23:14:28,0.467662037037037,1,3,0,3
2020-06-12 13:03:44,3.0624421296296296,1,64,0,64
2020-06-09 01:22:37,0.14074074074074075,3,29,4,33
2020-06-13 13:35:14,4.77994212962963,13,4072,1737,5809
2020-06-10 00:05:10,1.2173958333333332,3,4,28,32
2020-06-10 20:28:19,2.171238425925926,3,15,11,26
2020-06-09 21:12:43,1.2448148148148148,16,1094,861,1955
2020-06-08 15:28:20,0.025983796296296297,2,276,61,337
2020-06-08 13:31:33,0.0745949074074074,2,14,3,17
2020-06-08 16:28:51,0.6068402777777778,1,3,5,8
2020-06-09 15:14:12,1.8507175925925925,5,192,265,457
2020-06-08 13:45:24,1.1865972222222223,2,4,8,12
2020-07-07 12:57:09,30.398078703703703,11,41580,18023,59603
2020-07-02 09:19:07,25.332650462962963,1,4,1,5
2020-06-08 09:36:10,1.5622800925925926,1,4,6,10
2020-06-07 15:55:10,0.8768634259259259,1,1,0,1
2020-06-06 04:52:17,0.06557870370370371,2,3,2,5
2020-06-05 22:45:20,0.02861111111111111,4,13,7,20
2020-06-05 22:45:43,0.03991898148148148,2,165,40,205
2020-06-08 13:31:13,0.09585648148148149,1,191,46,237
2020-06-05 21:16:38,0.020092592592592592,2,40,1,41
2020-06-08 12:14:33,2.6558680555555556,2,10,2,12
2020-06-05 20:41:47,0.012638888888888889,1,17,17,34
2020-06-05 19:29:20,0.007453703703703704,1,2,1,3
2020-06-05 18:57:24,0.00931712962962963,2,1,9,10
2020-06-05 21:27:32,0.14827546296296296,1,2,1,3
2020-06-08 21:08:05,3.1361921296296296,4,338,179,517
2020-06-06 00:47:03,0.3155208333333333,1,12,0,12
2020-06-05 19:20:30,0.09697916666666667,2,3,3,6
2020-06-05 16:36:23,0.0040625,1,3,3,6
2020-06-05 16:22:50,0.07502314814814814,2,495,2,497
2020-06-06 01:16:49,1.0508449074074073,1,1,1,2
2020-06-04 23:15:08,0.08079861111111111,1,40,0,40
2020-06-05 11:56:12,0.6524421296296297,1,1,0,1
2020-06-04 21:57:05,0.1550462962962963,1,1,1,2
2020-06-09 07:44:00,4.579050925925926,1,4,1,5
2020-06-04 17:41:25,0.0503125,1,0,1,1
2020-06-04 17:43:15,0.06032407407407407,1,8,0,8
2020-06-04 15:44:39,0.019918981481481482,2,17,12,29
2020-06-04 20:58:41,0.389537037037037,2,100,1,101
2020-06-04 12:13:53,0.03914351851851852,1,0,8,8
2020-06-10 23:03:07,67.63804398148149,8,45429,11013,56442
2020-06-04 22:30:32,0.7120833333333333,1,6,0,6
2020-06-03 20:31:00,0.0006597222222222222,1,3,2,5
2020-06-05 16:01:43,1.78,2,5,1,6
2020-06-03 16:53:24,0.055601851851851854,1,2,2,4
2020-06-04 20:59:37,1.2368402777777778,1,10,0,10
2020-06-04 20:59:57,1.4150810185185185,1,73,0,73
2020-06-03 09:07:27,0.3133680555555556,4,8,5,13
2020-06-03 07:40:14,0.4342476851851852,3,114,0,114
2020-06-15 14:10:26,12.834606481481481,3,10,2,12
2020-06-02 16:59:01,0.00829861111111111,1,1,0,1
2020-06-02 14:21:09,0.016273148148148148,2,40,35,75
2020-06-03 20:48:29,1.3415625,7,15,10,25
2020-06-03 13:36:27,1.091087962962963,5,241,111,352
2020-06-02 21:08:40,0.4207175925925926,3,157,92,249
2020-06-24 16:14:50,22.313773148148147,1,3,1,4
2020-06-02 09:02:27,0.02267361111111111,1,3,0,3
2020-06-01 19:22:52,0.0062037037037037035,1,6,6,12
2020-06-02 08:29:29,0.567962962962963,2,3,2,5
2020-06-02 07:59:53,1.2631828703703705,1,1,0,1
2020-06-01 12:27:01,2.008958333333333,1,16,16,32
2020-06-02 09:03:47,2.9285995370370372,2,11,6,17
2020-06-01 09:45:54,2.0463425925925924,1,65,0,65
2020-06-04 23:13:18,5.973680555555555,4,168,32,200
2020-05-29 23:25:19,0.0866087962962963,2,50,4,54
2020-05-29 17:38:57,0.0004976851851851852,1,1,0,1
2020-05-29 15:58:43,0.10518518518518519,9,131,63,194
2020-06-01 12:28:26,3.1166435185185186,1,124,0,124
2020-06-01 12:28:43,3.1220833333333333,1,124,0,124
2020-06-01 12:29:10,3.128645833333333,1,124,0,124
2020-06-22 14:47:15,24.53935185185185,9,35554,13828,49382
2020-05-29 11:12:35,0.7927777777777778,2,11,11,22
2020-05-28 20:27:23,0.18469907407407407,1,1,0,1
2020-05-29 11:46:09,1.006747685185185,6,233,69,302
2020-05-28 20:35:16,0.5463657407407407,3,1756,1463,3219
2020-06-01 14:12:49,11.85113425925926,7,46,22,68
2020-05-28 10:48:19,0.22255787037037036,1,122,0,122
2020-06-01 13:23:32,4.6244097222222225,15,5775,1337,7112
2020-06-02 13:39:34,5.426770833333333,7,799,1330,2129
2020-06-03 07:51:32,6.433263888888889,8,7789,2470,10259
2020-05-28 20:44:43,1.003449074074074,2,19,19,38
2020-05-28 09:11:06,0.5729282407407408,3,71,16,87
2020-05-27 16:48:04,0.004085648148148148,1,54,0,54
2020-06-02 17:40:14,6.754872685185185,6,42,22,64
2020-06-04 22:07:50,8.290567129629629,1,17,24,41
2020-05-27 15:36:56,0.05320601851851852,8,100,713,813
2020-05-27 13:10:27,0.005601851851851852,1,11,0,11
2020-05-27 15:19:11,0.2022337962962963,1,8,1,9
2020-05-27 15:25:36,0.3128472222222222,1,124,0,124
2020-05-27 13:50:05,0.32994212962962965,1,68,12,80
2020-05-27 13:36:21,0.33069444444444446,1,135,0,135
2020-05-26 20:52:43,0.0578125,2,162,60,222
2020-05-26 20:54:43,0.22871527777777778,1,55,0,55
2020-05-26 20:38:39,0.22914351851851852,1,7,7,14
2020-05-26 12:58:48,0.14699074074074073,4,128,26,154
2020-05-26 20:50:09,0.5173726851851852,1,68,0,68
2020-06-04 04:57:01,9.277696759259259,15,190,142,332
2020-05-25 23:20:51,0.050381944444444444,1,5,5,10
2020-05-26 20:51:41,0.9741435185185185,1,19,3,22
2020-05-26 17:43:59,0.9190277777777778,2,29,61,90
2020-05-27 20:30:01,2.1278125,5,461,76,537
2020-05-25 19:28:31,0.11983796296296297,1,110,0,110
2020-05-29 16:13:31,4.154768518518519,2,3,5,8
2020-05-25 19:29:51,0.46172453703703703,1,2,2,4
2020-05-25 20:04:45,1.0506481481481482,4,22,13,35
2020-05-25 18:50:45,1.1850462962962962,1,2,3,5
2020-06-22 19:58:48,29.335949074074072,4,92,25,117
2020-05-25 19:12:23,1.382951388888889,1,11,0,11
2020-05-25 20:03:56,1.5718402777777778,1,11,2,13
2020-05-29 15:12:25,5.374664351851852,1,13,10,23
2020-05-26 14:43:42,2.7287268518518517,2,2,2,4
2020-06-09 21:39:07,17.161574074074075,43,15856,5754,21610
2020-05-23 13:41:00,0.3198726851851852,1,12,12,24
2020-05-25 19:29:33,2.6211805555555556,1,1,1,2
2020-05-28 14:54:46,5.606539351851852,1,10,4,14
2020-06-04 23:45:54,16.173078703703705,50,2700,878,3578
2020-05-22 22:08:31,0.039502314814814816,4,17,9,26
2020-05-22 19:17:09,0.005891203703703704,1,1,1,2
2020-05-22 19:04:07,64.27171296296297,24,40071,11373,51444
2020-06-15 21:12:52,24.898518518518518,23,23316,10217,33533
2020-05-22 21:49:46,1.0543981481481481,3,5,9,14
2020-05-28 09:18:17,6.616793981481481,2,2799,1675,4474
2020-05-22 16:45:10,0.9860069444444445,1,69,0,69
2020-05-25 16:43:37,4.1092361111111115,19,605,98,703
2020-05-26 12:57:25,4.939305555555555,2,2,2,4
2020-05-20 20:23:22,0.10846064814814815,1,1,1,2
2020-05-20 20:08:29,0.1760648148148148,1,32,1,33
2020-05-20 15:59:46,0.030243055555555554,4,12,8,20
2020-05-20 13:45:50,0.10513888888888889,1,111,0,111
2020-05-21 13:17:04,1.2260763888888888,7,30,15,45
2020-05-20 20:48:30,0.591412037037037,1,1,1,2
2020-05-20 20:17:53,0.8653356481481481,1,2,1,3
2020-05-19 23:45:32,0.019097222222222224,2,10,13,23
2020-05-20 13:44:27,0.7497453703703704,1,23,0,23
2020-05-20 20:46:22,1.0484027777777778,3,8,14,22
2020-05-19 19:35:05,0.02065972222222222,2,37,20,57
2020-05-21 13:18:28,1.7616666666666667,5,50,51,101
2020-05-20 13:45:25,0.8414467592592593,1,92,0,92
2020-05-25 21:28:03,6.197106481481481,1,1,2,3
2020-05-19 19:52:37,0.16189814814814815,2,86,29,115
2020-05-21 13:17:45,1.9609837962962964,3,2381,387,2768
2020-05-19 16:26:28,0.07041666666666667,2,3,2,5
2020-05-19 03:13:33,0.0038310185185185183,1,1,3,4
2020-05-20 20:46:00,6.356400462962963,2,2,2,4
2020-05-19 00:17:36,0.051597222222222225,4,13,5,18
2020-05-18 18:23:58,0.11513888888888889,4,11,4,15
2020-05-18 22:48:57,0.37547453703703704,5,101,2,103
2020-05-18 15:25:58,0.07010416666666666,4,50,17,67
2020-05-18 22:44:42,0.4002199074074074,1,125,0,125
2020-05-18 22:41:35,0.5524652777777778,1,18,0,18
2020-05-18 13:24:42,0.18976851851851853,1,3,1,4
2020-05-18 18:32:33,0.4086689814814815,3,45,7,52
2020-05-19 13:56:25,1.3834953703703703,1,59,67,126
2020-05-18 22:18:18,0.8320717592592592,1,27,15,42
2020-05-18 15:31:36,0.686875,1,6,6,12
2020-05-18 16:23:21,0.7296296296296296,4,34,37,71
2020-05-18 13:51:41,0.671400462962963,1,12,14,26
2020-05-18 15:23:30,0.880625,1,1,1,2
2020-05-18 22:17:34,1.2928240740740742,1,10,3,13
2020-05-26 12:51:28,9.033877314814815,1,11,13,24
2020-05-18 22:17:14,1.625949074074074,2,39,1,40
2020-05-18 15:37:36,1.4470949074074073,1,4,1,5
2020-05-20 13:42:36,3.635011574074074,3,273,18,291
2020-05-19 03:16:06,2.3592939814814815,2,4,2,6
2020-05-18 15:34:01,2.197210648148148,1,29,29,58
2020-05-19 14:46:56,4.642465277777778,9,1324,474,1798
2020-05-19 23:45:49,5.016689814814815,12,3736,790,4526
2020-05-15 13:49:12,0.0043055555555555555,1,6,1,7
2020-05-15 13:47:16,0.007534722222222222,1,1,1,2
2020-05-18 22:10:24,60.40107638888889,22,36641,10738,47379
2020-05-15 13:52:01,0.6673263888888888,1,7,3,10
2020-05-14 17:14:27,0.02903935185185185,2,37,23,60
2020-05-14 18:39:45,0.20800925925925925,2,2,2,4
2020-05-14 18:07:33,0.23086805555555556,2,68,1,69
2020-05-14 18:06:11,0.3148148148148148,1,39,0,39
2020-05-25 20:04:30,11.755856481481482,1,1,0,1
2020-05-19 14:04:44,5.721273148148148,28,1540,430,1970
2020-06-18 22:41:27,77.18568287037037,65,53214,17225,70439
2020-05-14 00:04:58,0.04546296296296296,1,3,0,3
2020-05-14 00:05:16,0.2536689814814815,1,11,5,16
2020-05-15 14:33:09,1.9639930555555556,1,53,85,138
2020-05-14 12:59:53,0.910625,1,20,1,21
2020-05-18 12:54:04,5.172395833333334,1,1,3,4
2020-05-13 14:22:03,0.44883101851851853,1,1,1,2
2020-05-13 01:52:02,5.102349537037037,6,113,77,190
2020-08-12 11:52:43,91.63098379629629,3,88665,27465,116130
2020-05-12 19:00:57,0.03701388888888889,1,19,0,19
2020-05-13 13:22:32,1.2551273148148148,9,298,32,330
2020-05-12 19:01:18,0.15127314814814816,1,158,0,158
2020-05-12 19:02:46,0.1966550925925926,2,8,4,12
2020-05-12 19:01:35,0.2338425925925926,1,2,2,4
2020-05-12 19:01:46,0.25894675925925925,1,1,1,2
2020-05-12 12:34:18,0.2174074074074074,1,1,0,1
2020-05-19 00:34:50,6.965960648148148,8,108,34,142
2020-05-12 13:11:51,0.5667824074074074,1,6,2,8
2020-05-12 01:03:31,0.08886574074074075,2,4,4,8
2020-05-13 18:24:08,2.071724537037037,5,588,131,719
2020-05-11 20:43:57,0.006446759259259259,1,128,0,128
2020-05-11 19:05:37,0.0011111111111111111,1,7,7,14
2020-05-13 21:29:42,2.1472569444444445,18,1423,256,1679
2020-05-11 17:31:03,0.017800925925925925,1,5,11,16
2020-05-11 14:22:08,0.00730324074074074,1,57,0,57
2020-05-11 15:47:51,0.09449074074074074,1,1,1,2
2020-05-11 15:28:38,0.0952662037037037,5,14,6,20
2020-05-11 14:38:07,0.1373263888888889,4,16,14,30
2020-05-11 15:32:25,0.1282060185185185,2,61,1,62
2020-05-11 15:24:11,0.12886574074074075,1,47,4,51
2020-05-11 16:48:21,0.2894097222222222,2,3,3,6
2020-05-11 15:24:41,0.3561226851851852,1,100,5,105
2020-05-11 17:35:14,0.6943287037037037,1,14,1,15
2020-05-12 12:48:49,3.1375462962962963,22,865,198,1063
2020-05-11 16:45:53,0.975474537037037,1,1,1,2
2020-05-22 13:48:21,12.817083333333333,4,154,14,168
2020-05-14 20:35:53,8.907013888888889,46,1244,443,1687
2020-05-10 18:07:09,1.326898148148148,1,1,1,2
2020-05-27 01:13:07,17.943854166666668,1,2,0,2
2020-05-11 18:55:56,2.7890509259259257,2,5,5,10
2020-05-19 02:02:40,10.073645833333334,10,304,107,411
2020-05-11 14:53:43,2.8330439814814814,1,3,3,6
2020-05-14 17:36:02,6.991180555555555,34,6689,3821,10510
2020-05-08 13:45:10,0.0959375,2,43,35,78
2020-05-11 19:24:03,3.466921296296296,2,4,12,16
2020-05-08 18:10:06,0.7141666666666666,4,89,48,137
2020-05-08 12:30:06,0.2010763888888889,2,531,494,1025
2020-05-07 19:00:07,0.004560185185185185,2,61,35,96
2020-05-07 17:48:45,0.033715277777777775,5,2134,1361,3495
2020-06-22 15:09:06,45.95708333333334,1,1,1,2
2020-05-07 15:14:57,0.028877314814814814,1,1,6,7
2020-05-07 22:31:23,0.3510300925925926,1,51,0,51
2020-05-07 14:02:54,0.0020717592592592593,1,1,1,2
2020-05-10 13:02:37,2.981886574074074,3,11,11,22
2020-05-27 21:22:17,20.491099537037037,44,3372,3182,6554
2020-05-08 13:30:16,1.0463425925925927,1,67,0,67
2020-05-07 08:54:49,0.0011458333333333333,1,3,3,6
2020-05-07 08:50:12,0.013391203703703704,3,6,6,12
2020-05-07 08:28:32,0.0007986111111111112,1,2,2,4
2020-05-08 13:42:44,1.7383912037037037,1,44,0,44
2020-05-08 13:42:29,1.7410416666666666,1,85,0,85
2020-05-08 13:25:36,1.9072453703703705,1,77,0,77
2020-05-06 16:00:23,0.3680671296296296,1,1,0,1
2020-05-06 20:31:07,0.9783796296296297,1,2,2,4
2020-05-06 14:40:56,0.8281944444444445,1,556,0,556
2020-05-14 17:50:47,9.005590277777777,5,11232,3128,14360
2020-05-07 13:52:41,1.967476851851852,6,140,36,176
2020-05-10 17:54:57,11.81056712962963,57,19967,11899,31866
2020-05-07 14:34:05,5.738460648148148,12,329,155,484
2020-05-06 14:41:08,2.2672685185185184,1,54,0,54
2020-05-05 22:42:35,1.926435185185185,1,1,1,2
2020-05-08 13:27:29,5.047719907407408,2,113,23,136
2020-05-26 14:00:51,23.17107638888889,2,13,6,19
2020-05-03 10:40:08,0.31842592592592595,1,4,1,5
2020-05-06 14:38:30,3.962326388888889,1,2,2,4
2020-05-02 14:38:22,0.049479166666666664,1,1,2,3
2020-05-02 14:38:31,0.05018518518518519,1,1,1,2
2020-05-02 15:19:32,0.16260416666666666,3,68,3,71
2020-05-02 15:15:39,0.1840625,2,37,1,38
2020-05-02 08:25:23,0.39741898148148147,2,17,18,35
2020-05-02 14:52:12,0.4559375,1,34,0,34
2020-05-02 14:29:18,0.6707060185185185,2,30,1,31
2020-05-02 15:20:31,0.7346643518518519,3,3,3,6
2020-05-02 14:51:15,44.096111111111114,18,23931,7323,31254
2020-05-01 15:06:58,0.0077083333333333335,1,13,1,14
2020-05-01 15:46:42,0.06950231481481481,3,135,2,137
2020-05-08 16:06:58,7.12962962962963,10,12562,4220,16782
2020-05-06 16:24:49,5.32162037037037,1,8,2,10
2020-05-01 02:16:13,1.9379513888888888,1,110,0,110
2020-05-01 02:16:01,1.938761574074074,1,110,0,110
2020-05-01 02:15:48,1.939537037037037,1,111,0,111
2020-05-01 02:15:39,1.9422685185185184,1,111,0,111
2020-05-01 02:15:24,1.9471875,1,110,0,110
2020-05-07 23:44:52,9.13175925925926,4,294,45,339
2020-04-28 20:42:16,0.03079861111111111,1,3,3,6
2020-04-28 21:12:01,0.1475462962962963,3,5,4,9
2020-04-30 12:28:56,1.8179166666666666,1,47,47,94
2020-04-29 13:53:19,0.8904513888888889,1,0,9,9
2020-05-14 21:07:53,16.19591435185185,2,17,13,30
2020-05-04 00:18:37,6.059548611111111,4,367,373,740
2020-04-28 14:33:24,0.008935185185185185,1,50,12,62
2020-04-28 19:35:31,0.2772453703703704,1,13,0,13
2020-04-28 19:32:56,10.402210648148149,1,12,11,23
2020-04-28 19:29:31,1.1541666666666666,1,107,0,107
2020-05-01 02:26:59,2.8066319444444443,3,70,4,74
2020-04-29 00:27:14,0.985,3,219,199,418
2020-04-28 07:12:25,0.35208333333333336,1,1,1,2
2020-05-13 12:32:58,15.584710648148148,1,0,1,1
2020-05-04 23:58:25,7.219074074074074,1,4,1,5
2020-05-06 16:56:52,10.850972222222222,21,1673,1286,2959
2020-04-29 13:47:21,1.9852083333333332,9,22,20,42
2020-04-27 22:29:56,0.5826041666666667,1,50,0,50
2020-04-27 22:27:47,0.5838888888888889,1,53,0,53
2020-04-27 22:27:05,0.591550925925926,1,72,0,72
2020-04-28 12:32:31,1.6031134259259259,1,11,1,12
2020-04-27 22:25:17,1.037835648148148,1,68,0,68
2020-04-28 23:13:59,2.086388888888889,2,32,8,40
2020-04-28 12:33:16,1.6824421296296297,2,25,15,40
2020-04-27 22:21:02,1.2177777777777778,1,194,0,194
2020-04-27 22:18:55,1.8010185185185186,2,3,1,4
2020-04-27 16:27:16,1.5762268518518519,3,4,2,6
2020-04-30 12:33:10,4.443553240740741,1,1,1,2
2020-05-05 14:23:02,9.87298611111111,3,4,4,8
2020-04-27 15:17:15,2.023275462962963,1,11,75,86
2020-05-01 15:28:56,6.0653703703703705,1,9,10,19
2020-04-25 13:16:41,0.16597222222222222,1,25,0,25
2020-05-12 12:32:45,17.260844907407407,1,2,2,4
2020-05-17 07:25:18,44.01475694444444,8,105,36,141
2020-04-28 19:18:57,3.9276388888888887,2,1,2,3
2020-05-29 15:55:56,34.871006944444446,1,28,17,45
2020-05-22 23:10:23,28.259328703703705,10,20216,4765,24981
2020-05-01 02:14:09,6.896840277777778,9,32,20,52
2020-05-01 02:40:14,7.149479166666667,1,47,9,56
2020-05-11 17:10:01,17.82991898148148,2,36,2,38
2020-05-01 02:30:16,7.220335648148148,2,62,68,130
2020-04-23 17:18:16,0.0043055555555555555,1,1,1,2
2020-04-23 15:15:10,0.002928240740740741,1,0,1,1
2020-04-23 18:25:31,0.1777662037037037,1,1,1,2
2020-04-24 14:24:29,1.9258680555555556,3,24,6,30
2020-04-24 14:24:01,1.306087962962963,1,50,0,50
2020-05-05 02:42:28,11.886539351851852,4,95,56,151
2020-04-24 11:55:35,1.5231018518518518,2,4,4,8
2020-04-28 22:22:37,21.394988425925927,109,14688,8649,23337
2020-04-27 17:25:54,4.816388888888889,1,4,4,8
2020-04-23 18:19:46,1.0177199074074075,1,2,5,7
2020-04-22 15:02:30,0.007476851851851852,1,1,1,2
2020-04-22 18:56:43,0.8958564814814814,1,106,0,106
2020-04-22 18:54:18,0.8957638888888889,1,7,6,13
2020-04-24 19:57:01,3.1614699074074073,1,128,0,128
2020-04-21 18:13:31,0.14202546296296295,1,43,15,58
2020-04-21 19:31:37,0.7393287037037037,3,26,7,33
2020-04-20 14:49:57,0.027118055555555555,2,38,24,62
2020-04-28 20:40:21,0.0009722222222222222,1,79,0,79
2020-04-20 21:10:02,0.7922453703703703,1,2,0,2
2020-04-20 14:10:57,0.8482986111111112,1,24,36,60
2020-04-20 18:39:17,1.2533564814814815,2,1,5,6
2020-04-21 07:08:21,1.8568287037037037,1,1,1,2
2020-04-17 15:26:17,0.004548611111111111,1,2,2,4
2020-04-17 15:25:15,0.0044444444444444444,1,1,1,2
2020-04-20 23:37:45,3.3780208333333333,1,6,6,12
2020-04-18 00:08:13,0.9042708333333334,1,103,5,108
2020-04-20 20:58:53,4.1696990740740745,1,14,2,16
2020-04-16 19:10:36,0.15752314814814813,1,1,1,2
2020-04-16 19:15:19,0.1966087962962963,4,42,20,62
2020-04-16 15:04:33,0.0908449074074074,1,1,1,2
2020-04-16 18:00:42,1.583773148148148,9,144,137,281
2020-04-17 14:45:30,1.7347800925925927,4,194,6,200
2020-04-16 19:11:24,1.1571180555555556,1,1,1,2
2020-04-16 13:55:26,1.096863425925926,7,203,450,653
2020-04-22 00:11:56,8.066493055555556,18,2887,2772,5659
2020-04-18 00:07:19,3.1419212962962964,2,49,16,65
2020-04-16 14:21:34,1.7605324074074074,1,21,52,73
2020-04-16 13:58:58,1.8030902777777778,1,1,1,2
2020-04-17 15:28:55,2.971539351851852,2,7,6,13
2020-04-17 15:14:12,3.007199074074074,1,12,6,18
2020-04-20 21:07:35,6.921921296296296,1,32,0,32
2020-04-14 02:29:29,0.2300347222222222,1,27,13,40
2020-04-16 19:02:44,3.017349537037037,3,32,29,61
2020-06-11 17:02:34,78.0746412037037,57,54936,15839,70775
2020-04-16 14:14:53,1.807199074074074,14,449,151,600
2020-04-13 14:11:19,0.8667939814814815,1,5,1,6
2020-04-17 15:23:19,5.057974537037037,1,11,0,11
2020-04-22 13:37:03,11.243726851851852,82,17535,4966,22501
2020-04-16 07:04:33,4.610173611111111,10,103,30,133
2020-04-11 10:42:07,22.92310185185185,12,13535,2523,16058
2020-04-20 20:08:57,9.818020833333334,3,71,50,121
2020-04-16 15:19:25,5.803842592592592,1,13,1,14
2020-04-10 20:03:28,0.006863425925925926,1,1,8,9
2020-04-10 16:34:05,0.001724537037037037,1,4,20,24
2020-04-11 10:45:00,8.883958333333334,7,5806,1220,7026
2020-04-14 18:40:29,4.177361111111111,12,390,216,606
2020-04-20 14:54:40,10.544490740740741,3,87,0,87
2020-10-19 13:55:42,214.99712962962963,127,3137,1659,4796
2020-04-13 16:11:23,4.248344907407407,5,54,48,102
2020-04-18 11:43:58,9.867951388888889,21,4617,1974,6591
2020-04-10 18:23:49,1.993125,1,6,8,14
2020-04-10 16:53:54,156.6834027777778,24,83145,37167,120312
2020-04-08 16:12:52,0.09431712962962963,1,1,0,1
2020-04-09 18:44:57,1.2974074074074073,1,1,1,2
2020-04-10 14:20:18,2.5548148148148146,5,110,143,253
2020-04-08 20:22:44,1.0288657407407407,2,202,85,287
2020-04-09 23:02:50,2.18875,15,479,175,654
2020-04-08 13:45:02,0.8340277777777778,1,69,25,94
2020-04-07 20:25:57,0.31171296296296297,3,922,876,1798
2020-04-10 16:21:58,3.4567939814814816,4,558,338,896
2020-04-08 13:10:21,1.3672222222222221,2,21,2,23
2020-04-07 18:01:31,0.8541087962962963,5,1466,592,2058
2020-04-06 20:27:51,0.04783564814814815,1,54,0,54
2020-04-06 22:47:52,0.2005787037037037,1,1,1,2
2020-04-06 20:30:03,0.16609953703703703,1,80,0,80
2020-04-06 20:29:52,0.17083333333333334,1,82,0,82
2020-04-06 20:29:45,0.17945601851851853,1,53,0,53
2020-04-06 20:29:36,0.18157407407407408,2,54,1,55
2020-04-06 20:29:26,0.18909722222222222,2,81,1,82
2020-04-06 20:29:03,0.1979861111111111,1,82,0,82
2020-04-06 20:35:30,0.2743055555555556,1,64,0,64
2020-04-06 20:21:26,0.37658564814814816,2,29,0,29
2020-04-06 20:12:10,0.8029166666666666,7,49,11,60
2020-04-07 16:03:23,1.6374421296296295,1,4,11,15
2020-04-05 10:33:42,0.010636574074074074,1,1,1,2
2020-04-05 10:23:09,0.008240740740740741,1,2,2,4
2020-04-07 23:08:26,3.1018287037037036,5,159,106,265
2020-04-06 20:52:23,2.1042824074074074,2,2,1,3
2020-04-04 19:18:32,0.11505787037037037,1,61,0,61
2020-04-04 19:18:55,0.13516203703703702,1,61,0,61
2020-04-04 12:20:35,0.5907986111111111,1,27,0,27
2020-04-06 18:32:40,3.012465277777778,3,5,20,25
2020-04-03 13:28:44,15.03880787037037,10,6832,1119,7951
2020-04-03 13:07:16,0.9827546296296297,3,321,7,328
2020-04-08 13:08:57,5.256990740740741,1,1,1,2
2020-04-03 13:28:25,0.3560300925925926,1,2,16,18
2020-04-03 13:27:58,0.3605324074074074,1,3,22,25
2020-04-10 15:25:39,16.007337962962964,40,13068,3242,16310
2020-04-06 08:37:05,3.557962962962963,4,146,92,238
2020-04-02 19:49:35,0.010451388888888889,1,0,2,2
2020-04-03 01:40:17,0.5056828703703704,1,190,0,190
2020-04-03 01:43:13,1.2350694444444446,1,68,0,68
2020-04-03 01:48:32,1.6833912037037038,3,66,9,75
2020-04-01 11:15:00,12.9459375,8,5926,1014,6940
2020-04-03 15:12:19,2.3483796296296298,3,27,8,35
2020-04-01 11:14:24,0.6170717592592593,1,82,0,82
2020-04-02 10:34:06,1.7226157407407408,2,13,6,19
2020-03-31 14:40:35,0.017997685185185186,1,2,1,3
2020-04-01 16:01:34,1.270300925925926,5,347,57,404
2020-04-01 20:04:20,1.4646180555555555,2,38,27,65
2020-04-01 19:59:13,1.5104050925925927,1,9,6,15
2020-04-15 22:35:01,20.380046296296296,25,13753,2784,16537
2020-05-01 13:05:48,31.371909722222224,11,18818,6470,25288
2020-03-31 13:36:04,0.7107060185185186,1,135,1,136
2020-03-31 11:54:45,0.9074189814814815,3,59,0,59
2020-04-02 13:18:34,0.009560185185185185,2,24,16,40
2020-04-02 19:00:05,3.9592824074074073,2,4,4,8
2020-03-31 13:32:26,1.0246180555555555,1,0,1,1
2020-03-30 12:26:24,0.014583333333333334,1,5,8,13
2020-03-31 11:58:48,1.3350462962962963,2,12622,2688,15310
2020-03-30 11:45:27,0.5002546296296296,10,134,73,207
2020-04-07 20:26:31,9.150972222222222,3,10,10,20
2020-03-29 17:25:42,3.1652430555555555,10,4403,903,5306
2020-03-31 15:54:13,0.20824074074074075,7,46,32,78
2020-03-30 13:50:13,1.125173611111111,2,16,18,34
2020-04-02 18:07:08,4.4679166666666665,2,3369,626,3995
2020-03-30 11:35:55,1.4112152777777778,8,73,57,130
2020-03-31 13:31:47,2.5543055555555556,1,4,8,12
2020-03-30 16:20:37,2.010289351851852,1,2,0,2
2020-03-27 22:06:26,0.046099537037037036,1,13,0,13
2020-03-30 16:28:27,2.975324074074074,11,82,40,122
2020-03-31 11:59:23,3.8100694444444443,1,83,0,83
2020-03-27 17:01:29,0.06702546296296297,9,56,31,87
2020-04-01 19:04:39,5.183888888888889,1,2,2,4
2020-03-27 14:57:00,0.021122685185185185,1,11,5,16
2020-03-27 15:05:38,0.12506944444444446,1,3013,474,3487
2020-03-31 11:59:50,4.013263888888889,1,38,0,38
2020-03-31 12:01:10,4.377222222222223,1,3,3,6
2020-03-27 01:33:34,0.08753472222222222,1,1,1,2
2020-03-31 12:00:00,4.542731481481481,1,3,1,4
2020-03-31 11:59:37,4.549143518518519,1,2,0,2
2020-03-27 14:57:16,0.8851157407407407,11,539,383,922
2020-03-31 13:30:17,4.830590277777778,1,2,0,2
2020-04-01 11:13:41,5.877835648148148,2,16,16,32
2020-03-31 12:01:04,4.92931712962963,1,62,0,62
2020-04-07 23:05:58,12.401539351851852,22,11101,2081,13182
2020-03-26 13:10:10,0.0021875,1,60,0,60
2020-03-26 17:19:19,0.22827546296296297,1,1,1,2
2020-04-17 15:17:22,22.594479166666666,4,19,12,31
2020-03-26 08:41:36,0.45744212962962966,1,4,1,5
2020-03-30 21:06:09,5.0301736111111115,3,3,3,6
2020-03-25 20:40:04,0.061307870370370374,1,127,34,161
2020-03-25 20:32:05,0.253587962962963,2,28,14,42
2020-03-26 18:08:00,0.24943287037037037,7,541,42,583
2020-03-26 11:50:28,6.97056712962963,6,479,94,573
2020-03-25 15:10:21,0.658599537037037,4,26,29,55
2020-03-29 14:51:13,11.367650462962963,10,7848,1908,9756
2020-03-25 01:15:56,0.12150462962962963,1,37,0,37
2020-03-26 12:50:58,0.10530092592592592,30,3524,3347,6871
2020-03-26 10:03:14,0.06252314814814815,11,213,135,348
2020-03-26 17:17:56,0.2127314814814815,11,220,38,258
2020-03-24 15:01:57,0.13668981481481482,1,17,13,30
2020-03-24 15:30:13,0.18534722222222222,1,3,3,6
2020-03-24 15:29:07,0.22818287037037038,3,226,0,226
2020-03-24 15:28:34,0.32591435185185186,2,460,90,550
2020-03-24 00:11:16,0.0284375,1,90,199,289
2020-03-26 23:33:55,3.1424421296296297,3,2362,399,2761
2020-03-26 22:42:10,3.3385185185185184,3,2446,370,2816
2020-03-23 16:10:24,0.19304398148148147,1,3,1,4
2020-03-31 12:00:35,8.02111111111111,2,60,1,61
2020-03-23 16:11:21,0.1971064814814815,1,6,0,6
2020-03-23 16:10:42,0.20320601851851852,1,122,0,122
2020-04-28 13:11:10,36.5631712962963,22,930,449,1379
2020-03-23 15:55:42,1.1043865740740741,1,32,0,32
2020-03-24 09:18:37,1.8646527777777777,3,103,3,106
2020-03-27 01:34:15,8.881481481481481,23,4446,1299,5745
2020-03-26 22:41:20,5.094432870370371,5,2121,387,2508
2020-03-26 22:42:39,5.119976851851852,1,13,4,17
2020-03-31 16:42:31,10.101643518518518,7,317,109,426
2020-03-20 22:03:51,0.015497685185185186,1,1,1,2
2020-03-20 22:01:02,0.2113773148148148,1,46,1,47
2020-03-19 17:53:06,0.02912037037037037,1,1,0,1
2020-03-20 22:00:05,1.3543518518518518,1,3,1,4
2020-03-19 19:08:20,0.2746412037037037,1,51,0,51
2020-05-07 08:17:02,48.88291666666667,162,13387,9802,23189
2020-03-19 19:07:57,0.3450810185185185,1,104,0,104
2020-03-19 19:07:40,0.3526273148148148,1,103,0,103
2020-03-19 19:07:23,0.36666666666666664,1,96,0,96
2020-03-19 19:06:37,0.3891435185185185,1,84,0,84
2020-03-19 08:55:17,0.021238425925925924,2,8,3,11
2020-03-19 16:22:48,0.34199074074074076,1,1,1,2
2020-03-19 22:21:50,0.6168634259259259,1,2,2,4
2020-03-19 22:23:03,0.7570370370370371,1,2,6,8
2020-03-19 03:44:13,0.025578703703703704,1,31,0,31
2020-03-19 03:43:50,0.025868055555555554,1,31,0,31
2020-03-19 03:45:03,0.027476851851851853,1,31,0,31
2020-03-19 20:41:30,0.7727083333333333,1,5,5,10
2020-03-19 19:06:01,0.9655787037037037,4,168,0,168
2020-03-18 19:45:11,0.0403125,3,53,1,54
2020-03-18 15:37:18,0.04412037037037037,1,1,0,1
2020-03-18 12:24:10,0.0077083333333333335,1,71,24,95
2020-03-18 12:24:28,0.03121527777777778,1,1,0,1
2020-03-26 22:40:40,8.659305555555555,11,4229,1098,5327
2020-03-19 15:56:54,1.4570254629629629,6,531,313,844
2020-03-18 11:55:28,0.35225694444444444,1,39,0,39
2020-03-19 15:16:52,1.5354282407407407,3,43,84,127
2020-03-17 16:29:11,0.08950231481481481,1,123,0,123
2020-03-17 13:05:12,0.20221064814814815,2,22,0,22
2020-03-17 16:30:10,0.5721412037037037,2,17,45,62
2020-03-17 03:09:11,0.0627199074074074,1,2,20,22
2020-03-17 01:51:46,0.10497685185185185,1,70,0,70
2020-03-16 18:42:13,0.0027083333333333334,1,1,0,1
2020-03-17 14:52:37,1.118136574074074,4,33,25,58
2020-03-16 16:23:02,0.2967592592592593,1,100,0,100
2020-03-16 16:32:47,0.35685185185185186,1,86,0,86
2020-03-17 15:46:43,1.6666898148148148,11,353,120,473
2020-03-18 13:24:28,5.776909722222222,7,204,272,476
2020-03-16 03:00:44,1.1612847222222222,3,14,29,43
2020-03-16 16:47:54,1.7672337962962963,5,23,22,45
2020-03-26 14:22:13,11.89179398148148,13,199,52,251
2020-03-13 20:40:36,0.027569444444444445,1,1,0,1
2020-03-19 22:25:31,6.1714467592592595,1,0,1,1
2020-03-13 23:48:27,0.3404976851851852,6,22,10,32
2020-03-20 20:41:05,0.48789351851851853,4,165,163,328
2020-03-13 13:35:55,0.060439814814814814,1,9,0,9
2020-04-03 18:10:55,23.497592592592593,53,4126,1852,5978
2020-03-12 23:38:05,0.214375,1,3,2,5
2020-03-13 01:14:57,0.29087962962962965,1,1,1,2
2020-03-12 14:05:41,0.0011805555555555556,1,13,20,33
2020-03-16 08:48:31,3.824710648148148,4,19,12,31
2020-03-19 16:08:31,7.492916666666667,3,7,5,12
2020-03-25 01:00:24,13.017291666666667,37,924,674,1598
2020-03-11 22:40:39,0.03518518518518519,1,76,0,76
2020-03-12 14:36:37,1.6865162037037038,6,921,471,1392
2020-03-11 16:37:00,0.02435185185185185,1,39,0,39
2020-03-11 16:36:34,0.07597222222222222,2,40,1,41
2020-03-19 22:18:24,3.159872685185185,26,1700,1531,3231
2020-03-14 14:08:59,3.026990740740741,6,29,12,41
2020-03-11 13:12:48,0.24291666666666667,2,172,0,172
2020-03-19 13:49:26,8.552268518518519,1,1,1,2
2020-03-11 13:10:25,0.5467476851851852,1,20,0,20
2020-03-11 13:10:58,0.564375,1,20,0,20
2020-03-11 13:10:14,0.5648032407407407,1,20,0,20
2020-03-11 13:03:32,0.5628125,1,78,0,78
2020-03-19 13:47:55,8.630208333333334,1,1,1,2
2020-03-11 13:03:21,0.6277662037037037,1,2,16,18
2020-03-11 13:03:08,0.6297800925925926,1,1,1,2
2020-03-11 13:02:57,0.6315393518518518,1,2,15,17
2020-03-11 13:02:20,0.6323032407407407,1,1,9,10
2020-03-10 14:59:35,0.450625,1,1,1,2
2020-03-10 14:59:18,0.45358796296296294,1,2,2,4
2020-03-09 23:37:16,0.0070023148148148145,1,41,0,41
2020-03-18 13:52:50,8.6346875,6,206,101,307
2020-03-09 21:33:58,0.0028819444444444444,1,50,18,68
2020-03-10 14:58:14,0.7752199074074074,1,137,0,137
2020-03-09 19:09:36,0.03553240740740741,1,1,1,2
2020-03-10 10:29:18,1.833425925925926,10,1587,701,2288
2020-03-09 15:29:57,0.06581018518518518,2,14,6,20
2020-03-17 14:17:11,9.577037037037037,12,1182,649,1831
2020-04-06 22:29:16,28.501469907407408,67,1386,1113,2499
2020-03-10 00:43:39,1.1345833333333333,9,90,65,155
2020-03-08 14:55:31,0.21885416666666666,1,2,2,4
2020-03-06 16:15:34,0.0022916666666666667,1,2,3,5
2020-03-06 21:06:37,0.23219907407407409,4,263,31,294
2020-03-06 22:23:32,0.334375,1,264,0,264
2020-03-05 23:45:08,0.006493055555555556,1,1,1,2
2020-03-06 21:01:47,0.9187962962962963,1,47,26,73
2020-03-05 22:16:57,0.05153935185185185,3,24,2,26
2020-03-06 22:20:21,1.1560648148148147,1,138,0,138
2020-03-05 21:14:36,0.1537962962962963,5,35,28,63
2020-03-05 22:01:55,0.21459490740740741,1,24,0,24
2020-03-11 12:21:54,5.078981481481481,29,1011,945,1956
2020-03-06 22:19:37,1.3067592592592592,1,19,50,69
2020-03-05 14:34:44,0.9976273148148148,4,123,7,130
2020-03-06 12:06:35,0.9311805555555556,2,13,5,18
2020-03-05 21:12:57,0.3750810185185185,3,50,34,84
2020-03-06 12:05:53,1.3143981481481481,2,75,4,79
2020-03-17 22:04:22,12.961805555555555,15,4973,1532,6505
2020-03-04 18:57:24,0.07261574074074074,1,137,0,137
2020-03-04 16:25:24,0.011851851851851851,1,1,1,2
2020-03-04 17:03:47,0.14561342592592594,1,76,0,76
2020-03-04 17:01:17,0.0817824074074074,3,31,29,60
2020-03-04 22:28:01,0.9554861111111111,4,360,50,410
2020-03-09 17:48:59,5.7721990740740745,13,498,410,908
2020-03-04 20:59:10,0.9121527777777778,1,2,2,4
2020-03-05 22:41:19,2.0153703703703703,13,2330,9617,11947
2020-03-04 17:04:40,0.772349537037037,2,178,0,178
2020-03-04 17:06:06,0.8111689814814815,1,62,0,62
2020-03-03 20:54:30,0.021076388888888888,1,16,6,22
2020-03-04 14:30:52,0.9518287037037036,3,48,32,80
2020-03-06 22:26:19,3.0604050925925925,2,39,110,149
2020-03-06 11:59:13,2.915775462962963,12,256,136,392
2020-03-03 14:29:29,0.04119212962962963,1,44,0,44
2020-03-06 18:04:30,3.2083101851851854,1,6,6,12
2020-03-03 13:59:48,0.0745138888888889,1,5,2,7
2020-03-03 20:14:13,0.6893634259259259,1,11,11,22
2020-03-02 22:07:14,0.01670138888888889,2,100,2,102
2020-03-02 20:45:26,0.0930787037037037,6,41,11,52
2020-03-02 18:35:36,0.002523148148148148,1,38,20,58
2020-03-03 20:30:00,1.1948148148148148,17,2456,437,2893
2020-03-02 17:00:10,0.12943287037037038,2,43,9,52
2020-03-02 15:20:22,0.7893634259259259,2,13,13,26
2020-03-03 14:42:15,5.057025462962963,53,2783,1953,4736
2020-03-02 15:35:54,9.958784722222223,65,5740,2185,7925
2020-03-02 19:07:11,4.131539351851852,5,442,54,496
2020-02-27 21:45:33,0.19175925925925927,4,120,111,231
2020-03-04 16:45:57,11.850694444444445,41,2224,10007,12231
2020-02-27 15:22:36,0.3955092592592593,1,6,6,12
2020-02-27 14:56:47,0.43052083333333335,1,1,2,3
2020-03-02 15:53:56,4.923171296296296,2,48,2,50
2020-02-26 17:39:55,0.029814814814814815,1,5,5,10
2020-02-26 17:04:38,0.03293981481481482,3,84,4,88
2020-02-26 16:59:25,0.6502893518518519,2,26,13,39
2020-02-29 02:11:09,3.2083796296296296,14,170,70,240
2020-02-26 16:36:28,0.8253587962962963,1,1,203,204
2020-02-25 21:51:26,0.41054398148148147,4,679,500,1179
2020-03-05 22:26:49,9.283946759259258,4,7405,10568,17973
2020-03-19 15:21:21,23.30201388888889,3,16,12,28
2020-02-24 23:45:53,0.0052893518518518515,1,2,2,4
2020-02-24 23:30:58,0.0012268518518518518,1,2,2,4
2020-02-24 19:33:50,0.11413194444444444,1,80,0,80
2020-02-24 19:19:39,0.009027777777777777,1,6,46,52
2020-02-24 20:42:38,0.06940972222222222,2,23,8,31
2020-03-27 14:59:55,32.11290509259259,2,7,4,11
2020-02-25 23:43:36,0.04162037037037037,2,879,255,1134
2020-04-03 19:20:22,39.848333333333336,3,8,8,16
2020-02-24 20:11:11,0.8975462962962963,4,43,19,62
2020-02-23 21:55:32,0.016226851851851853,1,3,0,3
2020-02-27 15:22:56,3.803865740740741,7,154,20,174
2020-02-25 19:47:44,2.0126851851851852,5,46,37,83
2020-02-24 17:09:47,1.8381712962962964,6,273,90,363
2020-02-24 22:50:24,2.0469675925925928,1,1,1,2
2020-02-22 21:25:04,0.015532407407407408,2,3,6,9
2020-02-23 16:28:49,0.8355439814814815,1,0,19,19
2020-02-25 19:06:58,2.962523148148148,1,1,1,2
2020-02-24 13:42:55,1.925625,1,7,0,7
2020-02-23 14:50:39,1.0000694444444445,1,4,1,5
2020-02-22 16:12:39,0.14916666666666667,1,3,3,6
2020-02-22 14:27:48,0.625011574074074,2,77,1,78
2020-02-21 22:10:19,0.0006828703703703704,1,3,3,6
2020-02-21 21:10:21,0.007418981481481481,2,5,2,7
2020-02-22 16:08:44,1.0161689814814814,1,3,3,6
2020-02-21 13:53:06,0.10356481481481482,2,4,2,6
2020-02-21 13:54:42,0.46142361111111113,1,77,0,77
2020-02-22 17:09:02,1.8633796296296297,1,62,0,62
2020-02-20 20:31:18,0.05380787037037037,1,10,4,14
2020-02-22 16:06:42,1.9415277777777777,1,34,5,39
2020-02-24 23:20:43,4.24994212962963,11,102,43,145
2020-02-20 15:02:08,0.04869212962962963,1,3,3,6
2020-02-24 19:58:16,4.290104166666667,3,55,29,84
2020-02-21 16:28:33,1.3070949074074074,1,0,3,3
2020-02-20 16:55:04,0.36574074074074076,2,7,7,14
2020-02-20 16:53:32,0.36628472222222225,1,6,0,6
2020-02-19 23:58:05,0.010717592592592593,2,27,8,35
2020-02-20 15:06:16,0.7199652777777777,1,1,1,2
2020-02-19 21:09:52,0.03167824074074074,2,69,1,70
2020-02-24 16:51:58,4.980266203703704,13,975934,974949,1950883
2020-02-20 15:58:00,1.1887037037037036,1,41,0,41
2020-02-19 15:51:17,0.889537037037037,1,5,0,5
2020-02-20 20:25:16,2.1257175925925926,1,3,3,6
2020-02-20 16:50:05,2.067511574074074,8,934,377,1311
2020-02-21 17:10:00,28.886631944444446,59,4267,1418,5685
2020-02-17 15:58:44,0.06635416666666667,1,58,0,58
2020-02-17 13:36:49,0.0071875,1,3,0,3
2020-02-17 14:54:47,0.6116898148148148,1,74,0,74
2020-02-16 15:09:35,0.12409722222222222,1,16,12,28
2020-02-14 18:39:24,0.01068287037037037,4,1227,143,1370
2020-02-14 14:31:16,0.15034722222222222,3,86,43,129
2020-02-14 14:11:08,0.1880902777777778,1,3,3,6
2020-02-14 14:07:43,0.22354166666666667,1,1,1,2
2020-02-14 14:13:08,0.3884837962962963,1,1,1,2
2020-02-14 04:04:53,0.0044907407407407405,1,108,0,108
2020-02-14 14:18:11,0.544074074074074,1,4,0,4
2020-02-14 02:54:43,0.08631944444444445,1,16,0,16
2020-02-14 00:27:23,0.007372685185185185,1,76,0,76
2020-02-25 18:48:25,11.948773148148149,11,747,98,845
2020-02-18 21:14:51,5.307604166666667,2,2,1,3
2020-02-13 14:11:04,0.03127314814814815,1,2,0,2
2020-02-13 20:43:45,1.2865277777777777,11,554,503,1057
2020-02-13 22:19:14,0.9993171296296296,2,48,0,48
2020-02-12 01:07:16,0.01494212962962963,1,89,0,89
2020-02-11 22:20:10,0.11019675925925926,3,8,6,14
2020-02-11 16:22:26,0.3936689814814815,1,1,1,2
2020-02-13 13:28:33,2.366435185185185,6,401,122,523
2020-02-11 15:49:39,0.7308101851851851,2,130,8,138
2020-02-12 18:23:15,1.861412037037037,2,13,4,17
2020-02-10 18:24:05,0.04483796296296296,1,1,1,2
2020-02-10 15:27:30,0.036631944444444446,2,68,2,70
2020-02-10 20:21:49,0.27174768518518516,2,108,4,112
2020-02-11 10:48:43,0.9334027777777778,1,4,3,7
2020-02-10 14:58:41,0.5561111111111111,1,16,0,16
2020-02-10 22:28:00,2.043645833333333,5,224,134,358
2020-02-13 18:29:44,5.9719444444444445,3,167,67,234
2020-02-07 20:28:14,0.04767361111111111,4,81,46,127
2020-02-07 15:14:59,0.5933449074074074,1,2,2,4
2020-02-10 13:05:16,3.5847685185185183,4,58,15,73
2020-02-07 14:15:29,0.7608333333333334,2,18,19,37
2020-02-06 20:25:48,0.04736111111111111,1,2,0,2
2020-02-06 20:30:03,0.06976851851851852,2,50,1,51
2020-02-11 20:19:23,5.358240740740741,1,30,2,32
2020-02-06 21:40:08,0.5259259259259259,1,2,0,2
2020-02-06 21:38:56,0.601412037037037,1,1,1,2
2020-02-05 20:26:28,0.07106481481481482,2,14,0,14
2020-02-21 17:01:03,15.976354166666667,2,30,7,37
2020-02-20 23:11:14,28.276782407407406,168,23905,14907,38812
2020-02-05 18:55:42,0.8649421296296296,1,1,1,2
2020-02-04 21:38:53,0.9830671296296296,4,1376,96,1472
2020-02-04 22:12:43,0.1652199074074074,3,24,8,32
2020-02-04 23:05:36,0.9880555555555556,5,532,79,611
2020-02-03 14:04:36,0.06954861111111112,1,103,0,103
2020-02-03 14:09:35,0.6671527777777778,1,351,0,351
2020-04-07 20:19:19,64.96513888888889,4,12,9,21
2020-02-20 21:08:22,18.500300925925927,3,17,22,39
2020-02-01 16:10:58,0.06616898148148148,1,1,1,2
2020-01-31 23:39:10,0.061875,4,774,0,774
2020-03-16 13:29:22,44.900787037037034,7,20126,11585,31711
2020-02-01 15:38:15,0.9631018518518518,12,1657,187,1844
2020-01-31 15:58:50,0.01380787037037037,1,1,1,2
2020-01-30 23:41:25,0.07605324074074074,1,6,6,12
2020-01-31 00:27:00,0.14280092592592591,3,6,3,9
2020-01-30 17:05:02,0.26717592592592593,1,13,3,16
2020-01-30 14:52:36,1.0607175925925927,1,5,1,6
2020-01-30 15:04:19,14.945763888888889,5,1029,245,1274
2020-02-19 16:35:41,23.183819444444445,76,1518,690,2208
2020-01-29 19:01:17,0.733738425925926,1,0,3,3
2020-01-28 15:41:11,0.19283564814814816,8,87,66,153
2020-01-29 22:44:59,1.513449074074074,2,3,2,5
2020-01-31 02:05:54,3.1262962962962964,2,15,4,19
2020-01-27 17:12:47,0.04447916666666667,1,2,0,2
2020-01-27 16:08:32,0.04462962962962963,1,2,5,7
2020-02-07 15:25:32,11.031805555555556,1,19,4,23
2020-01-27 19:27:08,2.8597916666666667,3,382,3,385
2020-01-24 21:37:31,0.04945601851851852,2,273,219,492
2020-01-24 15:28:21,2.3939930555555557,1,3,3,6
2020-01-30 23:15:42,12.740231481481482,13,255,72,327
2020-01-21 21:57:39,3.9525810185185186,5,153,85,238
2020-01-17 23:29:12,0.06925925925925926,1,1,1,2
2020-01-20 16:46:44,2.9503935185185184,1,6,2,8
2020-01-17 16:22:52,0.19398148148148148,1,1,1,2
2020-01-17 19:57:57,0.8628472222222222,3,9,2,11
2020-01-16 12:17:00,0.45461805555555557,1,6,3,9
2020-01-16 12:17:16,0.530162037037037,2,332,335,667
2020-01-16 21:47:20,1.1739351851851851,3,121,94,215
2020-01-23 14:38:46,8.882199074074075,31,5095,4544,9639
2020-01-20 15:56:24,10.10849537037037,3,59,29,88
2020-01-14 18:43:46,0.14600694444444445,1,16,0,16
2020-01-10 21:18:55,0.0484375,1,1,0,1
2020-01-14 18:59:15,4.055011574074074,20,997,868,1865
2020-01-14 13:09:10,1.677673611111111,7,866,358,1224
2020-01-10 10:42:22,0.9776851851851852,1,9,0,9
2020-01-09 11:54:30,0.28747685185185184,1,1,1,2
2020-01-13 15:02:54,4.972453703703704,2,78,62,140
2020-01-10 10:42:54,1.798275462962963,7,210,125,335
2020-01-29 16:47:50,21.142291666666665,4,379,211,590
2020-02-04 15:59:33,27.129710648148148,1,1,1,2
2020-01-15 17:31:44,7.212557870370371,1,6,2,8
2020-01-07 16:21:23,0.06773148148148148,2,25,25,50
2020-01-29 17:06:14,22.130752314814814,5,446,262,708
2020-01-11 04:00:08,3.5766898148148147,4,36,14,50
2020-01-07 16:25:26,0.1017824074074074,1,1,1,2
2020-01-14 22:47:29,7.4184375,1,2,4,6
2020-01-07 16:37:28,0.31078703703703703,1,11,11,22
2020-01-21 15:18:25,15.14150462962963,1,28,2,30
2020-01-07 13:55:55,2.154212962962963,4,34,24,58
2020-01-05 17:50:21,1.1887847222222223,2,10,5,15
2020-01-14 12:19:02,12.564745370370371,3,8,11,19
2020-01-05 17:37:12,3.911909722222222,1,2,1,3
2020-01-06 14:11:13,6.083009259259259,2,1,0,1
2020-01-06 13:54:37,8.056828703703705,3,3,3,6
2019-12-29 15:07:22,1.4212615740740742,1,7,0,7
2019-12-29 15:06:51,1.4363425925925926,1,4,1,5
2019-12-28 14:40:01,0.44875,5,58,56,114
2020-01-05 17:52:15,8.836296296296297,1,21,21,42
2019-12-26 11:38:07,0.011423611111111112,1,1,1,2
2019-12-25 19:52:31,0.21533564814814815,2,5,1,6
2019-12-25 11:43:23,0.22030092592592593,2,2,4,6
2019-12-25 21:39:20,1.2230902777777777,1,10,2,12
2019-12-27 09:33:27,3.551388888888889,12,108,48,156
2019-12-25 21:37:43,2.009710648148148,7,14,41,55
2019-12-27 09:29:07,3.527488425925926,4,80,39,119
2019-12-25 21:30:47,2.0314930555555555,3,9,5,14
2019-12-23 21:28:47,0.050243055555555555,5,31,33,64
2019-12-27 09:50:47,3.6916319444444445,1,1,1,2
2020-01-28 02:00:35,39.56368055555556,2,12,2,14
2019-12-23 11:19:48,0.16744212962962962,1,3,1,4
2019-12-24 10:21:20,1.6716782407407407,12,267,204,471
2019-12-22 22:04:38,0.280625,10,217,603,820
2019-12-22 15:41:54,1.0442824074074073,41,20967,16559,37526
2019-12-23 11:31:01,1.183287037037037,1,3,1,4
2020-01-15 23:25:39,25.100289351851853,1,2,2,4
2019-12-22 15:31:12,1.036851851851852,32,19427,14606,34033
2019-12-21 14:33:23,0.005960648148148148,1,29,7,36
2019-12-20 21:10:40,0.06039351851851852,6,48,38,86
2019-12-20 18:34:09,0.045625,3,98,57,155
2020-01-16 12:28:26,26.95577546296296,6,1296,269,1565
2019-12-20 14:12:33,0.16582175925925927,1,94,1,95
2019-12-20 16:29:44,0.6435532407407407,1,1,1,2
2019-12-20 09:28:10,0.41658564814814814,2,25,10,35
2019-12-19 21:23:19,0.16789351851851853,4,6,6,12
2019-12-19 14:50:57,0.04707175925925926,1,0,1,1
2019-12-19 14:36:45,0.9090046296296296,1,1,1,2
2019-12-19 14:34:56,0.5895254629629629,1,4,4,8
2019-12-21 10:54:24,0.6232175925925926,12,187,239,426
2019-12-27 09:24:30,2.667361111111111,11,547,177,724
2019-12-17 20:54:06,0.07849537037037037,2,9,10,19
2019-12-21 13:31:45,3.884548611111111,2,59,29,88
2019-12-20 22:21:25,3.5427199074074074,2,34,2,36
2019-12-16 21:58:45,0.018518518518518517,1,12,3,15
2019-12-20 21:08:09,0.04283564814814815,1,1,0,1
2019-12-18 01:35:26,1.4354282407407408,5,40,20,60
2019-12-20 12:26:39,3.8675,28,1610,684,2294
2019-12-21 13:31:21,6.964872685185185,1,7,5,12
2019-12-21 13:33:17,79.12458333333333,12,25525,3510,29035
2019-12-13 21:39:09,0.020671296296296295,1,43,14,57
2019-12-17 08:10:17,3.775613425925926,12,3795,776,4571
2019-12-12 06:24:48,0.4267476851851852,1,23,16,39
2019-12-11 17:19:22,0.02431712962962963,1,8,8,16
2019-12-12 06:43:41,0.6002662037037036,7,647,70,717
2019-12-12 16:16:20,1.0427314814814814,1,1,1,2
2019-12-21 14:03:53,11.91894675925926,7,9677,1852,11529
2019-12-21 13:55:41,10.728726851851851,5,43,49,92
2019-12-10 21:18:56,0.07083333333333333,1,2,2,4
2019-12-10 14:13:34,0.016446759259259258,1,0,30,30
2019-12-21 14:26:09,11.500474537037038,3,12001,2911,14912
2019-12-10 09:07:57,0.9547222222222222,1,6,4,10
2019-12-13 21:41:46,4.972037037037037,6,45,36,81
2019-12-07 12:46:15,0.1602199074074074,1,4,3,7
2019-12-12 07:20:44,5.9083449074074075,1,1,1,2
2019-12-06 16:56:24,0.6854745370370371,3,35,3,38
2019-12-06 11:14:49,0.4517013888888889,1,10,10,20
2019-12-12 07:09:12,6.447395833333333,2,6039,2611,8650
2019-12-10 14:34:09,5.010150462962963,2,20,12,32
2019-12-06 11:06:42,0.8959259259259259,1,10,6,16
2019-12-05 12:45:45,0.012349537037037037,2,6,3,9
2019-12-12 07:21:46,6.974965277777778,1,1,1,2
2019-12-05 14:20:08,1.629236111111111,5,236,241,477
2019-12-06 18:57:38,1.0554861111111111,8,390,277,667
2019-12-06 21:15:54,2.223946759259259,1,20,7,27
2019-12-06 11:12:23,2.1035648148148147,4,1109,8,1117
2019-12-05 13:41:57,1.264525462962963,1,0,169,169
2019-12-05 08:44:08,1.1192708333333334,3,538,30,568
2019-12-03 15:03:49,1.9017824074074074,1,4,0,4
2019-12-05 11:39:05,4.1255902777777775,1,1,1,2
2019-12-05 11:32:40,4.857511574074074,2,42,14,56
2019-12-03 15:15:40,3.6202083333333333,1,1,1,2
2019-11-29 19:17:03,0.32252314814814814,1,5,3,8
2019-11-29 16:25:38,0.23399305555555555,1,46,17,63
2019-12-09 21:24:36,12.281666666666666,6,38,5,43
2019-12-10 10:07:27,21.600324074074074,27,10840,3083,13923
2019-11-29 14:40:51,0.9924537037037037,2,49,55,104
2019-11-27 17:05:24,0.013912037037037037,1,7,7,14
2019-11-27 15:38:11,0.2357986111111111,1,1,1,2
2019-12-17 23:12:23,20.964768518518518,2,21,10,31
2019-11-27 16:02:29,1.0222453703703704,1,1,1,2
2019-11-26 14:01:33,0.4146064814814815,1,1,1,2
2019-11-23 15:55:17,0.8323379629629629,1,1,1,2
2019-11-25 21:48:04,3.136226851851852,1,2,2,4
2019-11-25 16:32:01,3.5693865740740742,1,3,3,6
2019-12-03 15:13:02,12.192789351851852,6,259,14,273
2019-11-25 15:21:04,4.240243055555555,3,21,8,29
2019-11-20 22:54:35,0.0146875,1,2,33,35
2019-11-21 19:41:20,1.1113078703703703,2,26,0,26
2019-11-29 08:26:33,9.38355324074074,1,1,1,2
2019-11-29 08:25:47,9.566145833333334,8,3788,126,3914
2019-12-05 08:54:09,15.973622685185186,1,232,11,243
2019-11-21 09:56:08,2.862372685185185,4,61,2,63
2019-11-18 14:23:15,0.2195601851851852,1,2,1,3
2019-11-18 16:50:07,1.320324074074074,1,1,1,2
2019-11-25 20:06:33,9.272013888888889,2,810,148,958
2019-12-04 12:28:39,18.111828703703704,1,1,1,2
2019-11-16 05:11:08,7.18318287037037,11,525,31,556
2019-12-21 13:27:36,36.149976851851854,12,10019,2565,12584
2019-12-11 23:32:28,26.63023148148148,12,584,64,648
2019-11-14 21:04:50,0.2322685185185185,1,5,4,9
2019-11-14 21:10:31,2.459537037037037,2,103,126,229
2019-11-14 21:11:55,0.29560185185185184,1,3,2,5
2019-11-14 21:17:25,2.0343518518518517,1,21,1,22
2019-11-14 21:24:05,2.436736111111111,1,24,0,24
2019-12-21 12:38:48,39.185694444444444,4,20406,3918,24324
2019-11-12 16:29:22,0.8411226851851852,7,357,119,476
2019-11-14 21:47:54,3.2705787037037037,5,114,6,120
2019-11-28 15:08:38,18.941643518518518,2,5,0,5
2019-12-10 01:37:56,39.701030092592596,19,3212,2142,5354
2019-11-28 15:06:56,20.19765046296296,2,13,9,22
2019-11-08 21:28:41,0.9722453703703704,1,5,2,7
2019-12-21 11:13:28,43.63554398148148,2,96,24,120
2019-11-28 14:24:08,21.672511574074075,1,5,1,6
2019-11-06 19:03:48,0.18041666666666667,4,37,14,51
2019-11-05 18:31:59,0.029837962962962962,1,8,0,8
2019-11-27 22:28:31,22.25115740740741,3,5428,572,6000
2019-12-14 08:40:44,38.90232638888889,33,17990,4535,22525
2019-11-05 22:31:30,0.4767476851851852,1,13,9,22
2019-12-21 11:42:05,46.05337962962963,1,1,1,2
2019-12-05 10:56:48,30.03300925925926,2,14,6,20
2019-11-05 10:34:21,0.08326388888888889,1,2,1,3
2019-11-27 16:14:49,23.004837962962963,1,77,18,95
2019-11-05 07:36:31,0.6773032407407408,1,87,32,119
2019-11-04 15:21:53,0.16177083333333334,4,268,233,501
2019-11-05 09:55:34,1.9658333333333333,1,1,1,2
2019-12-03 15:14:03,27.985717592592593,30,2955,1414,4369
2019-11-05 14:55:29,3.9353819444444444,3,387,158,545
2019-11-26 18:08:13,27.924016203703705,36,3112,556,3668
2019-11-27 16:07:23,29.01158564814815,16,765,87,852
2019-11-01 21:02:25,1.4984375,1,1,0,1
2019-10-30 16:05:59,0.23197916666666665,4,3747,2,3749
2019-10-30 16:08:00,0.6081597222222223,1,8,4,12
2019-10-31 21:24:38,1.8612847222222222,1,14,4,18
2019-10-28 14:18:59,3.163900462962963,2,7,5,12
2019-10-30 16:04:04,5.765497685185185,2,46,11,57
2019-10-24 18:32:49,0.6025,4,168,5,173
2019-11-27 16:11:07,34.038333333333334,2,11586,931,12517
2019-10-30 16:14:08,7.157581018518519,1,3,0,3
2019-10-30 16:03:15,7.7581597222222225,5,28,7,35
2019-10-22 19:13:48,0.0019212962962962964,1,2,2,4
2019-10-30 16:00:40,7.926296296296297,3,312,87,399
2019-11-27 16:05:19,21.19934027777778,2,4090,341,4431
2019-12-21 11:36:11,61.27800925925926,4,67,67,134
2019-10-22 11:59:20,1.6031828703703703,3,552,6,558
2019-10-21 12:31:57,1.6754282407407408,1,3,3,6
2019-11-05 10:13:13,18.52232638888889,1,5,0,5
2019-10-17 18:47:15,0.029641203703703704,1,1,1,2
2019-11-04 14:37:16,20.715335648148148,3,7450,247,7697
2019-12-20 14:28:30,65.09064814814815,72,9169,2992,12161
2019-10-15 08:25:01,31.543993055555557,1,12,2,14
2019-10-14 15:40:33,0.2927777777777778,1,9,9,18
2019-10-15 08:24:14,1.3849652777777777,2,23,2,25
2019-10-15 07:57:19,1.8998148148148148,3,61,15,76
2019-10-15 07:50:37,2.8564814814814814,1,3,2,5
2019-10-14 14:14:52,2.5908564814814814,1,10,6,16
2019-10-11 11:01:52,0.11202546296296297,1,20,0,20
2019-10-11 14:33:00,0.8124305555555555,2,33,2,35
2019-10-10 23:20:40,0.11998842592592593,1,1,1,2
2019-10-11 14:25:43,1.137025462962963,9,289,229,518
2019-10-10 09:56:20,0.07296296296296297,3,79,90,169
2019-10-30 15:54:18,23.243206018518517,80,8947,2975,11922
2019-10-10 09:56:56,1.8630555555555555,1,41,10,51
2019-10-08 14:55:34,0.777337962962963,3,202,27,229
2019-10-07 16:49:26,0.03556712962962963,1,48,0,48
2019-10-07 09:02:24,0.001736111111111111,1,1,1,2
2019-10-15 07:44:19,8.589791666666667,1,2,5,7
2019-10-07 03:40:53,0.43494212962962964,2,6,6,12
2019-10-09 12:48:41,3.3014467592592593,6,107,71,178
2019-10-03 19:51:34,0.16594907407407408,1,3,5,8
2019-10-03 15:31:12,0.29269675925925925,1,2,1,3
2019-10-09 01:14:34,5.850949074074074,1,14,6,20
2019-10-03 14:27:12,0.9766898148148148,15,569,285,854
2019-10-11 10:10:59,22.721145833333335,3,31,16,47
2019-10-02 15:04:19,0.0015162037037037036,1,4,4,8
2019-10-09 01:52:42,7.063043981481481,1,1,1,2
2019-10-01 18:59:32,0.0015509259259259259,1,6,6,12
2019-10-09 15:18:25,8.801041666666666,12,737,597,1334
2019-10-09 15:31:06,8.946122685185186,14,4183,1007,5190
2019-10-03 23:04:03,4.467384259259259,1,8,11,19
2019-09-30 18:48:02,1.8006481481481482,1,18,18,36
2019-09-28 08:26:43,0.0044675925925925924,1,1,1,2
2019-10-04 21:23:16,6.985231481481481,4,650,60,710
2019-09-27 20:58:20,0.11085648148148149,1,1,1,2
2019-09-27 20:59:54,0.2559837962962963,2,73,4,77
2019-09-27 21:00:35,0.2533796296296296,1,3,3,6
2019-09-27 11:08:01,0.041261574074074076,1,4,4,8
2019-09-27 08:30:08,0.019814814814814816,1,4,0,4
2019-09-27 08:35:13,0.7791666666666667,1,2,3,5
2019-09-26 11:45:41,1.0518055555555557,6,357,45,402
2019-10-31 18:29:59,36.23368055555556,2,24434,2440,26874
2019-09-26 06:50:03,3.2628125,1,1,5,6
2019-10-03 22:43:57,11.378692129629629,2,13382,1774,15156
2019-09-20 14:59:36,0.5353819444444444,1,4,4,8
2019-10-03 21:06:17,14.267766203703705,3,12928,1559,14487
2019-09-23 13:54:56,4.597164351851852,2,1948,1987,3935
2019-10-01 22:46:07,13.086064814814815,2,2,2,4
2019-10-01 22:40:22,13.381527777777778,3,26,20,46
2019-10-15 07:35:25,27.761435185185185,12,967,143,1110
2019-09-11 13:53:29,0.4521527777777778,2,4502,3905,8407
2019-09-10 20:14:19,0.16826388888888888,1,1,1,2
2019-09-10 20:15:48,0.8456018518518519,1,2,1,3
2019-09-10 20:16:45,1.243611111111111,2,2,4,6
2019-09-10 09:55:27,9.693275462962964,1,5,3,8
2019-09-09 07:26:37,2.6433449074074074,5,396,716,1112
2019-09-05 19:44:17,0.38842592592592595,2,31,25,56
2019-09-26 10:11:03,21.40513888888889,154,27146,11343,38489
2019-09-05 19:16:59,0.9447800925925925,6,1612,1255,2867
2019-09-05 19:17:02,0.9448148148148148,2,10,7,17
2019-09-09 12:42:51,5.083020833333333,3,2368,2222,4590
2019-09-04 10:50:50,0.39121527777777776,1,4,0,4
2019-09-05 16:33:47,2.0861805555555555,1,9,0,9
2019-09-26 10:11:06,23.56150462962963,37,1487,1226,2713
2019-09-02 07:01:16,0.2733449074074074,2,26,5,31
2019-09-02 00:00:08,1.5684027777777778,1,1,1,2
2019-09-02 21:14:04,2.6826967592592594,2,9,1,10
2019-08-30 14:30:33,0.03894675925925926,3,6948,1672,8620
2019-08-30 21:29:12,0.6911111111111111,2,77,62,139
2019-08-30 21:23:09,0.714837962962963,1,4,1,5
2019-08-30 21:21:59,1.025798611111111,1,1,1,2
2019-08-30 11:28:17,0.80125,1,23,5,28
2019-08-29 12:43:31,0.2005324074074074,1,1,1,2
2019-08-28 20:00:53,0.11280092592592593,1,1,1,2
2019-08-28 20:00:13,0.1610763888888889,1,1,1,2
2019-08-28 14:43:09,1.0106712962962963,32,3020,559,3579
2019-08-27 13:01:01,0.07081018518518518,1,2,2,4
2019-08-27 12:58:51,0.15010416666666668,1,1,4,5
2019-08-27 12:56:44,0.15703703703703703,1,0,8,8
2019-08-30 21:08:58,4.0586574074074075,17,5333,2179,7512
2019-08-30 21:15:40,7.107905092592593,12,3861,231,4092
2019-08-30 12:49:09,7.108993055555556,1,1,14,15
2019-08-28 20:22:11,5.95574074074074,1,3,3,6
2019-08-23 14:53:54,1.43625,2,4,4,8
2019-09-01 07:42:15,12.207789351851853,11,293,138,431
2019-08-23 10:42:40,1.5091435185185185,3,10,10,20
2019-08-30 21:18:58,9.13037037037037,18,3635,287,3922
2019-08-21 01:05:57,0.025266203703703704,2,10,5,15
2019-08-20 15:39:07,0.1222337962962963,1,1,1,2
2019-08-20 23:53:49,0.4913425925925926,5,9,7,16
2019-08-20 23:54:05,0.6235300925925926,6,91,34,125
2019-08-20 10:42:25,0.11369212962962963,4,4,4,8
2019-08-20 23:20:47,1.1345717592592592,2,3,3,6
2019-08-17 17:18:39,0.022094907407407407,1,1,1,2
2019-08-16 20:30:39,0.022453703703703705,1,3,2,5
2019-08-16 15:53:11,0.03542824074074074,1,5,4,9
2019-08-20 15:13:44,4.460173611111111,4,21,19,40
2019-08-20 23:46:04,6.617303240740741,2,1521,187,1708
2019-08-30 12:15:37,16.13693287037037,1,1,0,1
2019-08-19 13:31:47,5.92037037037037,1,10,8,18
2019-08-12 13:53:06,1.0112847222222223,1,1,1,2
2019-09-18 19:42:52,38.51545138888889,29,17023,11411,28434
2019-08-09 23:36:45,0.5472916666666666,1,2,2,4
2019-08-28 14:51:51,21.97920138888889,16,1004,314,1318
2019-08-07 08:08:45,0.5760532407407407,1,1,1,2
2019-08-07 08:08:22,1.2030671296296296,4,282,317,599
2019-08-15 15:11:11,10.563773148148147,21,3989,2031,6020
2019-08-07 08:09:05,2.2991435185185187,1,1,1,2
2019-08-07 08:09:21,2.3001388888888887,1,1,1,2
2019-08-07 08:09:55,2.6514930555555556,1,1,1,2
2019-08-07 08:10:20,3.086921296296296,1,4,4,8
2019-08-07 08:11:26,4.162731481481481,1,1,1,2
2019-08-01 13:50:31,0.5287847222222222,1,23,0,23
2019-07-31 14:22:42,0.0037847222222222223,1,1,1,2
2019-08-18 09:02:26,18.933900462962963,1,1,1,2
2019-07-26 19:36:22,0.015104166666666667,2,34,14,48
2019-08-05 17:17:48,10.089456018518518,16,2574,1782,4356
2019-08-05 10:55:05,9.945358796296297,3,23,23,46
2019-07-25 13:03:22,0.1751273148148148,2,4,4,8
2019-07-26 17:31:02,1.5151851851851852,2,8,4,12
2019-07-25 12:58:49,0.5444560185185185,1,1,1,2
2019-07-25 13:01:23,0.7737847222222223,1,1,1,2
2019-07-25 13:00:00,1.2002777777777778,1,4,1,5
2019-07-23 16:16:36,0.01685185185185185,1,18,4,22
2019-07-23 14:03:07,0.004039351851851852,1,71,31,102
2019-07-23 16:05:30,0.7562847222222222,4,57,24,81
2019-07-23 13:24:26,1.024502314814815,3,3,3,6
2019-07-23 13:28:32,2.033912037037037,1,4,4,8
2019-07-23 13:29:32,3.1155671296296297,1,25,12,37
2019-07-21 15:05:37,1.2610532407407407,1,1,1,2
2019-07-18 13:54:06,0.3183796296296296,1,1,1,2
2019-07-18 16:30:33,0.44471064814814815,1,1,2,3
2019-08-20 23:14:41,34.29584490740741,1,2,1,3
2019-07-17 10:31:26,0.055150462962962964,1,0,1,1
2019-07-18 21:32:34,1.8446064814814815,5,48,67,115
2019-07-17 10:26:35,0.5323032407407408,4,7,7,14
2019-08-05 14:18:01,19.93002314814815,2,98,57,155
2019-07-05 10:00:05,3.5025578703703704,1,3,1,4
2019-07-05 10:04:31,8.450219907407407,1,36,20,56
2019-06-28 15:28:26,3.295300925925926,1,16,18,34
2019-06-28 15:08:51,4.890833333333333,2,2,6,8
2019-06-22 19:29:20,0.22885416666666666,2,4857,2007,6864
2019-06-22 19:29:41,0.33047453703703705,2,4,4,8
2019-07-16 09:51:23,26.03962962962963,151,36226,28142,64368
2019-06-28 15:10:59,8.939085648148149,1,2,2,4
2019-06-20 07:58:25,1.925127314814815,39,2055,1631,3686
2019-06-18 09:42:58,0.045625,4,275,64,339
2019-06-17 14:27:26,0.22554398148148147,9,1003,227,1230
2019-06-15 21:12:56,0.3287731481481482,1,1,1,2
2019-06-15 21:14:10,0.7991782407407407,1,2,2,4
2019-06-15 21:13:42,1.229814814814815,1,4,0,4
2019-06-14 15:23:46,0.004201388888888889,1,2,0,2
2019-06-12 08:01:22,0.407974537037037,1,1,1,2
2019-06-14 15:02:47,3.136273148148148,1,14,3,17
2019-06-11 09:29:11,1.2581944444444444,1,59,23,82
2019-06-14 15:02:09,12.815578703703704,12,1163,399,1562
2019-05-31 12:44:53,0.34554398148148147,7,469,265,734
2019-05-30 19:53:14,0.0060648148148148145,1,3,3,6
2019-06-14 14:57:46,15.41388888888889,1,1,1,2
2019-06-14 14:57:03,18.228726851851853,1,1,1,2
2019-06-14 14:56:26,23.228090277777778,1,1,1,2
2019-07-05 10:01:18,63.69922453703704,15,4709,904,5613
2019-06-14 14:49:25,33.691435185185185,3,141,139,280
2019-05-10 11:48:13,1.1642939814814814,3,171,159,330
2019-06-14 14:47:32,45.25145833333333,19,1278,551,1829
2019-05-08 14:56:39,2.937708333333333,1,8,5,13
2019-05-08 14:06:14,6.112939814814815,1,2,2,4
2019-05-08 14:07:51,6.123865740740741,1,138,133,271
2019-05-01 09:18:47,0.2711226851851852,1,4,1,5
2019-05-01 09:20:17,0.518900462962963,1,2,2,4
2019-05-08 14:55:28,10.876793981481482,1,13,4,17
2019-04-25 19:02:36,0.21038194444444444,3,69,34,103
2019-04-30 09:12:55,5.879108796296296,2,7,7,14
2019-04-25 19:01:04,2.4055324074074074,1,25,12,37
2019-04-23 08:30:23,0.815,2,757,286,1043
2019-04-23 08:29:02,1.6310185185185184,1,17,19,36
2019-04-24 18:59:21,10.873993055555555,2,302,109,411
2019-04-17 13:22:15,0.14152777777777778,6,135,20,155
2019-04-17 09:06:42,0.7540162037037037,4,179,43,222
2019-04-17 09:08:54,0.44829861111111113,1,1,1,2
2019-04-17 09:10:37,0.6028125,1,1,1,2
2019-04-17 09:11:36,0.624849537037037,1,19,19,38
2019-04-15 14:14:51,4.1274189814814815,5,9,10,19
2019-04-16 06:49:55,0.8767361111111112,16,458,255,713
2019-04-25 19:04:17,10.434907407407408,2,4,4,8
2019-04-15 08:57:25,2.602048611111111,1,1,1,2
2019-04-15 08:55:58,2.783333333333333,1,15,5,20
2019-04-15 08:56:49,3.553125,1,1,1,2
2019-04-11 19:53:24,1.9219560185185185,1,2,1,3
2019-04-11 19:54:47,2.8154166666666667,1,4,1,5
2019-04-23 08:27:39,35.8302662037037,15,2200,521,2721
2019-04-02 09:40:47,0.0140625,1,2,2,4
2019-04-02 08:41:41,0.5748842592592592,1,7,3,10
2019-04-02 08:41:56,2.640023148148148,1,1,1,2
2019-04-03 09:26:59,4.150486111111111,1,1,1,2
2019-03-29 08:14:11,0.003321759259259259,1,1,1,2
2019-04-15 09:01:54,17.656701388888887,7,157,75,232
2019-03-27 11:30:04,0.9399189814814815,1,2,2,4
2019-04-03 09:35:31,9.542372685185185,7,39,21,60
2019-03-27 11:03:26,5.919363425925926,1,1,1,2
2019-03-27 11:03:00,6.250011574074074,1,2,2,4
2019-03-27 11:02:37,6.86025462962963,23,974,299,1273
2019-04-03 09:21:44,25.634189814814814,14,153,92,245
2019-03-28 08:06:53,13.988067129629629,6,450,47,497
2019-03-15 11:54:41,0.006168981481481482,1,3,1,4
2019-03-14 14:56:40,0.22528935185185187,1,2,2,4
2019-03-14 09:17:19,0.009502314814814814,1,1,1,2
2019-03-14 09:00:48,0.004016203703703704,2,7,1,8
2019-03-14 08:03:33,1.2648958333333333,1,0,1,1
2019-03-11 08:08:52,1.731400462962963,1,1,1,2
2019-03-11 08:08:28,2.3197337962962963,1,16,16,32
2019-03-11 08:07:56,2.631111111111111,1,1,0,1
2019-03-11 08:06:55,3.8361111111111112,1,3,3,6
2019-03-11 08:06:28,3.9539699074074073,1,1,0,1
2019-03-06 08:48:27,0.548599537037037,1,34,1,35
2019-03-06 08:48:02,1.4289699074074074,1,1,1,2
2019-03-06 08:47:33,3.120011574074074,1,9,3,12
2019-03-06 08:45:50,6.2810648148148145,4,5,5,10
2019-03-06 08:44:57,7.723668981481482,9,91,54,145
2019-03-06 08:37:12,7.184583333333333,2,31,11,42
2019-02-24 08:38:30,1.3753587962962963,2,33,19,52
2019-02-21 09:23:28,0.005567129629629629,1,4,3,7
2019-02-21 08:25:19,0.2081712962962963,1,1,1,2
2019-02-20 20:24:07,0.05917824074074074,1,9,1,10
2019-02-20 13:14:03,0.0027314814814814814,2,2,2,4
2019-02-19 13:00:29,0.01818287037037037,1,1,1,2
2019-02-19 08:00:02,0.4802546296296296,1,2,2,4
2019-02-18 20:07:39,0.11126157407407407,1,1,1,2
2019-02-18 11:00:12,0.003715277777777778,1,7,4,11
2019-02-18 10:38:06,0.49947916666666664,10,1733,161,1894
2019-02-17 14:30:47,0.7589699074074074,1,1,0,1
2019-02-15 09:06:51,0.04821759259259259,1,7,0,7
2019-02-13 15:32:22,0.04325231481481481,1,0,1,1
2019-02-13 09:19:09,0.03221064814814815,4,59,18,77
2019-02-13 09:19:26,0.8923958333333334,1,1,1,2
2019-02-08 09:36:04,1.0204398148148148,2,2,6,8
2019-02-06 19:33:19,0.03971064814814815,1,1,1,2
2019-02-11 13:19:27,35.05822916666666,84,10526,4343,14869
2019-02-05 15:33:46,0.9494212962962963,1,8,1,9
2019-02-05 15:00:53,3.8646875,1,7,4,11
2019-02-01 11:17:50,1.0248148148148148,1,2,2,4
2019-02-01 11:14:56,1.6291666666666667,2,2,2,4
2019-02-01 11:14:05,1.7047453703703703,1,8,8,16
2019-02-05 14:40:44,13.66710648148148,4,105,119,224
2019-02-05 15:15:04,17.539513888888887,5,180,1162,1342
2019-01-18 08:28:11,0.6571296296296296,1,2,1,3
2019-01-16 22:51:53,0.11561342592592593,1,1,1,2
2019-01-14 08:44:02,0.17247685185185185,1,1,1,2
2019-01-14 08:40:08,0.8548032407407408,1,6,6,12
2019-01-14 08:39:04,0.8442708333333333,1,7,7,14
2019-01-14 08:38:38,0.8662847222222222,1,0,1,1
2019-01-11 07:50:13,0.012916666666666667,1,7,4,11
2019-01-10 22:39:11,0.40800925925925924,1,3,2,5
2019-01-10 22:40:45,1.9774537037037037,1,1075,0,1075
2019-01-09 12:44:10,1.4092476851851852,2,11,4,15
2019-01-07 11:44:47,0.16196759259259258,1,2,2,4
2019-01-07 11:40:56,2.3736342592592594,1,1,1,2
2019-01-07 11:31:07,4.1865046296296295,4,12,8,20
2019-01-07 11:27:17,4.934930555555556,1,6,3,9
2019-01-07 11:23:06,15.956261574074073,1,1,1,2
2019-01-07 11:21:13,17.559328703703702,1,1,1,2
2019-01-07 11:06:07,17.95474537037037,1,4,10,14
2018-12-19 09:18:25,0.30649305555555556,2,9,4,13
2018-12-19 09:15:53,0.31568287037037035,1,1,0,1
2018-12-19 09:29:18,0.7831944444444444,1,53,13,66
2019-01-07 11:03:51,20.06349537037037,4,1447,99,1546
2018-12-14 22:29:48,0.13833333333333334,1,1,2,3
2018-12-13 11:32:38,7.517337962962963,2,165,197,362
2018-12-13 11:15:15,1.955775462962963,2,13,7,20
2018-12-14 14:15:47,8.06670138888889,48,2149,760,2909
2018-12-11 10:18:01,1.0065162037037036,1,3,2,5
2018-12-09 20:29:32,2.03375,1,3,0,3
2018-12-13 11:05:12,6.934351851851852,14,764,113,877
2018-12-09 20:27:31,3.342337962962963,1,1,1,2
2018-12-11 10:12:05,5.721828703703704,3,24,30,54
2018-12-05 15:41:05,1.1253125,2,15,15,30
2018-12-02 12:01:05,0.015729166666666666,1,2,1,3
2018-12-01 00:15:44,0.009351851851851853,1,1,1,2
2018-12-01 00:15:31,0.010717592592592593,1,1,0,1
2018-11-30 22:10:31,0.3909490740740741,14,318,74,392
2018-11-30 22:33:53,0.055879629629629626,1,1,1,2
2018-11-30 17:23:47,0.06315972222222223,1,1,1,2
2018-11-28 13:59:09,0.003738425925925926,1,1,1,2
2018-11-28 11:39:46,1.1049652777777779,1,42,22,64
2018-11-20 09:09:50,0.2141435185185185,2,2,2,4
2018-11-19 19:54:47,0.08626157407407407,1,1,1,2
2018-11-20 09:11:47,2.0384953703703705,1,2,2,4
2018-11-17 11:21:49,1.6428125,13,12960,7144,20104
2018-11-13 16:00:10,6.96744212962963,9,511,294,805
2018-11-13 15:19:29,0.01601851851851852,1,9,3,12
2018-11-08 20:00:02,0.06675925925925925,1,5,5,10
2018-11-07 22:36:46,0.0583912037037037,3,359,146,505
2018-11-05 23:34:18,0.021979166666666668,1,1,1,2
2018-11-10 21:27:46,4.995532407407407,2,49,0,49
2018-11-03 14:10:35,0.0003935185185185185,1,9,0,9
