Merge Date,Time to Integration (days),Number of Commits,Total Additions,Total Deletions,Total Lines Changed
2024-05-26 21:45:28,0.37030092592592595,1,10,20,30
2024-05-26 22:11:30,0.4140162037037037,1,6,1,7
2024-05-26 13:56:19,0.12465277777777778,1,10,8,18
2024-05-25 19:56:01,0.011851851851851851,1,0,2,2
2024-05-25 18:49:02,0.033935185185185186,1,1,3,4
2024-05-25 18:19:29,0.3125115740740741,2,4,5,9
2024-05-25 18:21:55,0.30831018518518516,1,32,0,32
2024-05-25 10:10:21,0.7566203703703703,6,172,119,291
2024-05-24 14:34:32,0.41846064814814815,3,105,85,190
2024-05-24 11:12:54,0.06011574074074074,1,56,45,101
2024-05-24 09:37:12,0.21197916666666666,1,32,23,55
2024-05-23 21:36:18,0.05269675925925926,1,110,2,112
2024-05-26 06:25:26,3.0528703703703703,4,213,121,334
2024-05-23 07:11:55,0.37353009259259257,2,779,760,1539
2024-05-26 20:28:36,4.3750231481481485,1,24,3,27
2024-05-24 14:08:29,2.1510300925925927,1,8,6,14
2024-05-21 13:28:26,0.5008796296296296,1,120,184,304
2024-05-22 22:40:11,2.861759259259259,4,379,319,698
2024-05-20 20:29:21,0.8253587962962963,6,192,176,368
2024-05-20 12:52:07,0.4500462962962963,3,18,38,56
2024-05-19 17:40:25,0.2258564814814815,2,19,18,37
2024-05-21 14:04:58,2.2207175925925924,5,45,43,88
2024-05-19 06:20:51,0.19270833333333334,1,6,8,14
2024-05-19 11:49:07,0.6522453703703703,4,29,20,49
2024-05-18 14:28:33,0.039375,1,1,0,1
2024-05-19 17:59:47,1.5542592592592592,2,3,1,4
2024-05-18 09:19:57,0.26055555555555554,2,17,8,25
2024-05-18 14:34:05,0.7516898148148148,6,460,761,1221
2024-05-18 15:52:34,1.321226851851852,5,24,5,29
2024-05-16 22:48:09,0.9437384259259259,1,3,1,4
2024-05-16 22:45:56,0.24769675925925927,1,1,0,1
2024-05-21 20:24:01,5.2959606481481485,6,2817,2591,5408
2024-05-25 19:48:19,9.674618055555555,2,43,25,68
2024-05-24 14:38:00,9.246736111111112,3,12,4,16
2024-05-16 22:56:28,1.7365162037037036,1,68,34,102
2024-05-21 17:28:57,6.96869212962963,13,239,133,372
2024-05-14 20:42:02,0.2629976851851852,2,8,28,36
2024-05-13 06:31:02,0.2762615740740741,1,6,6,12
2024-05-20 10:09:30,8.165451388888888,3,23,2,25
2024-05-16 04:28:44,4.340034722222223,4,7,4,11
2024-05-12 02:24:34,0.7688888888888888,1,10,2,12
2024-05-25 23:19:27,14.890613425925926,3,58,98,156
2024-05-13 22:48:12,4.1787731481481485,13,1646,524,2170
2024-05-15 04:21:13,5.136527777777777,2,20,4,24
2024-05-13 16:41:23,3.8178819444444443,9,99,102,201
2024-05-10 18:21:44,0.8838425925925926,1,5,5,10
2024-05-10 14:08:20,1.1125,1,2,1,3
2024-05-09 11:32:17,0.11653935185185185,1,38,28,66
2024-05-09 12:13:46,0.254224537037037,8,57,20,77
2024-05-09 06:49:43,0.21509259259259259,1,1,1,2
2024-05-14 14:10:59,5.534479166666666,5,1032,351,1383
2024-05-26 09:57:57,17.411284722222224,22,7772,5957,13729
2024-05-14 18:32:48,6.098715277777778,4,2382,747,3129
2024-05-08 05:42:51,0.1265625,3,53,5,58
2024-05-08 07:57:21,0.2279050925925926,1,1,1,2
2024-05-08 15:41:04,0.5660648148148149,2,7,0,7
2024-05-08 08:10:47,0.6217476851851852,3,81,40,121
2024-05-07 08:51:57,0.209375,1,1,1,2
2024-05-14 20:00:50,7.873831018518518,1,3,3,6
2024-05-06 19:35:53,0.15042824074074074,4,9,7,16
2024-05-09 18:21:58,3.823263888888889,1,36,4,40
2024-05-06 15:53:45,0.38472222222222224,4,136,44,180
2024-05-15 04:18:31,58.018993055555555,6,179,111,290
2024-05-06 17:02:26,1.1772222222222222,4,380,213,593
2024-05-07 17:12:47,4.0787962962962965,3,342,104,446
2024-05-06 02:48:37,6.1573263888888885,2,23,19,42
2024-05-15 17:31:37,10.70931712962963,1,30,0,30
2024-05-06 22:32:57,2.0043171296296296,5,12,6,18
2024-05-05 19:46:23,1.239988425925926,2,9,7,16
2024-05-04 02:31:39,0.06388888888888888,1,6,6,12
2024-05-04 12:21:51,0.7418402777777777,1,4,3,7
2024-05-08 05:24:58,4.725289351851852,10,2042,901,2943
2024-05-03 05:15:39,0.26185185185185184,1,12,0,12
2024-05-03 14:07:35,0.7452893518518519,2,37,19,56
2024-05-08 22:50:45,6.176099537037037,4,2602,956,3558
2024-05-02 18:41:29,0.07696759259259259,1,1,1,2
2024-05-02 17:07:52,0.05652777777777778,1,3,0,3
2024-05-02 18:45:55,0.21284722222222222,1,0,2,2
2024-05-02 19:10:08,0.42237268518518517,2,35,26,61
2024-05-01 11:11:11,2.672314814814815,3,38,20,58
2024-04-30 09:39:36,0.06255787037037037,1,6,46,52
2024-04-30 04:28:53,0.060613425925925925,2,20,0,20
2024-05-10 13:56:54,11.420949074074073,6,189,115,304
2024-05-03 07:32:18,3.592048611111111,2,4,2,6
2024-04-30 06:39:07,1.1890046296296297,1,8,3,11
2024-05-05 18:33:09,7.040486111111111,10,2375,761,3136
2024-04-28 23:05:14,0.02246527777777778,1,2,1,3
2024-04-28 18:11:39,0.3098726851851852,1,27,27,54
2024-05-02 20:19:52,4.567789351851852,10,1826,459,2285
2024-05-03 14:40:28,6.333101851851852,12,2248,743,2991
2024-04-29 09:08:45,2.100671296296296,15,240,171,411
2024-05-16 18:46:21,19.758472222222224,1,20,3,23
2024-04-26 21:25:47,0.016770833333333332,1,1818,498,2316
2024-04-26 20:09:25,0.4279861111111111,1,15,82,97
2024-04-26 09:30:43,0.20283564814814814,1,17,0,17
2024-04-26 11:04:13,0.5265972222222223,1,46,33,79
2024-04-29 08:46:02,3.966087962962963,1,11,122,133
2024-04-25 07:11:45,0.42381944444444447,1,13,0,13
2024-04-24 19:28:23,0.031342592592592596,1,6,6,12
2024-04-28 14:00:45,3.961053240740741,4,79,34,113
2024-04-29 03:31:12,5.606736111111111,2,1284,4,1288
2024-04-25 10:23:39,0.9111226851851851,1,2,2,4
2024-04-24 13:12:30,0.10170138888888888,1,1,1,2
2024-04-26 15:07:49,2.3549652777777776,1,1,45,46
2024-04-24 04:25:44,0.47662037037037036,3,38,17,55
2024-04-26 15:13:32,3.0527662037037038,1,8,101,109
2024-04-25 10:30:12,2.042708333333333,1,29,0,29
2024-04-22 23:59:13,0.08138888888888889,1,10,12,22
2024-04-26 15:10:01,3.8603703703703705,2,13,117,130
2024-04-22 11:20:51,0.05841435185185185,1,1,22,23
2024-04-22 22:45:27,0.9177662037037037,1,13,3,16
2024-05-03 20:03:58,11.992881944444445,1,107,11,118
2024-04-21 20:43:38,0.03606481481481481,1,10,10,20
2024-04-22 15:49:28,1.6347106481481481,3,225,134,359
2024-04-21 08:54:59,0.47931712962962963,1,12,9,21
2024-04-20 21:10:02,0.12300925925925926,5,117,55,172
2024-04-20 15:08:27,0.09194444444444444,1,0,20,20
2024-04-23 07:26:55,5.48681712962963,27,439,203,642
2024-04-21 06:11:18,0.9241782407407407,7,43,30,73
2024-04-19 20:21:05,0.056365740740740744,1,4,1,5
2024-04-19 15:43:36,0.08905092592592592,2,6,6,12
2024-04-19 15:24:20,0.15430555555555556,1,5,5,10
2024-04-19 18:35:43,0.3570138888888889,1,9,3,12
2024-04-19 10:08:09,0.0844212962962963,1,8,8,16
2024-04-19 01:21:15,0.16938657407407406,2,9,1,10
2024-04-18 23:33:51,0.5440972222222222,2,13,2,15
2024-04-19 12:23:45,1.1633912037037037,2,10,1,11
2024-04-17 22:14:40,0.05269675925925926,1,7,1,8
2024-04-25 07:28:34,7.4784953703703705,2,83,75,158
2024-04-17 20:24:07,4.932789351851852,1,5,4,9
2024-04-19 15:46:27,2.081446759259259,4,8,4,12
2024-04-17 09:57:35,0.09324074074074074,1,1,1,2
2024-04-30 00:29:03,12.772685185185185,3,18,14,32
2024-04-18 21:19:57,1.770324074074074,2,3,4,7
2024-04-19 14:02:29,2.5585300925925925,1,18,248,266
2024-04-21 11:20:21,4.464421296296297,4,80,190,270
2024-05-25 08:52:20,38.38605324074074,9,26268,25709,51977
2024-04-16 21:52:31,0.0175,2,1,2,3
2024-04-18 19:17:01,1.9950810185185186,3,11,12,23
2024-05-07 18:09:14,21.328761574074075,9,61390,47027,108417
2024-04-30 13:05:43,14.327731481481482,10,139,136,275
2024-04-15 23:48:35,0.28836805555555556,1,2,2,4
2024-04-18 19:02:25,3.3689699074074073,13,2832,2700,5532
2024-04-21 09:56:58,5.860324074074074,4,1015,149,1164
2024-05-20 21:13:46,35.85170138888889,16,7717,4434,12151
2024-05-01 20:59:09,16.279652777777777,6,20182,21401,41583
2024-04-16 05:40:02,1.2430324074074075,2,12,8,20
2024-04-15 17:45:29,0.9515509259259259,1,24,7,31
2024-04-18 21:13:34,4.3359143518518515,4,9,5,14
2024-04-15 09:29:15,0.8546180555555556,1,2,2,4
2024-05-15 17:21:45,32.085092592592595,1,4,494,498
2024-04-23 18:45:37,9.469699074074073,5,20854,22049,42903
2024-05-14 07:53:48,30.106863425925926,3,19,13,32
2024-04-13 17:12:11,0.037662037037037036,1,4,4,8
2024-04-15 00:13:41,1.5015856481481482,32,2775,1655,4430
2024-04-12 23:36:32,0.05092592592592592,1,1,1,2
2024-04-12 21:47:50,10.243645833333334,1,59,198,257
2024-05-13 00:00:31,53.132534722222225,26,27632,24868,52500
2024-04-12 14:05:57,0.049039351851851855,1,6,1,7
2024-04-14 19:02:29,2.6841435185185185,9,264,232,496
2024-04-12 06:27:20,0.1021412037037037,2,53,3,56
2024-04-11 22:50:05,0.07703703703703704,1,31,7,38
2024-04-11 20:52:41,0.03746527777777778,1,1,1,2
2024-04-11 07:45:45,0.01628472222222222,1,2,2,4
2024-04-12 13:55:17,1.4111342592592593,5,20,4,24
2024-05-09 02:01:33,28.93582175925926,4,142,121,263
2024-04-11 04:41:41,9.50550925925926,2,74,140,214
2024-04-10 17:48:54,0.03931712962962963,1,1,0,1
2024-04-11 16:35:33,1.195300925925926,20,579,274,853
2024-04-10 11:00:32,0.02440972222222222,1,1,0,1
2024-04-10 09:00:55,0.08238425925925925,1,26,1,27
2024-04-10 16:32:04,1.0685416666666667,5,130,75,205
2024-04-11 14:56:58,2.1506481481481483,4,83,9,92
2024-04-09 11:18:59,0.010902777777777779,1,1,1,2
2024-04-09 11:55:03,0.16503472222222224,1,1180,94,1274
2024-04-13 07:00:19,3.512986111111111,5,328,7,335
2024-04-09 02:13:08,0.1360300925925926,2,217,33,250
2024-04-09 05:01:04,0.379212962962963,1,14,13,27
2024-04-10 11:16:06,1.7430092592592592,4,24,25,49
2024-04-09 13:04:30,0.8019791666666667,16,4923,1701,6624
2024-04-08 15:40:19,0.08255787037037036,2,37,18,55
2024-04-15 19:48:29,7.351400462962963,4,23755,13319,37074
2024-04-09 03:18:15,2.0330439814814816,3,17,2,19
2024-05-22 12:56:42,46.82168981481482,7,96,87,183
2024-04-06 22:07:56,0.1867939814814815,9,1589,487,2076
2024-04-07 11:40:57,0.9844907407407407,1,2,2,4
2024-04-15 08:23:12,9.520451388888889,7,179,77,256
2024-04-10 18:25:24,12.034282407407407,48,27396,20217,47613
2024-04-20 18:44:48,73.05979166666667,100,26341,27205,53546
2024-04-08 21:02:55,5.288368055555556,7,6923,7299,14222
2024-04-03 16:39:46,0.29282407407407407,6,38,28,66
2024-04-03 23:44:06,1.0218171296296297,1,72,17,89
2024-04-03 15:45:54,1.8991782407407407,2,25,37,62
2024-04-02 06:18:44,1.2146527777777778,3,3652,2315,5967
2024-03-31 17:26:09,0.4100578703703704,2,16,6,22
2024-04-01 19:42:11,1.9180092592592592,5,30,7,37
2024-03-30 14:26:36,0.08512731481481481,3,930,866,1796
2024-03-30 03:04:29,0.3323726851851852,3,593,712,1305
2024-03-29 14:41:00,18.849895833333335,2,21,33,54
2024-03-29 13:31:15,0.13493055555555555,1,3,3,6
2024-03-28 20:11:45,0.015590277777777778,1,1,1,2
2024-03-28 16:40:44,0.035868055555555556,1,0,6,6
2024-03-29 15:34:17,0.9978703703703704,20,4433,4316,8749
2024-03-29 09:42:14,0.8694907407407407,2,6,6,12
2024-03-28 15:28:22,0.24707175925925925,2,23,1,24
2024-03-28 12:49:22,0.16608796296296297,2,7,20,27
2024-03-28 20:33:33,0.5591319444444445,1,32,0,32
2024-03-28 08:13:47,0.45023148148148145,1,19,2,21
2024-03-29 17:43:55,2.0341898148148148,1,12,2,14
2024-03-27 15:28:14,0.8901041666666667,2,11,28,39
2024-03-26 22:02:29,0.3575,3,21,20,41
2024-03-25 22:54:20,0.04047453703703704,1,1,1,2
2024-03-25 15:27:39,0.03871527777777778,1,1,1,2
2024-03-25 16:33:04,0.14347222222222222,2,35,5,40
2024-03-25 12:59:39,0.09663194444444445,1,1,1,2
2024-03-25 10:59:43,0.03300925925925926,1,3,0,3
2024-03-26 19:23:18,1.3932407407407408,9,28,23,51
2024-03-24 21:11:33,0.06773148148148148,2,3,4,7
2024-04-15 18:14:24,22.1815625,1,9,2,11
2024-04-01 21:49:22,9.20949074074074,18,211,124,335
2024-04-09 22:36:14,17.23353009259259,89,28066,20906,48972
2024-03-24 07:06:31,0.7531481481481481,2,10,1,11
2024-03-24 15:57:18,1.1869907407407407,1,106,106,212
2024-03-24 20:31:26,6.119502314814815,2,625,17,642
2024-03-28 19:15:48,6.063692129629629,1,1,1,2
2024-03-23 08:44:05,0.6600810185185185,1,1,1,2
2024-03-22 15:19:00,0.03971064814814815,1,3,3,6
2024-05-08 06:50:45,47.72328703703704,6,39,10,49
2024-03-26 20:12:44,5.857673611111111,6,34,15,49
2024-03-26 07:13:08,5.400740740740741,3,8,3,11
2024-03-29 19:14:50,8.911597222222222,1,9,1,10
2024-04-01 14:51:25,295.87159722222225,26,6310,4734,11044
2024-04-19 19:48:21,30.777627314814815,19,36097,23793,59890
2024-03-19 19:25:12,0.04005787037037037,1,2,2,4
2024-03-29 09:51:25,35.69543981481481,19,12129,8009,20138
2024-03-21 19:55:12,29.786469907407408,4,35,12,47
2024-03-19 14:12:09,0.6324074074074074,3,71,16,87
2024-03-18 23:25:32,0.010439814814814815,1,1,0,1
2024-03-19 06:18:06,0.4202314814814815,1,4,75,79
2024-03-21 07:01:59,2.6546527777777778,1,16,7,23
2024-03-22 17:34:06,31.041909722222222,6,43,43,86
2024-03-27 22:18:03,3.0930439814814816,3,33,9,42
2024-03-17 22:35:20,0.16623842592592591,1,134,3,137
2024-03-17 07:49:54,0.1037037037037037,1,22,12,34
2024-03-25 09:46:18,8.195717592592592,1,4,4,8
2024-03-16 19:22:22,0.0783912037037037,1,4,0,4
2024-03-16 15:47:54,0.1840277777777778,3,38,61,99
2024-03-23 03:53:44,6.728900462962963,3,3352,2538,5890
2024-03-16 10:15:13,223.9091435185185,4,162,133,295
2024-03-18 06:54:50,2.331863425925926,1,2,1,3
2024-03-18 10:43:54,2.6182291666666666,3,16,34,50
2024-03-15 15:23:54,0.073125,2,26,25,51
2024-03-15 16:24:50,0.7782175925925926,2,51,51,102
2024-03-15 05:59:44,0.36266203703703703,1,14,12,26
2024-03-15 16:01:45,1.279988425925926,9,1572,1802,3374
2024-03-14 00:17:06,0.06428240740740741,1,8571,8569,17140
2024-03-13 19:08:21,0.13430555555555557,2,909,646,1555
2024-03-13 15:52:28,0.10085648148148148,1,4,4,8
2024-03-13 07:23:39,0.36170138888888886,1,16,16,32
2024-03-12 22:06:05,0.008229166666666666,1,3,3,6
2024-03-12 21:49:53,0.003969907407407407,1,1,1,2
2024-03-13 01:32:29,0.33649305555555553,1,5,1,6
2024-03-12 05:59:15,0.050625,1,8,8,16
2024-03-14 11:28:27,2.829525462962963,5,428,420,848
2024-03-12 16:40:36,0.7042361111111111,1,15,8,23
2024-03-13 17:59:05,2.263310185185185,2,22,5,27
2024-03-12 07:24:44,0.8931828703703704,1,30,30,60
2024-03-10 22:11:56,0.2409375,2,11,5,16
2024-03-11 17:41:20,2.4167824074074074,7,132,108,240
2024-03-15 17:13:31,6.724097222222222,4,62,53,115
2024-03-08 13:04:21,0.003599537037037037,1,1,0,1
2024-03-09 05:07:23,1.041388888888889,2,52,4,56
2024-03-12 16:20:43,4.885856481481482,5,13,6,19
2024-03-07 21:22:03,0.4791666666666667,1,5,1,6
2024-03-09 10:29:59,2.246261574074074,2,75,74,149
2024-03-07 22:33:14,0.8494560185185185,3,48,68,116
2024-03-08 23:22:57,2.1878935185185187,3,6,6,12
2024-03-06 22:44:53,0.20715277777777777,1,24,3,27
2024-03-07 23:04:40,1.2502662037037038,1,28,0,28
2024-03-06 23:24:18,0.274837962962963,3,4,5,9
2024-03-18 19:59:58,12.150300925925926,3,1836,1811,3647
2024-04-22 14:39:51,47.06784722222222,1,26,72,98
2024-03-06 15:49:43,0.13622685185185185,1,5,5,10
2024-03-26 08:31:15,19.847731481481482,1,10,19,29
2024-03-06 08:21:51,0.05119212962962963,1,23,11,34
2024-03-07 22:44:56,2.15837962962963,1,99,15,114
2024-03-05 18:40:17,0.13667824074074075,1,12,2,14
2024-04-01 04:25:29,26.870983796296297,5,13438,14946,28384
2024-03-04 22:45:36,0.05023148148148148,1,3,3,6
2024-03-05 19:01:46,4.950243055555555,1,1,0,1
2024-03-12 18:03:03,8.136631944444444,5,55,22,77
2024-03-04 23:37:41,0.4323842592592593,1,8,5,13
2024-03-04 08:29:02,0.43743055555555554,1,4,4,8
2024-03-22 14:50:31,27.086006944444446,3,256,45,301
2024-03-03 07:58:56,0.6822337962962963,2,36,31,67
2024-03-05 14:34:20,3.1475578703703704,1,26,2,28
2024-03-02 21:20:01,0.9826851851851852,5,110,62,172
2024-03-29 17:17:20,32.27376157407407,1,299,19,318
2024-02-29 20:52:37,0.02971064814814815,2,1,51,52
2024-02-29 13:49:55,0.03487268518518519,1,1,1,2
2024-03-02 19:28:40,3.474201388888889,10,92,50,142
2024-02-27 20:22:29,0.07121527777777778,1,0,1,1
2024-02-27 07:27:21,1.2109953703703704,1,7,5,12
2024-02-28 22:32:59,2.8503935185185183,5,51,46,97
2024-02-25 17:16:41,0.2326388888888889,2,20,21,41
2024-02-25 19:40:54,0.4270023148148148,1,2,2,4
2024-02-25 08:02:52,0.3550347222222222,1,2,3,5
2024-02-24 23:57:58,0.10442129629629629,1,1,1,2
2024-02-24 17:23:13,33.93678240740741,2,16,8,24
2024-02-23 03:34:56,0.5129398148148148,1,8,40,48
2024-03-21 04:43:07,27.481342592592593,8,7820,5518,13338
2024-02-22 15:31:14,0.3058796296296296,1,3,3,6
2024-02-21 23:56:10,0.1749537037037037,2,7,3,10
2024-05-15 14:45:50,86.23918981481482,41,708,402,1110
2024-02-21 16:34:55,0.24628472222222222,1,1,1,2
2024-02-21 16:44:43,0.2834837962962963,1,1,1,2
2024-02-21 17:04:54,0.8726041666666666,4,109,137,246
2024-02-20 16:57:39,3.310162037037037,4,34,27,61
2024-02-20 15:32:31,0.8508449074074074,1,0,1,1
2024-03-04 08:38:32,13.599907407407407,1,1,1,2
2024-03-04 10:31:25,14.660844907407407,2,197,13,210
2024-02-19 09:31:18,0.6695601851851852,1,1,1,2
2024-03-03 07:41:30,13.927037037037037,1,17,3,20
2024-02-19 16:50:41,1.345775462962963,4,20,16,36
2024-03-13 17:00:16,24.39521990740741,4,61,17,78
2024-02-18 08:20:11,0.08166666666666667,1,9,9,18
2024-02-17 15:49:57,0.17247685185185185,1,11,11,22
2024-02-16 18:19:38,0.14803240740740742,1,14,11,25
2024-02-16 18:27:40,0.1884259259259259,1,0,5,5
2024-02-16 00:20:26,0.0783912037037037,1,6,8,14
2024-02-15 13:45:25,0.03998842592592593,1,6,6,12
2024-04-10 01:47:35,62.3533912037037,26,1478,674,2152
2024-02-14 23:57:53,0.44927083333333334,2,100,48,148
2024-02-14 00:15:33,0.10479166666666667,1,7,11,18
2024-05-18 10:20:50,94.57315972222223,73,73615,54765,128380
2024-02-18 21:28:13,6.084421296296297,1,8,3,11
2024-05-25 20:56:54,103.18276620370371,6,109,25,134
2024-02-12 18:16:59,0.07717592592592593,1,30,26,56
2024-02-12 20:30:40,0.2900578703703704,1,36,2,38
2024-04-15 15:02:54,63.377662037037034,3,34,7,41
2024-02-11 13:07:59,0.03788194444444445,1,9,7,16
2024-02-18 22:10:55,7.607141203703704,10,1430,791,2221
2024-02-12 01:02:30,1.2139699074074075,3,32,31,63
2024-02-12 10:03:27,1.6041203703703704,1,3,3,6
2024-02-09 21:12:29,0.008993055555555556,1,1,1,2
2024-02-23 18:14:18,13.998599537037038,1,135,15,150
2024-02-09 08:20:26,0.5222916666666667,2,16,4,20
2024-02-16 09:16:36,7.526458333333333,2,9,2,11
2024-02-13 10:57:04,4.717164351851852,5,147,73,220
2024-02-08 15:34:49,0.1373263888888889,1,4,2,6
2024-03-23 10:20:10,0.056365740740740744,1,0,1,1
2024-02-08 07:29:59,0.060266203703703704,1,1,1,2
2024-02-08 10:09:03,0.2259722222222222,5,41,3,44
2024-03-03 07:37:23,25.363599537037036,2,10,6,16
2024-02-23 01:19:56,16.309247685185184,1,8,0,8
2024-02-08 17:36:56,2.8972106481481483,2,0,13,13
2024-02-06 03:20:32,0.33761574074074074,3,82,28,110
2024-02-16 03:04:35,217.4099652777778,2,556,182,738
2024-02-07 06:18:38,2.9832638888888887,6,119,40,159
2024-02-04 08:25:53,0.2312962962962963,3,11,5,16
2024-02-05 06:41:07,1.5105671296296297,1,1,1,2
2024-03-08 18:36:30,34.9278587962963,8,85,29,114
2024-02-03 17:46:26,0.2477199074074074,1,4,0,4
2024-02-04 06:00:37,0.9342592592592592,4,42,27,69
2024-02-03 20:06:45,0.5201388888888889,2,4,3,7
2024-03-04 12:26:50,30.55091435185185,1,5,6,11
2024-02-02 21:08:51,0.06050925925925926,1,18,5,23
2024-02-29 10:37:18,26.89296296296296,3,6180,4724,10904
2024-02-02 11:07:34,0.12358796296296297,1,0,1,1
2024-02-07 05:49:55,5.130300925925926,2,51,54,105
2024-02-05 19:34:22,3.9756828703703704,2,100,105,205
2024-02-01 23:35:19,1.1907407407407407,1,20,8,28
2024-02-01 11:09:43,0.9861921296296297,1,27,24,51
2024-01-31 00:00:41,0.15748842592592593,2,13,7,20
2024-05-10 05:12:24,100.88016203703704,22,85258,69039,154297
2024-01-28 16:22:53,0.3428587962962963,1,1,1,2
2024-02-05 18:41:50,10.118645833333334,8,112,109,221
2024-01-27 11:33:13,0.11310185185185186,1,1,0,1
2024-01-28 16:06:58,1.3484837962962963,2,20,8,28
2024-02-02 19:03:16,6.793761574074074,3,81,41,122
2024-01-29 18:14:41,3.1302546296296296,1,163,4,167
2024-01-26 01:12:37,0.04579861111111111,1,119,7,126
2024-02-26 14:29:50,31.92829861111111,6,39,16,55
2024-03-06 03:58:50,41.08518518518518,6,121,91,212
2024-02-02 17:30:19,8.8584375,1,2,0,2
2024-03-26 10:52:06,61.65130787037037,4,29971,25532,55503
2024-02-19 04:12:11,26.042951388888888,10,105,47,152
2024-04-08 01:08:00,145.30234953703703,10,1112,1245,2357
2024-01-23 19:40:18,0.03119212962962963,1,13,0,13
2024-01-23 12:44:54,0.03133101851851852,1,1,1,2
2024-01-23 05:54:50,0.17425925925925925,1,1,1,2
2024-01-22 23:31:21,0.0421412037037037,1,29,29,58
2024-01-22 20:04:41,0.056886574074074076,1,13,3,16
2024-01-22 18:09:22,0.30940972222222224,2,2,2,4
2024-03-06 17:57:08,44.60193287037037,6,93,72,165
2024-01-22 17:59:13,0.6535763888888889,1,6,1,7
2024-01-22 07:08:59,0.2604976851851852,4,17,14,31
2024-01-22 08:59:31,0.4452199074074074,1,1,1,2
2024-01-21 23:03:13,0.08175925925925925,1,8,3,11
2024-01-21 22:09:46,0.26125,2,5,2,7
2024-01-21 18:14:23,0.057164351851851855,1,8,2,10
2024-01-28 04:42:49,6.628263888888889,3,83,22,105
2024-01-21 12:58:50,0.13322916666666668,1,29,29,58
2024-03-02 15:45:25,41.369224537037034,1,1,3,4
2024-01-22 09:28:21,1.4247106481481482,2,16,8,24
2024-01-21 00:10:46,0.04724537037037037,1,67,25,92
2024-01-20 16:57:19,0.1633912037037037,1,9,6,15
2024-03-24 11:02:56,64.08479166666666,11,532,285,817
2024-01-21 15:06:32,2.0490162037037036,5,278,19,297
2024-01-19 14:05:14,0.06329861111111111,1,1,1,2
2024-01-18 20:04:29,0.11435185185185186,1,2,2,4
2024-01-18 15:38:59,0.0772800925925926,1,5,5,10
2024-01-18 14:31:14,0.09166666666666666,1,5,5,10
2024-05-18 11:47:53,121.35935185185186,9,25729,25038,50767
2024-01-18 07:59:17,0.20515046296296297,1,2,2,4
2024-01-19 16:07:36,1.763611111111111,2,58,10,68
2024-01-17 20:56:57,0.06429398148148148,1,4,5,9
2024-05-18 20:05:54,122.11555555555556,10,9692,5165,14857
2024-01-17 07:48:49,0.14369212962962963,1,0,4,4
2024-01-17 17:08:37,0.5622800925925926,1,68,73,141
2024-01-17 17:49:24,0.9154629629629629,2,21,9,30
2024-01-16 18:00:09,0.05091435185185185,1,4,4,8
2024-01-21 21:18:22,5.206712962962963,3,18,9,27
2024-01-16 20:22:17,0.8984375,3,12,3585,3597
2024-01-20 05:03:29,5.158252314814815,1,31,323,354
2024-03-17 22:28:00,62.94335648148148,3,622,108,730
2024-01-13 21:33:36,0.5762731481481481,4,36,24,60
2024-02-18 03:07:34,35.99337962962963,10,15756,16617,32373
2024-01-13 15:57:47,0.754363425925926,3,40,31,71
2024-01-12 14:26:33,0.10427083333333333,1,2,2,4
2024-01-16 21:20:00,4.168391203703703,7,39,17,56
2024-01-17 17:27:09,5.767939814814815,1,53,52,105
2024-01-11 22:35:50,0.037662037037037036,1,2,0,2
2024-01-12 21:33:19,1.096076388888889,1,1,1,2
2024-01-12 17:14:38,1.0658217592592591,1,5,0,5
2024-03-15 23:46:28,64.41303240740741,2,12,1,13
2024-01-11 11:11:45,0.015590277777777778,1,1,1,2
2024-01-11 13:25:58,0.1435648148148148,1,2,2,4
2024-01-11 13:19:14,0.4668981481481482,1,16,4,20
2024-01-11 10:13:09,0.3908564814814815,1,1,4,5
2024-02-28 09:09:52,311.0936226851852,17,250,355,605
2024-02-07 14:19:17,27.89841435185185,5,701,245,946
2024-01-10 17:12:08,0.3018865740740741,3,16,5,21
2024-01-09 17:33:03,0.0720486111111111,1,12,12,24
2024-01-09 12:15:30,0.03450231481481481,1,2,1,3
2024-01-10 09:42:57,0.9642824074074074,1,32,31,63
2024-01-10 09:49:46,1.4622453703703704,1,8,8,16
2024-01-09 13:08:42,0.5665046296296297,1,2,14,16
2024-01-29 14:06:06,81.80952546296297,13,1054,485,1539
2024-05-07 03:59:29,116.89141203703704,10,43094,27627,70721
2024-01-07 20:54:53,0.029456018518518517,1,1,1,2
2024-01-08 10:32:32,0.6094907407407407,1,0,1,1
2024-01-07 20:58:32,0.13633101851851853,1,30,30,60
2024-01-07 19:01:48,0.07672453703703704,1,3,3,6
2024-01-08 17:43:34,1.029050925925926,1,25,20,45
2024-02-19 14:19:23,42.663900462962964,16,9657,13454,23111
2024-01-07 15:43:54,0.17707175925925925,1,26,0,26
2024-01-07 18:21:00,0.39689814814814817,1,8,8,16
2024-01-07 16:34:34,0.3447337962962963,1,3,0,3
2024-01-07 18:15:18,0.41181712962962963,1,11,0,11
2024-01-07 19:51:51,0.9659722222222222,3,10,175,185
2024-04-15 14:45:06,100.6061111111111,7,609,364,973
2024-01-17 13:11:47,11.959247685185185,1,1,2,3
2024-01-09 09:50:25,3.904027777777778,3,73,144,217
2024-02-05 19:15:49,32.477094907407405,12,24219,26933,51152
2024-01-05 21:33:08,1.5497222222222222,6,30,26,56
2024-01-04 11:18:07,0.4824421296296296,3,41,21,62
2024-01-10 15:42:55,6.783113425925926,2,11,11,22
2024-01-03 08:50:21,5.260891203703704,1,7,7,14
2024-02-12 11:56:30,40.79479166666667,2,323,112,435
2024-01-02 02:18:44,0.1749537037037037,1,5,19,24
2024-01-04 22:32:21,3.120173611111111,2,62,4,66
2024-01-03 11:10:02,1.7177662037037038,1,37,23,60
2024-01-03 08:51:37,1.628449074074074,1,5,0,5
2024-01-01 17:45:52,0.09505787037037038,1,9,4,13
2024-01-04 12:02:48,2.9393171296296297,4,286,145,431
2023-12-31 18:00:26,0.36850694444444443,3,5,5,10
2024-02-06 18:07:42,37.67903935185185,5,118,138,256
2023-12-30 16:15:14,0.3411574074074074,2,8,1,9
2023-12-29 20:26:36,0.048275462962962964,1,1,1,2
2024-03-17 08:45:30,78.95734953703703,5,317,24,341
2024-01-03 01:47:44,4.828506944444444,2,77,58,135
2023-12-29 09:13:37,0.5340625,2,27,4,31
2023-12-28 18:41:56,0.083125,1,4,4,8
2024-03-04 18:50:39,66.73979166666666,12,37413,41395,78808
2023-12-28 10:42:33,1.2257175925925925,1,4,24,28
2024-02-06 20:26:47,43.88211805555556,2,24783,27056,51839
2024-03-11 17:29:05,77.85155092592592,2,48,6,54
2023-12-29 02:48:49,2.6239351851851853,5,15,10,25
2023-12-26 11:54:21,0.04131944444444444,1,0,6,6
2023-12-26 09:19:33,0.4115972222222222,1,2,2,4
2024-02-20 16:50:30,0.46065972222222223,3,1067,304,1371
2023-12-25 17:27:41,0.825625,1,22,3,25
2024-01-03 09:24:44,9.680671296296296,4,90,13,103
2023-12-24 11:10:35,0.35594907407407406,1,3,3,6
2023-12-28 18:45:10,4.811388888888889,5,129,26,155
2024-01-04 23:09:37,12.177662037037036,6,715,698,1413
2023-12-23 21:54:40,0.08777777777777777,1,3,0,3
2023-12-25 10:13:40,1.793275462962963,1,74,2,76
2023-12-23 15:12:46,0.030462962962962963,1,1,1,2
2024-01-20 08:22:41,28.15571759259259,6,96,26,122
2023-12-28 19:12:41,8.53,3,106,18,124
2023-12-23 09:41:58,0.4066666666666667,1,98,39,137
2024-02-05 20:52:43,117.83606481481482,4,18270,16381,34651
2023-12-22 21:57:25,0.18761574074074075,2,4,1,5
2024-01-02 02:29:44,10.549444444444445,4,19,8,27
2023-12-22 17:02:38,72.84545138888889,3,18223,16295,34518
2023-12-22 09:04:01,0.3552777777777778,1,1,1,2
2023-12-22 14:44:33,1.0583101851851853,6,9,8,17
2023-12-21 19:20:53,27.937708333333333,1,2,2,4
2024-01-07 17:02:41,17.702962962962964,6,21,9,30
2024-03-12 16:29:23,82.9196412037037,2,61,23,84
2023-12-20 17:29:19,0.04012731481481482,1,3,2,5
2023-12-20 16:38:27,0.057430555555555554,1,7,0,7
2024-01-28 11:14:45,39.91533564814815,5,195,109,304
2024-03-04 19:18:33,75.90365740740741,5,378,234,612
2023-12-20 03:29:10,0.19451388888888888,1,7,7,14
2023-12-19 15:17:33,0.035925925925925924,1,1,1,2
2023-12-19 18:30:04,0.3009375,3,23,13,36
2024-01-04 08:58:18,0.0634837962962963,1,44,30,74
2023-12-19 08:57:06,0.3607986111111111,1,2,2,4
2024-03-25 19:58:22,98.14881944444444,9,49018,49282,98300
2023-12-22 16:04:31,4.596736111111111,3,31,47,78
2023-12-19 09:02:56,1.369363425925926,10,234,206,440
2023-12-19 16:47:03,1.9185300925925926,2,72,51,123
2023-12-16 10:00:58,0.5614930555555555,1,1,1,2
2023-12-21 19:52:42,7.578703703703703,15,127,32,159
2023-12-14 13:04:15,0.4960185185185185,1,2,2,4
2023-12-14 10:15:28,0.4318402777777778,1,0,51,51
2023-12-14 01:42:22,0.08938657407407408,2,12,2,14
2023-12-19 02:08:55,10.305891203703704,9,110,96,206
2023-12-14 01:48:59,0.7126736111111112,2,8,15,23
2024-01-19 17:00:01,37.376423611111115,4,34,24,58
2023-12-13 10:37:10,0.6661458333333333,8,9,631,640
2023-12-12 19:15:07,0.08118055555555556,1,7,22,29
2024-02-16 22:03:16,66.91467592592592,5,378,541,919
2024-01-05 20:10:16,27.9959375,4,1175,463,1638
2023-12-16 06:38:18,67.25423611111111,2,16944,14591,31535
2023-12-12 07:48:33,0.4040972222222222,2,76,67,143
2023-12-12 21:22:15,1.222210648148148,3,41,34,75
2023-12-12 21:34:01,1.2363541666666666,1,3,77,80
2023-12-21 02:57:26,10.18806712962963,7,94,612,706
2023-12-11 10:33:10,0.5121527777777778,2,4,251,255
2024-05-23 08:33:04,164.4365740740741,14,105848,92429,198277
2023-12-23 22:23:18,13.027418981481482,2,11,366,377
2023-12-10 17:56:21,0.026631944444444444,1,133,2,135
2023-12-14 12:46:42,5.265752314814815,14,969,311,1280
2024-01-07 23:11:05,29.339826388888888,9,16637,15522,32159
2024-01-10 16:00:48,32.12788194444445,5,28,11,39
2024-01-10 19:18:30,32.31723379629629,7,14143,13991,28134
2023-12-11 12:57:55,60.347997685185184,5,9681,5962,15643
2023-12-08 17:18:06,0.0796875,1,4,1,5
2023-12-08 18:01:27,0.04545138888888889,2,143,137,280
2023-12-08 13:31:19,0.005706018518518518,1,5,0,5
2023-12-08 14:53:29,0.14520833333333333,1,0,1,1
2023-12-07 06:00:29,0.08935185185185185,1,2,1,3
2023-12-09 04:08:55,57.22012731481482,6,12328,12305,24633
2023-12-07 06:35:24,0.35010416666666666,2,15,5,20
2023-12-06 14:24:09,1.1671064814814816,1,3,3,6
2023-12-04 23:23:39,0.06664351851851852,3,15,3,18
2024-01-29 21:02:47,422.43836805555554,29,10714,12863,23577
2024-01-11 20:43:15,38.572604166666665,22,9400,6069,15469
2023-12-10 17:53:18,7.035254629629629,8,998,72,1070
2024-03-20 12:01:01,107.77072916666667,3,51919,50825,102744
2023-12-03 11:11:38,0.6809143518518519,1,11,6,17
2023-12-02 13:54:44,0.03817129629629629,1,1,1,2
2023-12-07 16:33:15,5.180578703703704,6,325,268,593
2023-12-02 15:21:44,0.19927083333333334,1,19,19,38
2023-12-02 10:01:22,0.5077546296296296,1,3,2,5
2023-12-01 22:49:56,0.10039351851851852,2,13,2,15
2023-12-01 17:25:52,0.19467592592592592,2,161,167,328
2023-12-01 08:24:38,0.5347800925925926,1,19,19,38
2023-12-08 00:38:55,8.133541666666666,20,4146,2115,6261
2023-12-01 13:57:12,1.7112731481481482,1,8,8,16
2023-12-01 20:13:54,2.2630324074074073,4,33,24,57
2023-12-01 18:30:13,3.3450810185185187,8,76,18,94
2023-11-28 23:49:30,0.94875,1,2,1,3
2023-11-30 21:22:34,4.294930555555555,6,883,431,1314
2023-12-05 13:52:17,9.230659722222223,5,11506,11098,22604
2023-11-26 17:20:56,0.4712384259259259,2,8,2,10
2023-12-05 01:05:08,9.344328703703704,3,39,9,48
2023-11-25 10:06:54,0.07731481481481481,1,1,1,2
2023-11-25 04:39:12,0.22203703703703703,1,1,1,2
2023-11-25 17:42:16,0.857662037037037,1,3,1,4
2023-11-24 20:02:13,0.08776620370370371,1,1,0,1
2024-01-14 00:39:45,20.311469907407407,13,8531,9420,17951
2023-12-04 16:28:37,10.102488425925927,6,219,401,620
2023-11-24 17:41:30,0.6968171296296296,3,19,8,27
2023-11-26 17:52:41,3.119837962962963,1,32,5,37
2023-11-23 10:22:49,0.019918981481481482,1,4,1,5
2023-12-06 22:15:59,13.871273148148148,4,1170,570,1740
2023-11-23 18:05:49,1.1397337962962963,2,23,6,29
2023-11-22 21:06:05,0.41587962962962965,3,49,13,62
2023-11-21 19:20:08,0.12513888888888888,1,3,0,3
2023-11-20 21:44:27,0.36483796296296295,1,8,8,16
2023-11-20 08:09:23,0.016550925925925927,1,2,2,4
2024-04-11 20:32:58,144.13716435185185,13,59303,54824,114127
2024-01-04 20:18:12,57.214131944444446,31,8829,10992,19821
2023-11-19 19:58:34,0.09028935185185186,1,69,1,70
2023-11-19 13:28:47,0.05402777777777778,1,1,1,2
2024-01-02 18:38:29,46.330243055555556,1,24,26,50
2023-11-22 15:47:46,5.223888888888889,1,5,5,10
2024-02-03 16:54:35,78.82784722222222,8,31266,30073,61339
2024-03-02 16:42:41,106.826875,7,48197,48631,96828
2023-11-16 22:55:52,0.16578703703703704,2,20,14,34
2023-11-16 11:45:22,0.054363425925925926,1,0,2,2
2023-11-17 10:42:56,1.0225694444444444,3,58,58,116
2023-11-16 20:52:19,0.8895601851851852,5,127,126,253
2023-11-16 23:42:09,1.1848148148148148,2,6,6,12
2023-11-15 18:40:35,0.030069444444444444,1,3,3,6
2023-11-15 21:07:49,7.193877314814815,2,4,3,7
2023-11-15 16:34:18,0.8152314814814815,4,11,5,16
2023-11-14 18:14:20,0.05939814814814815,1,1,1,2
2023-11-21 18:18:59,8.078611111111112,3,440,631,1071
2023-11-21 23:18:46,8.241631944444444,12,812,537,1349
2023-11-14 21:10:28,6.2090856481481485,3,12,6,18
2023-12-02 19:54:59,20.836145833333333,8,2715,1965,4680
2023-11-10 23:35:42,0.05497685185185185,1,7,6,13
2023-11-10 23:49:54,0.08744212962962963,1,21,18,39
2023-11-10 22:27:27,0.047233796296296295,1,6,4,10
2023-11-22 17:06:03,12.654432870370371,3,42,42,84
2023-11-13 15:07:50,4.983611111111111,3,6,4,10
2023-11-14 18:42:12,4.2200347222222225,3,6,5,11
2023-11-10 19:46:53,2.1413657407407407,3,6,2,8
2023-11-10 00:30:45,0.039074074074074074,1,1,0,1
2023-11-26 06:31:27,17.36601851851852,2,120,21,141
2024-01-28 23:14:15,82.21481481481482,17,801,625,1426
2023-11-09 09:07:19,0.6072916666666667,1,23,23,46
2023-11-09 18:40:58,1.1364699074074074,2,2,2,4
2023-11-08 20:24:10,0.8521527777777778,3,6,3,9
2023-11-08 09:34:59,0.4052546296296296,2,25,4,29
2024-01-08 17:05:18,61.983715277777776,12,846,156,1002
2023-12-06 22:48:30,51.72006944444445,5,1561,1314,2875
2023-11-09 23:50:06,2.76125,2,4,4,8
2023-12-03 10:57:01,26.34818287037037,21,1603,955,2558
2023-11-10 16:26:07,3.8577083333333335,5,114,45,159
2023-11-05 17:17:50,258.7185300925926,1,285,108,393
2023-11-11 23:34:10,8.27875,6,264,18,282
2023-11-08 13:59:39,5.048472222222222,2,42,86,128
2023-11-14 20:21:21,11.935104166666667,3,17,15,32
2023-11-02 21:40:55,0.005462962962962963,1,1,1,2
2023-11-01 22:34:44,0.07114583333333334,1,5,2,7
2023-11-06 23:27:58,6.209409722222222,2,43,24,67
2023-10-30 14:39:25,0.12333333333333334,1,3,3,6
2023-10-31 12:02:57,1.7765277777777777,1,3,0,3
2023-10-28 15:12:42,0.18516203703703704,1,7,7,14
2023-11-28 17:00:23,33.816261574074076,21,251,236,487
2023-10-28 21:09:23,1.0151157407407407,1,3,3,6
2023-10-27 15:32:11,0.07679398148148148,1,1,4,5
2023-10-27 16:51:26,0.22244212962962964,1,10,3,13
2023-11-01 05:31:18,6.431493055555555,14,432,360,792
2023-10-30 05:43:20,4.485347222222222,7,35,14,49
2023-10-25 03:24:58,0.18083333333333335,1,1,1,2
2023-10-24 15:46:22,0.04020833333333333,1,1,1,2
2023-11-07 14:37:44,27.53763888888889,4,6790,9445,16235
2023-10-23 17:52:41,0.3681597222222222,3,8,5,13
2023-11-07 18:51:42,15.8278125,14,1484,668,2152
2023-10-22 13:28:28,0.005902777777777778,1,1,1,2
2023-10-26 06:08:56,4.32724537037037,2,12,9,21
2023-10-20 17:10:13,0.34716435185185185,1,6,6,12
2023-10-29 15:57:30,9.716574074074074,4,60,111,171
2023-10-21 16:27:24,1.9765625,3,11,4,15
2023-10-19 21:14:30,0.2558796296296296,1,1,0,1
2023-11-08 23:22:50,20.37585648148148,5,16,7,23
2023-10-21 09:33:41,3.349502314814815,4,45,41,86
2023-10-18 03:41:48,0.3595138888888889,1,6,3,9
2023-10-18 08:24:46,0.6593981481481481,6,13,13,26
2023-10-18 10:54:17,2.000659722222222,1,25,60,85
2023-10-23 20:39:35,7.524178240740741,1,14,15,29
2023-10-19 20:46:41,3.6530787037037036,2,90,712,802
2023-10-16 10:12:14,0.5989814814814814,2,3,2,5
2023-10-18 07:46:24,2.621423611111111,2,7,596,603
2023-11-19 10:45:57,39.58556712962963,21,7721,9643,17364
2023-10-15 08:44:21,2.4778587962962964,3,83,125,208
2023-10-13 22:07:48,0.6661689814814815,2,21,6,27
2023-10-13 08:13:44,0.43982638888888886,1,3,0,3
2023-10-12 15:45:21,0.09289351851851851,1,1,1,2
2023-10-19 16:35:13,10.665960648148149,2,6257,8393,14650
2023-10-11 11:23:48,0.11792824074074074,2,21,23,44
2023-10-24 09:14:06,14.719201388888889,3,14,7,21
2023-10-11 15:08:42,3.9068055555555556,1,8,66,74
2023-10-11 20:10:31,4.884560185185185,2,6192,8377,14569
2023-10-11 16:15:57,5.965601851851852,1,13,2,15
2023-10-16 12:57:46,10.845439814814815,4,12,7,19
2023-10-05 05:50:52,0.09503472222222223,1,10,10,20
2023-10-05 06:14:34,0.25677083333333334,1,1,6,7
2023-10-05 11:04:42,0.5509375,4,56,58,114
2023-10-03 19:01:13,0.40372685185185186,4,16,10,26
2023-10-15 18:28:11,12.476527777777777,4,7306,8856,16162
2023-10-04 03:59:33,2.0945601851851854,10,149,238,387
2023-10-17 16:43:20,15.810671296296297,5,31,18,49
2023-10-01 22:11:10,0.05416666666666667,1,1,1,2
2023-10-14 16:53:39,12.86976851851852,4,47,18,65
2023-10-03 07:54:42,1.573611111111111,2,22,51,73
2023-10-01 06:44:24,0.3135648148148148,2,3,3,6
2023-10-03 01:36:28,2.4925810185185187,2,23,1,24
2023-09-30 03:18:55,0.6921643518518519,1,2,2,4
2023-09-30 16:34:02,2.316226851851852,2,100,3576,3676
2023-09-28 10:01:14,0.3616087962962963,1,83,1,84
2023-09-27 21:19:28,0.046550925925925926,1,5,3,8
2023-09-27 19:58:23,0.004629629629629629,1,22,22,44
2023-09-27 19:59:54,0.025104166666666667,1,7,7,14
2023-09-27 17:52:17,0.0031944444444444446,1,1,1,2
2023-10-02 18:47:49,5.146446759259259,3,156,124,280
2023-09-29 19:04:14,3.1528125,2,20,1,21
2023-09-26 04:13:56,0.07283564814814815,1,1,1,2
2023-10-02 01:37:02,6.232731481481482,2,42,16,58
2023-11-11 21:44:38,47.06959490740741,7,129,169,298
2023-09-26 16:14:55,1.2437152777777778,4,183,23,206
2023-09-25 13:10:07,0.21640046296296298,1,2,4,6
2023-09-25 16:48:08,0.8235763888888888,3,8,10,18
2023-09-28 10:10:45,3.562939814814815,2,273,273,546
2023-09-25 07:00:17,0.47770833333333335,1,1,1,2
2023-09-29 12:40:05,4.731527777777778,2,113,38,151
2023-09-25 16:28:18,1.1291666666666667,1,1,0,1
2023-09-25 22:10:20,1.4949768518518518,1,14,5,19
2023-11-30 21:07:56,57.75636574074074,10,482,289,771
2023-09-25 19:39:36,2.113587962962963,2,10,7,17
2023-09-23 22:56:46,3.386111111111111,1,2,5,7
2023-10-11 15:44:41,21.068148148148147,7,6254,8393,14647
2023-09-23 14:43:14,1.0287037037037037,1,69,80,149
2023-09-22 18:23:08,0.23184027777777777,1,1,0,1
2023-09-21 23:55:50,0.10072916666666666,3,32,1,33
2023-09-21 17:32:43,0.05550925925925926,1,1,1,2
2023-09-22 21:31:46,1.3960416666666666,1,1,0,1
2023-09-21 07:41:20,0.48311342592592593,1,35,0,35
2023-09-20 17:42:00,0.29159722222222223,4,564,663,1227
2023-09-25 18:16:31,5.988148148148148,2,2726,1262,3988
2023-09-23 14:30:01,3.837962962962963,1,7,7,14
2023-09-20 16:09:18,0.9997685185185186,1,7,7,14
2023-09-19 20:15:39,0.1820138888888889,1,2,88,90
2023-09-26 15:18:22,6.989976851851852,7,69,136,205
2023-09-25 21:52:06,6.283680555555556,1,8,12,20
2023-09-23 11:24:22,3.8550925925925927,1,49,41,90
2023-09-20 07:42:42,0.943113425925926,4,11,3,14
2023-09-28 21:01:46,10.572083333333333,6,43,8,51
2024-04-25 20:46:38,250.0129398148148,17,48696,33293,81989
2023-09-17 19:58:55,0.11668981481481482,1,8,6,14
2023-09-28 10:31:23,11.607870370370371,8,184,161,345
2023-09-16 06:42:46,0.43149305555555556,1,12,28,40
2023-09-14 18:30:27,0.09511574074074074,1,2,2,4
2023-09-15 00:00:00,0.36961805555555555,1,2,2,4
2023-09-14 03:55:04,0.41310185185185183,1,20,49,69
2023-09-14 00:59:09,0.3408217592592593,1,2,1,3
2023-09-13 14:53:16,0.010335648148148148,1,7,7,14
2023-09-13 16:46:54,0.10556712962962964,1,8,30,38
2023-09-13 10:13:45,0.046342592592592595,1,8,8,16
2023-09-12 23:42:51,0.006863425925925926,1,6,0,6
2023-09-12 18:49:54,0.0035185185185185185,1,5,4,9
2023-09-12 13:21:55,0.10952546296296296,1,4,4,8
2023-09-26 18:31:14,17.57525462962963,10,29267,6494,35761
2023-09-23 14:46:24,11.775416666666667,1,3,1,4
2023-09-11 17:33:11,0.059953703703703703,1,1,1,2
2023-09-11 05:39:27,4.576504629629629,6,253,103,356
2023-09-15 13:26:35,5.35755787037037,12,486,194,680
2023-09-10 23:55:56,1.8585069444444444,1,25,10,35
2023-09-20 14:40:08,12.669456018518519,7,56,23,79
2023-09-07 21:44:34,0.10506944444444444,1,55,57,112
2023-09-07 16:50:06,0.008483796296296297,1,1,1,2
2023-09-07 16:52:12,0.016944444444444446,1,5,5,10
2023-09-07 18:15:36,0.09949074074074074,1,0,4,4
2023-09-07 16:27:26,0.03550925925925926,1,4,4,8
2023-09-07 14:16:23,0.09466435185185185,1,4,2,6
2023-09-22 07:41:44,15.488599537037038,1,28,1,29
2023-09-07 16:49:13,0.9376388888888889,3,11,3,14
2023-09-06 14:50:49,0.01738425925925926,1,1,1,2
2023-09-08 16:21:16,2.0930439814814816,1,7,30,37
2023-09-06 16:58:57,0.15969907407407408,1,12,10,22
2023-09-08 17:14:48,2.1749537037037037,1,2,2,4
2023-09-06 22:37:21,14.232129629629629,6,41,25,66
2023-09-11 22:23:27,6.3705439814814815,20,323,153,476
2023-09-07 17:11:15,2.1743402777777776,3,4,3,7
2023-09-05 13:28:45,0.20422453703703702,1,1,1,2
2023-09-05 14:01:11,1.0620717592592592,4,17,3,20
2023-09-03 22:48:08,0.10126157407407407,1,6,4,10
2023-09-02 19:31:29,0.4027777777777778,4,17,4,21
2023-10-19 23:19:04,47.637511574074075,9,1483,1405,2888
2023-10-16 10:25:13,44.6087037037037,1,7,31,38
2023-12-05 13:50:39,102.4167013888889,30,950,567,1517
2023-09-01 17:56:56,0.5244791666666667,4,49,61,110
2023-09-01 08:38:28,0.7698148148148148,1,2,2,4
2023-08-31 11:35:09,0.07671296296296297,1,2,2,4
2023-08-30 20:18:40,0.08728009259259259,1,11,25,36
2023-08-30 16:41:48,0.23484953703703704,1,7,6,13
2023-09-04 22:46:57,6.221759259259259,2,53,0,53
2023-09-06 05:15:15,7.647627314814815,2,16,6,22
2023-08-29 06:49:40,0.04101851851851852,1,1,1,2
2023-08-28 21:49:40,0.2119675925925926,1,7,7,14
2023-09-08 07:13:40,11.545659722222222,15,110,79,189
2023-08-28 09:10:35,1.2483912037037037,2,17,10,27
2023-08-27 04:21:30,0.6710995370370371,1,2,2,4
2023-08-27 04:31:42,0.46434027777777775,1,5,5,10
2023-08-26 12:51:14,0.10142361111111112,3,23,22,45
2023-08-26 03:10:28,0.18741898148148148,1,2,2,4
2023-08-25 22:16:04,0.047002314814814816,1,3,3,6
2023-08-28 07:41:55,2.9207638888888887,3,39,10,49
2023-09-06 15:59:01,12.383425925925925,4,182,52,234
2023-08-25 06:06:42,0.3869675925925926,3,321,2025,2346
2023-08-24 21:24:05,0.2888541666666667,1,2,0,2
2023-08-24 21:27:57,0.40998842592592594,1,1,0,1
2023-08-23 23:58:22,0.6004166666666667,1,73,27,100
2023-08-23 02:33:32,0.11,1,4,11,15
2023-08-25 17:44:21,2.962974537037037,1,32,1,33
2023-08-22 20:48:46,0.054328703703703705,1,16,15,31
2023-08-23 15:21:16,1.108460648148148,1,62,62,124
2023-08-22 05:23:12,0.7067708333333333,1,22,37,59
2023-08-22 05:52:51,0.9014351851851852,2,95,28,123
2023-08-28 10:25:58,9.061261574074074,8,116,58,174
2023-08-20 09:03:50,0.08731481481481482,3,17,4,21
2023-08-20 06:51:15,0.1500462962962963,1,27,4,31
2023-08-19 21:27:06,0.2161574074074074,1,13,2,15
2023-08-19 09:33:42,0.890162037037037,2,24,19,43
2023-08-19 18:27:08,1.3313194444444445,2,12,4,16
2023-08-18 19:08:53,0.40392361111111114,2,11,18,29
2023-08-18 09:25:42,0.4003125,1,89,1,90
2023-08-20 06:42:59,2.4271875,5,104,53,157
2023-08-18 13:28:06,1.9429166666666666,5,360,362,722
2023-08-16 13:24:15,0.11144675925925926,1,2,2,4
2023-08-16 15:26:38,0.22068287037037038,1,6,0,6
2023-08-16 09:13:00,0.13234953703703703,1,0,5,5
2023-08-15 21:20:41,0.09628472222222222,1,10,24,34
2023-08-15 21:58:50,0.6248726851851852,2,13,153,166
2023-08-15 06:22:52,0.4204398148148148,1,1,1,2
2023-08-14 15:12:36,0.009456018518518518,1,1,1,2
2023-08-15 06:27:47,0.846087962962963,2,2428,337,2765
2023-08-14 15:29:14,0.37918981481481484,1,2,2,4
2023-08-24 17:49:41,15.625462962962963,6,740,27,767
2023-08-24 06:02:59,11.4646875,33,3915,1310,5225
2023-08-17 00:03:40,4.4819560185185185,2,14,14,28
2023-08-12 17:42:37,0.43201388888888886,2,11,3,14
2023-08-12 06:23:19,0.03037037037037037,3,7,1,8
2023-08-24 11:23:14,43.91273148148148,7,34,29,63
2023-09-06 18:48:52,25.812071759259258,11,9513,4159,13672
2023-08-12 05:50:44,0.3071064814814815,1,1,1,2
2023-08-11 17:53:48,0.023668981481481482,1,1,1,2
2023-08-11 15:35:46,0.08364583333333334,1,8,8,16
2023-08-16 10:27:16,15.85273148148148,5,5816,1566,7382
2023-08-14 16:36:25,0.8231597222222222,1,1,1,2
2023-08-09 20:27:36,0.2740740740740741,1,1,1,2
2023-08-10 10:01:56,1.5506134259259259,7,128,147,275
2023-08-08 16:28:28,0.3332986111111111,1,15,1,16
2023-08-07 23:23:44,1.4864351851851851,2,3081,727,3808
2023-09-17 02:45:07,40.44340277777778,26,15281,6318,21599
2023-09-04 17:33:52,31.004803240740742,7,9329,4042,13371
2023-08-05 21:10:41,1.5125462962962963,1,64,36,100
2023-08-07 00:44:56,3.015115740740741,7,72,28,100
2023-08-03 17:53:11,0.0372337962962963,1,1,1,2
2023-08-06 17:16:49,3.0225925925925927,1,8,0,8
2023-08-03 17:20:15,0.1337962962962963,1,1,1,2
2023-08-03 12:41:48,0.15457175925925926,1,1,0,1
2023-09-19 07:32:33,64.6751388888889,151,46910,16225,63135
2023-08-11 18:48:23,9.446469907407407,1,26,6,32
2023-08-01 19:48:20,0.2011574074074074,2,3,1,4
2023-08-03 07:40:16,1.8128935185185184,2,5,6,11
2023-12-04 23:16:14,125.56123842592592,1,2,2,4
2023-08-03 05:40:44,2.269849537037037,2,13,6,19
2023-08-01 07:21:05,0.3610069444444444,1,15,0,15
2023-08-07 22:42:07,19.526851851851852,8,4199,1069,5268
2023-07-31 01:34:51,0.04131944444444444,1,3,3,6
2023-08-28 17:31:43,29.20140046296296,12,10439,4671,15110
2023-08-02 09:24:03,3.229398148148148,14,206,126,332
2023-08-17 05:36:29,20.58534722222222,14,3331,913,4244
2023-08-03 16:45:07,21.00579861111111,18,2061,697,2758
2023-07-27 15:00:37,0.06553240740740741,1,2,2,4
2023-07-30 05:25:06,10.849641203703703,5,3036,908,3944
2023-07-28 05:10:53,8.822974537037037,4,2916,786,3702
2023-07-27 15:43:01,1.27625,3,22,18,40
2023-08-12 06:46:54,17.504583333333333,9,596,73,669
2023-07-25 15:49:33,0.006608796296296297,1,1,1,2
2023-07-25 12:42:37,0.014525462962962962,1,2,2,4
2023-07-25 05:10:06,0.061099537037037036,1,11,16,27
2023-07-25 02:09:48,0.05684027777777778,1,1,1,2
2023-08-17 00:03:05,23.17734953703704,4,1672,407,2079
2023-07-27 16:53:50,2.991909722222222,4,120,78,198
2023-10-05 21:55:26,73.19256944444444,114,37921,8994,46915
2023-07-26 16:22:18,2.2491550925925927,3,47,53,100
2023-07-24 08:54:18,0.20521990740740742,3,25,6,31
2023-08-04 15:24:11,11.82375,8,233,51,284
2023-07-29 00:11:57,5.238541666666666,1,7,3,10
2023-07-29 00:03:34,5.807708333333333,3,23,18,41
2023-07-25 08:30:47,2.3236226851851853,3,11,5,16
2023-07-22 22:46:52,0.12123842592592593,1,1,1,2
2023-07-22 11:50:20,1.1702546296296297,19,76,52,128
2023-07-22 16:42:30,14.344293981481481,1,7,7,14
2023-07-22 16:37:27,14.317037037037037,1,10,5,15
2023-07-22 16:46:55,14.337256944444444,1,29,8,37
2023-07-23 04:25:34,14.836805555555555,1,12,6,18
2023-07-22 17:47:43,14.395416666666666,1,33,27,60
2023-07-24 04:14:41,1.8500810185185186,1,2,28,30
2023-09-06 23:32:43,47.09625,9,13456,5364,18820
2023-08-12 01:29:55,21.241041666666668,3,74,65,139
2023-08-21 15:52:20,31.428958333333334,22,4318,1425,5743
2024-05-15 07:52:55,299.3396759259259,21,1313,982,2295
2023-07-21 01:05:45,0.4482291666666667,2,16,15,31
2023-09-11 07:03:44,53.152314814814815,1,46,0,46
2023-08-23 05:15:02,34.364583333333336,3,95,44,139
2023-07-24 04:26:55,4.814606481481482,3,64,85,149
2023-07-19 14:27:58,0.07685185185185185,1,66,14,80
2023-08-16 14:43:03,28.430960648148147,4,167,61,228
2023-07-19 13:48:03,1.6742824074074074,3,854,760,1614
2023-07-18 18:42:20,0.05017361111111111,2,5,5,10
2023-07-19 15:24:45,1.2674652777777777,2,11,4,15
2023-07-17 17:35:54,0.01855324074074074,1,1,1,2
2023-09-11 13:37:21,83.78008101851852,8,1592,1027,2619
2023-07-20 21:25:44,4.182858796296296,2,14,4,18
2023-07-16 20:58:36,0.2973032407407407,3,8,5,13
2023-08-28 17:52:10,43.85347222222222,10,264,57,321
2023-07-22 19:39:45,8.979039351851851,14,156,137,293
2023-07-15 17:38:51,0.004803240740740741,1,3,0,3
2023-07-16 15:30:12,0.9377662037037037,7,57,28,85
2023-07-17 16:54:00,2.033599537037037,2,118,46,164
2023-07-15 16:27:44,0.033414351851851855,1,2,2,4
2023-07-16 11:31:43,17.86484953703704,5,25,13,38
2023-07-13 17:09:44,0.09259259259259259,1,4,0,4
2023-07-13 07:30:18,1.048113425925926,2,56,18,74
2023-09-04 15:50:32,54.548680555555556,11,422,242,664
2023-07-12 00:03:59,0.13697916666666668,3,85,59,144
2023-08-06 22:26:08,26.302881944444444,1,72,63,135
2023-07-11 20:01:02,0.3319212962962963,2,66,140,206
2023-07-11 15:11:13,0.07854166666666666,1,12,14,26
2023-07-10 15:43:39,0.07893518518518519,1,13,13,26
2023-07-10 17:23:03,0.2752777777777778,1,1,97,98
2023-08-04 14:02:49,25.20652777777778,10,179,73,252
2023-08-24 20:46:18,46.063854166666665,1,26,10,36
2023-07-09 18:42:03,0.5933101851851852,1,16,2,18
2023-07-09 07:22:46,0.3247569444444444,1,17,17,34
2023-08-24 20:48:01,46.93326388888889,1,271,2000,2271
2023-07-22 07:58:10,14.043472222222222,3,79,12,91
2023-07-08 11:25:58,0.6562731481481482,1,24,15,39
2023-07-13 06:11:15,5.547685185185185,2,34,16,50
2023-07-15 10:28:02,8.564560185185185,9,126,105,231
2023-07-12 14:49:05,6.305671296296296,2,27,4,31
2023-07-07 15:23:00,1.7567592592592594,1,7,1,8
2023-07-17 18:38:03,11.971689814814814,5,38,28,66
2023-07-18 17:38:16,27.030671296296298,19,3767,2389,6156
2024-02-29 12:19:03,238.8973263888889,6,97740,63562,161302
2023-07-09 20:49:17,5.129571759259259,2,17,18,35
2023-08-03 04:54:34,29.351388888888888,7,12672,2115,14787
2023-07-12 22:25:01,8.181331018518518,3,81,6,87
2023-07-05 22:06:56,1.3840277777777779,4,124,35,159
2023-07-17 23:53:18,13.540324074074075,8,187,59,246
2023-07-05 14:54:35,1.2281018518518518,8,154,34,188
2023-07-03 20:54:14,0.008541666666666666,1,2,1,3
2023-07-04 05:29:17,0.4437037037037037,1,5,1,6
2023-07-03 21:59:22,0.2563078703703704,5,52,12,64
2023-07-03 21:55:13,0.3255208333333333,2,33,1,34
2023-07-03 21:40:57,0.41238425925925926,2,18,0,18
2023-07-05 16:00:12,2.195775462962963,4,35,28,63
2023-07-07 17:53:49,4.508877314814815,8,35,21,56
2023-07-28 11:55:57,33.246180555555554,26,16027,4115,20142
2023-07-06 14:55:25,3.7378935185185185,3,10,3,13
2023-07-02 19:35:37,0.0884837962962963,1,1,1,2
2023-07-02 20:25:48,0.14050925925925925,1,31,0,31
2023-07-04 00:41:46,2.1075925925925927,3,19,7,26
2023-07-02 03:48:49,0.6489699074074075,1,2,2,4
2023-07-03 21:14:37,2.3753125,1,7,1,8
2023-07-07 14:42:59,6.153923611111111,3,28,8,36
2023-07-27 00:11:49,26.24375,8,12959,2214,15173
2023-06-30 20:13:45,0.8817476851851852,2,2,1,3
2023-06-29 21:12:41,0.13195601851851851,1,14,2,16
2023-06-29 11:28:25,0.0412037037037037,1,1,1,2
2023-06-28 23:40:33,0.009930555555555555,1,50,1,51
2023-07-12 19:58:56,13.881956018518519,5,24,24,48
2023-06-28 22:52:44,0.08239583333333333,1,1,1,2
2023-07-11 00:38:40,12.160289351851851,1,34,4,38
2023-06-28 16:58:19,0.039907407407407405,1,1,2,3
2023-06-30 06:26:08,1.6203472222222222,8,43,23,66
2023-06-27 19:34:52,0.0052893518518518515,1,1,1,2
2023-06-30 02:03:34,3.1240972222222223,9,47,28,75
2023-06-27 10:00:38,0.45935185185185184,1,29,5,34
2023-06-27 20:32:23,0.9318518518518518,3,52,41,93
2023-06-30 00:36:23,5.159074074074074,4,67,10,77
2023-06-27 09:58:12,0.6059027777777778,2,35,23,58
2023-06-26 17:50:00,0.07686342592592593,1,6,5,11
2023-06-28 01:42:57,1.4305671296296296,5,47,15,62
2023-06-27 21:18:22,0.9653240740740741,3,21,3,24
2023-06-25 21:18:28,0.02179398148148148,1,79,45,124
2023-06-25 21:29:55,0.23599537037037038,1,2,1,3
2023-08-01 03:58:03,36.74489583333333,12,15949,3776,19725
2023-06-28 10:36:58,3.3271180555555557,3,40,5,45
2023-06-25 06:21:39,0.5291435185185185,1,1,1,2
2023-06-25 07:26:17,0.5942592592592593,1,1,1,2
2023-06-24 05:10:27,0.058275462962962966,1,2,1,3
2023-06-23 20:41:28,0.9458101851851852,3,7,3,10
2023-06-30 12:35:26,8.612638888888888,10,623,384,1007
2023-06-22 20:02:11,0.009247685185185185,1,3,0,3
2023-06-23 21:27:04,1.170787037037037,3,63,43,106
2023-06-26 22:13:52,4.44212962962963,3,20,19,39
2023-06-22 05:35:30,0.05974537037037037,1,2,2,4
2023-06-22 11:16:25,0.5577662037037037,1,37,11,48
2023-06-23 19:38:56,1.9338194444444445,1,1,0,1
2023-06-21 17:42:09,0.029201388888888888,1,2,7,9
2023-08-28 16:00:25,68.18924768518518,5,23864,6188,30052
2023-06-21 04:49:38,0.042986111111111114,1,1,1,2
2023-06-23 15:29:07,2.691597222222222,5,17,26,43
2023-06-20 21:03:55,0.20032407407407407,2,3,3,6
2023-06-20 22:56:48,0.5593171296296297,1,2,3,5
2023-08-24 20:54:05,66.02291666666666,1,15,9,24
2023-06-22 11:10:22,2.6401967592592595,1,1,1,2
2023-06-19 09:24:28,0.5320833333333334,3,25,12,37
2023-06-19 09:28:18,0.5455902777777778,1,5,5,10
2023-06-20 23:01:00,2.1394212962962964,2,5,2,7
2023-06-18 20:09:28,0.03951388888888889,1,1,1,2
2023-06-21 22:16:29,3.170324074074074,11,121,59,180
2023-09-28 21:12:32,103.07134259259259,2,4,4,8
2023-06-19 02:59:33,1.3480092592592592,1,2,5,7
2023-06-18 19:15:09,1.1401620370370371,2,8,10,18
2023-06-16 22:45:42,0.13157407407407407,3,13,3,16
2023-07-21 06:36:08,34.703090277777775,4,15914,7201,23115
2023-08-02 07:02:19,47.32262731481482,2,25,12,37
2023-06-16 08:05:09,5.2759837962962965,1,79,11,90
2023-06-16 07:31:19,1.4691550925925927,5,564,799,1363
2023-06-14 20:37:56,0.06622685185185186,1,1,0,1
2023-06-29 09:44:15,14.759421296296296,6,676,931,1607
2023-06-14 19:04:31,0.38708333333333333,2,127,112,239
2023-06-14 19:28:17,0.4487962962962963,1,15,1,16
2023-06-14 06:19:49,0.29430555555555554,1,1,1,2
2023-07-08 19:57:52,24.97851851851852,10,150,248,398
2023-07-12 12:22:22,82.06438657407408,119,26784,18875,45659
2023-06-13 12:25:27,0.006446759259259259,1,1,1,2
2023-06-13 11:49:10,0.18070601851851853,1,3,4,7
2023-06-13 14:32:44,0.8976736111111111,2,37,4,41
2023-06-12 14:11:56,0.12074074074074075,1,1,1,2
2023-06-12 10:53:19,0.7023495370370371,6,54,53,107
2023-06-12 02:12:10,0.3577546296296296,1,5,2,7
2023-06-11 08:20:20,0.5634490740740741,1,1,1,2
2023-06-12 10:56:35,2.658634259259259,1,1,1,2
2023-06-10 09:29:20,0.7865162037037037,2,6,1,7
2023-08-27 22:05:44,84.79458333333334,99,26630,12910,39540
2023-07-04 17:05:56,32.79101851851852,6,5834,6618,12452
2023-07-02 20:29:22,25.306342592592593,7,93,55,148
2023-06-07 02:04:43,0.10253472222222222,2,5,2,7
2023-06-06 20:55:15,0.057777777777777775,1,4,4,8
2023-06-12 23:22:42,7.0339583333333335,2,47,31,78
2023-06-05 10:55:38,0.10219907407407407,1,1,1,2
2023-09-15 17:38:52,104.70459490740741,54,45767,9109,54876
2023-06-14 06:19:20,9.325856481481482,2,3,12,15
2023-06-05 10:07:45,0.5150925925925925,1,2,2,4
2023-06-22 10:54:43,18.887569444444445,9,3081,4915,7996
2023-06-26 08:14:26,22.768958333333334,6,372,274,646
2023-06-04 19:25:48,1.2319560185185185,1,2,4,6
2023-06-02 21:46:06,0.33524305555555556,2,17,121,138
2023-06-03 14:37:25,1.078287037037037,2,50,15,65
2023-06-05 00:40:16,2.625798611111111,5,41,37,78
2023-06-15 17:22:22,13.355636574074074,4,20,18,38
2023-06-03 08:41:55,1.5471875,2,5,19,24
2023-06-01 20:43:49,0.09443287037037038,3,23,190,213
2023-07-23 20:00:34,52.15982638888889,2,43,15,58
2023-06-01 16:30:33,0.07689814814814815,1,1,1,2
2023-06-01 17:49:03,0.18439814814814814,2,75,35,110
2023-06-01 08:33:45,0.14628472222222222,3,23,1,24
2023-06-05 10:15:35,4.699467592592592,1,6,3,9
2023-05-31 22:19:41,0.05708333333333333,2,3,3,6
2023-06-01 20:00:27,1.2471064814814814,2,30,3,33
2023-05-30 19:26:04,0.09003472222222222,2,2,24,26
2023-05-30 16:42:05,0.3100810185185185,1,16,4,20
2023-06-01 06:29:39,1.9200462962962963,2,23,1,24
2023-05-30 17:05:53,0.4510416666666667,1,7,4,11
2023-05-29 21:33:42,0.23690972222222223,1,132,2,134
2023-06-12 19:46:10,16.13212962962963,17,501,347,848
2023-06-10 12:27:15,13.545416666666666,3,132,602,734
2023-05-29 21:31:00,3.168159722222222,6,1236,224,1460
2023-05-27 00:55:49,0.02476851851851852,1,16,0,16
2023-08-23 04:55:20,88.46201388888889,18,24419,10282,34701
2023-05-28 06:20:42,1.286886574074074,6,88,207,295
2023-06-23 15:04:52,27.68028935185185,1,25,20,45
2023-05-31 05:11:36,4.275023148148148,2,3,41,44
2023-05-27 01:14:33,0.24270833333333333,2,12,6,18
2023-05-26 22:22:13,0.13913194444444443,2,20,1,21
2023-06-02 08:56:55,6.602650462962963,1,5,0,5
2023-05-27 00:02:18,0.25851851851851854,3,36,31,67
2023-05-26 14:55:09,0.049930555555555554,1,3,2,5
2023-05-26 16:02:16,0.10695601851851852,1,1,0,1
2023-05-26 16:25:24,0.6644097222222223,1,4,3,7
2023-08-12 01:37:40,77.35527777777777,13,126,60,186
2023-05-26 07:06:00,0.30083333333333334,1,9,2,11
2023-05-27 00:03:57,1817.1335416666666,13,78789,32040,110829
2023-12-14 20:46:47,203.0305439814815,4,71505,31994,103499
2023-05-25 21:34:49,0.05453703703703704,1,21,20,41
2023-05-27 00:07:50,1.1683101851851851,9,68,27,95
2023-05-27 01:15:32,1.2570023148148148,11,152,56,208
2023-05-25 20:32:09,0.07721064814814815,2,64,17,81
2023-05-25 20:37:18,0.5446064814814815,3,31,21,52
2023-05-26 16:04:36,1.3912615740740741,8,383,349,732
2023-12-23 00:18:11,67.95193287037037,20,12290,7469,19759
2023-05-26 18:09:38,2.7661226851851852,16,1123,584,1707
2023-05-25 00:59:06,0.1090625,2,3,1,4
2023-05-24 22:03:14,0.05884259259259259,2,1,5,6
2023-05-25 11:56:58,0.7489467592592592,9,445,418,863
2023-05-24 19:47:25,0.08832175925925925,1,1,1,2
2023-05-24 22:13:47,0.9738194444444445,3,216,16,232
2023-05-23 18:25:27,0.08072916666666667,1,29,30,59
2023-05-24 19:34:28,1.7920833333333333,5,543,182,725
2023-05-24 16:41:35,1.7145023148148149,14,184,105,289
2023-05-23 19:51:54,0.07327546296296296,1,7,2,9
2023-05-24 00:15:11,0.9999768518518518,8,314,109,423
2023-05-23 16:50:25,0.7359837962962963,3,20,13,33
2023-05-26 17:44:22,3.9809027777777777,2,9,9,18
2023-05-22 19:06:46,0.049166666666666664,1,11,10,21
2023-05-24 17:39:06,2.2368402777777776,2,16,3,19
2023-05-23 12:24:29,1.0662731481481482,2,28,2,30
2023-05-22 19:31:58,0.3769212962962963,1,6,5,11
2023-06-08 22:19:30,17.589849537037036,9,73,31,104
2023-06-01 11:34:31,10.965983796296296,2,29,9,38
2023-05-20 20:59:24,0.12128472222222222,1,1,1,2
2023-06-08 00:19:16,189.30016203703704,21,1271,391,1662
2023-05-20 12:57:20,0.9757638888888889,3,25,7,32
2023-06-18 09:18:05,31.815613425925925,7,1104,3998,5102
2023-05-18 07:22:05,0.15297453703703703,2,3,7,10
2023-05-20 16:58:38,3.0190509259259257,2,15,3,18
2023-08-04 15:01:49,78.96590277777777,4,136,62,198
2023-06-19 04:56:06,33.106516203703706,4,8314,4617,12931
2023-05-17 10:54:01,0.45716435185185184,5,29,16,45
2023-05-22 19:27:20,5.480613425925926,7,110,7,117
2023-05-17 07:23:03,1.018877314814815,1,0,96,96
2023-07-13 05:49:09,58.241840277777776,3,96,59,155
2023-05-16 07:03:55,0.5628240740740741,1,70,34,104
2023-05-16 06:37:10,0.6727662037037037,1,22,27,49
2023-06-08 08:53:30,23.893969907407406,9,135,44,179
2023-05-16 07:03:32,1.0844212962962962,3,129,141,270
2023-05-15 14:08:17,0.3888888888888889,1,138,117,255
2023-05-15 07:53:55,0.2799074074074074,2,71,21,92
2023-05-15 07:58:53,0.4631712962962963,4,45,4,49
2023-05-14 17:54:18,0.29422453703703705,1,8,0,8
2023-05-14 17:56:26,0.3719560185185185,2,5,1,6
2023-05-13 17:28:47,0.06638888888888889,1,1,1,2
2023-05-14 11:12:11,1.560162037037037,4,94,23,117
2023-05-11 08:23:19,0.05724537037037037,2,238,11,249
2023-05-14 16:54:54,3.8197685185185186,3,35,3,38
2023-05-11 03:23:40,0.5677546296296296,1,6,15,21
2023-05-09 22:25:03,0.0028819444444444444,1,3,2,5
2023-05-14 08:04:36,5.384942129629629,7,50,34,84
2023-05-08 16:47:18,0.08849537037037038,1,12,7,19
2023-05-21 15:14:52,13.352719907407407,4,89,43,132
2023-05-15 16:47:11,7.715798611111111,4,1824,1144,2968
2023-05-09 00:03:48,1.1166435185185186,1,8,1,9
2023-05-08 16:04:42,0.9267592592592593,1,16,5,21
2023-05-10 13:17:59,5.638310185185185,7,159,124,283
2023-05-22 19:57:44,16.914247685185185,3,30,17,47
2023-05-17 16:47:23,12.765115740740741,12,817,1622,2439
2023-05-05 13:15:48,0.18578703703703703,1,15,15,30
2023-05-10 10:04:57,5.135393518518518,3,54,30,84
2023-05-04 15:20:53,0.06751157407407407,1,1,1,2
2023-05-05 05:32:55,0.6925578703703704,2,9,13,22
2023-05-05 07:31:50,1.0515046296296295,1,0,696,696
2023-05-26 17:20:12,42.05032407407408,10,12546,9242,21788
2023-05-03 19:07:30,0.27586805555555555,1,9,1,10
2023-05-11 02:00:31,7.917199074074074,7,48,105,153
2023-05-10 10:00:15,7.048055555555556,3,74,58,132
2023-05-03 16:37:10,0.35519675925925925,1,8,9,17
2023-05-03 21:07:44,241.06645833333334,4,38,50,88
2023-05-03 06:57:36,0.05493055555555556,1,7,1,8
2023-05-02 21:23:51,0.03981481481481482,1,1695,2054,3749
2023-05-02 23:12:57,0.46695601851851853,1,15,8,23
2023-05-02 14:52:51,0.13332175925925926,2,3,3,6
2023-05-02 14:07:02,0.11752314814814815,2,2,2,4
2023-05-01 10:05:47,0.5482523148148148,1,1,1,2
2023-05-05 08:46:39,5.033275462962963,2,872,1400,2272
2023-05-05 20:57:13,6.45550925925926,4,83,24,107
2023-04-29 19:21:05,0.44883101851851853,2,29,5,34
2023-05-02 21:46:47,4.992199074074074,4,13,11,24
2023-04-27 22:10:09,0.12311342592592593,1,8,9,17
2023-04-27 21:53:19,0.12186342592592593,1,1,1,2
2023-04-27 19:56:39,0.06543981481481481,1,1,1,2
2023-06-17 16:28:47,51.4015625,17,486,369,855
2023-04-27 01:36:17,0.1011574074074074,4,11,10,21
2023-04-26 07:59:40,0.13295138888888888,1,25,15,40
2023-04-27 06:24:57,1.8072453703703704,4,66,288,354
2023-07-12 19:29:58,78.8538425925926,21,2443,1219,3662
2023-04-25 21:49:57,1.015636574074074,1,4,4,8
2023-07-15 22:09:38,82.23638888888888,14,29586,19888,49474
2023-04-28 12:46:51,3.692638888888889,5,91,60,151
2023-04-24 18:43:13,0.005555555555555556,1,1,1,2
2023-05-26 06:27:52,32.42710648148148,4,656,249,905
2023-05-03 16:23:37,9.82349537037037,5,48,14,62
2023-05-25 17:31:18,32.17002314814815,7,36,14,50
2023-04-23 18:19:16,0.5584027777777778,1,21,44,65
2023-04-26 11:25:11,3.3610185185185184,4,13,16,29
2023-04-25 09:09:11,2.27818287037037,3,2,22,24
2023-04-23 03:34:22,0.05797453703703704,1,1,2,3
2023-04-24 12:04:44,1.4213425925925927,1,1,12,13
2023-09-18 17:52:02,148.72505787037036,23,42930,22146,65076
2023-04-23 01:25:04,1.6658912037037037,2,29,35,64
2023-04-21 20:37:08,1.030474537037037,1,30,1,31
2023-04-21 19:35:26,0.09244212962962962,1,4,17,21
2023-04-22 11:28:26,0.7720023148148148,1,9,3,12
2023-05-03 11:05:12,70.58269675925926,4,65,25,90
2023-04-21 16:08:16,0.07131944444444445,1,2,1,3
2023-04-23 07:22:43,1.718773148148148,2,2,3,5
2023-05-05 05:35:54,13.759016203703704,5,2589,1064,3653
2023-04-21 11:29:55,0.25763888888888886,8,66,22,88
2023-04-20 23:22:01,0.00883101851851852,1,1,1,2
2023-04-20 23:37:42,0.09768518518518518,3,14,34,48
2023-04-21 11:42:46,0.8174421296296296,2,23,3,26
2023-04-20 18:32:17,0.1215625,1,58,7,65
2023-04-21 00:09:34,0.834224537037037,4,69,26,95
2023-04-28 20:03:54,12.572094907407408,12,5833,3426,9259
2023-04-21 19:20:51,11.874189814814814,3,3599,1502,5101
2023-04-19 06:44:54,0.3808912037037037,1,19,64,83
2023-04-19 04:14:40,0.3635069444444444,3,27,38,65
2023-04-18 14:50:56,0.7436574074074074,1,4,4,8
2023-04-19 15:56:40,1.9998958333333334,8,664,392,1056
2023-04-17 17:02:21,0.05189814814814815,1,1,7,8
2023-04-17 15:20:18,0.09747685185185186,1,3,17,20
2023-04-18 03:50:17,1.0300462962962964,4,1869,657,2526
2023-04-17 12:42:47,0.4880555555555556,2,51,27,78
2023-04-16 20:55:10,1.0349421296296297,3,5,2,7
2023-05-25 19:48:55,42.584386574074074,3,131,40,171
2023-04-15 08:47:49,0.5552777777777778,1,1,1,2
2023-04-16 12:47:15,1.8703472222222222,2,3,3,6
2023-05-15 19:57:13,31.764930555555555,1,0,1085,1085
2023-04-14 11:31:42,30.55011574074074,1,16,0,16
2023-04-13 23:43:53,0.03560185185185185,1,1,1,2
2023-04-14 10:44:52,0.9713657407407408,3,27,137,164
2023-04-13 23:40:38,0.4233912037037037,2,3,2,5
2023-04-13 10:39:31,0.10039351851851852,1,1,0,1
2023-04-14 07:46:21,1.116099537037037,1,21,0,21
2023-04-14 07:42:39,1.137349537037037,3,24,10,34
2023-04-13 07:45:30,0.2444675925925926,1,17,2,19
2023-05-12 19:26:03,29.744699074074074,3,15,8,23
2023-04-23 07:07:31,10.465335648148148,8,3518,1469,4987
2023-04-12 19:07:06,0.18259259259259258,1,1,1,2
2023-04-25 22:04:33,13.41875,1,2,0,2
2023-04-11 19:22:41,0.15523148148148147,2,28,31,59
2023-04-12 14:39:07,1.0545833333333334,6,16,11,27
2023-04-11 09:13:01,0.12925925925925927,1,27,14,41
2023-04-14 10:51:19,43.193888888888885,12,6966,3421,10387
2023-04-10 15:44:24,0.23412037037037037,1,7,3,10
2023-04-14 21:05:20,4.695277777777778,1,93,2,95
2023-04-17 11:05:39,9.345810185185185,5,1603,1963,3566
2023-04-09 18:07:40,0.8486458333333333,3,52,16,68
2023-04-16 22:27:46,8.136226851851852,1,14,5,19
2023-04-14 19:06:59,6.094016203703704,13,428,407,835
2023-04-07 12:46:43,0.028668981481481483,1,1,1,2
2023-04-07 15:01:23,0.14844907407407407,1,4,0,4
2023-04-06 12:06:47,0.015439814814814814,2,2,1,3
2023-04-05 21:55:25,0.04618055555555556,1,8,4,12
2023-04-25 17:39:33,20.08383101851852,4,3980,3621,7601
2023-04-05 21:06:49,0.1854861111111111,1,6,6,12
2023-04-06 12:13:08,1.1577430555555555,7,62,240,302
2023-04-04 02:11:24,0.08076388888888889,1,2,1,3
2023-05-03 20:22:36,29.922349537037036,15,8698,5658,14356
2023-04-07 08:21:52,3.6968402777777776,7,321,1273,1594
2023-04-03 17:48:45,0.3880208333333333,1,1,1,2
2023-04-14 10:55:54,11.210659722222223,7,197,71,268
2023-04-03 11:23:04,0.3474305555555556,1,2,2,4
2023-04-13 05:44:35,11.95050925925926,12,1747,1750,3497
2023-04-23 18:17:36,21.762326388888887,7,5662,3282,8944
2023-05-21 18:15:10,49.91612268518519,3,37,21,58
2023-04-03 11:15:01,1.6197685185185184,1,70,15,85
2023-04-01 20:21:33,0.47195601851851854,2,14,5,19
2023-05-04 01:15:12,32.79641203703704,21,7703,4198,11901
2023-04-17 16:57:44,16.790150462962963,7,369,154,523
2023-04-03 01:46:56,2.3970949074074075,1,16,2,18
2023-04-03 08:44:59,2.8308564814814816,1,13,0,13
2023-03-31 14:01:29,0.11813657407407407,1,2,2,4
2023-06-21 05:03:08,82.09957175925926,14,19841,16688,36529
2023-04-04 01:15:09,4.118194444444445,2,28,19,47
2023-04-08 18:01:08,9.035034722222223,2,115,43,158
2023-03-30 17:37:57,0.11733796296296296,1,13,0,13
2023-05-01 15:50:48,33.44954861111111,10,1107,323,1430
2023-04-04 23:08:15,6.760370370370371,3,20,20,40
2023-04-07 21:00:00,9.954131944444445,9,1635,652,2287
2023-04-25 13:44:10,28.305891203703705,10,248,72,320
2023-03-28 21:23:23,0.0909837962962963,2,15,1,16
2023-03-29 21:05:19,4.902465277777778,11,149,70,219
2023-03-27 16:45:45,0.4750347222222222,1,57,39,96
2023-03-31 10:01:31,4.316331018518518,1,11,0,11
2023-08-13 15:42:15,141.07390046296297,17,33266,19428,52694
2023-03-30 20:40:08,15.325092592592593,31,717,366,1083
2023-04-16 07:37:27,22.80298611111111,1,29,89,118
2023-03-24 09:47:40,0.16219907407407408,1,23,4,27
2023-04-12 03:36:01,19.245787037037037,4,33,5,38
2023-03-25 06:07:48,2.4766203703703704,3,41,16,57
2023-03-24 07:54:39,1.5921875,3,22,13,35
2023-03-22 22:39:15,0.40605324074074073,1,12,2,14
2023-03-22 10:09:27,0.14049768518518518,1,17,2,19
2023-04-13 22:47:17,23.992025462962964,2,88,109,197
2023-03-22 22:01:07,2.222673611111111,6,34,31,65
2023-03-21 16:29:17,0.984212962962963,2,25,11,36
2023-03-21 19:20:27,1.5953472222222222,2,8,6,14
2023-03-21 18:03:54,3.6544791666666665,4,4,4,8
2023-03-21 12:34:32,1.6084027777777778,1,45,13,58
2023-03-23 20:13:01,5.115833333333334,5,67,49,116
2023-03-18 20:12:36,0.7464120370370371,3,3,0,3
2023-03-17 15:13:07,0.8781365740740741,7,44,25,69
2023-03-24 07:32:05,7.634479166666667,8,94,92,186
2023-03-18 02:12:09,1.7216550925925926,1,8,1,9
2023-03-17 02:35:14,1.0062731481481482,1,2,2,4
2023-03-16 11:28:35,0.5672800925925926,3,3,3,6
2023-06-07 05:16:43,84.45291666666667,11,20285,12326,32611
2023-03-15 16:59:51,0.10476851851851852,2,3,3,6
2023-03-16 08:17:58,0.8044097222222222,3,67,11,78
2023-04-24 12:36:54,78.99087962962963,12,4086,2336,6422
2023-12-06 07:19:11,279.05039351851855,51,84402,41258,125660
2023-03-30 06:57:34,15.609606481481482,20,2648,949,3597
2023-03-14 23:12:38,0.3045833333333333,1,26,28,54
2023-03-13 22:43:40,0.4733912037037037,1,15,7,22
2023-03-15 11:34:19,2.04806712962963,7,60,31,91
2023-03-18 19:44:55,33.925185185185185,13,1151,173,1324
2023-03-12 07:48:18,0.2808449074074074,2,31,5,36
2023-03-21 12:31:45,14.580474537037038,11,1852,366,2218
2023-03-15 01:20:08,3.0217824074074073,11,69,41,110
2023-03-18 21:36:28,10.11050925925926,2,91,27,118
2023-06-01 00:25:44,81.14293981481481,10,13585,8618,22203
2023-03-17 15:18:33,6.534988425925926,17,83,53,136
2023-03-11 07:11:57,0.2622453703703704,3,32,13,45
2023-03-14 05:39:38,3.2648842592592593,3,37,56,93
2023-03-18 05:19:50,7.383148148148148,2,53,29,82
2023-03-11 01:25:26,0.2676851851851852,2,12,12,24
2023-03-15 20:57:40,5.257407407407407,1,4,6,10
2023-03-14 20:27:32,4.652094907407408,17,47,22,69
2023-03-27 20:22:40,17.67849537037037,4,27,10,37
2023-03-09 13:06:56,0.030810185185185184,2,2,2,4
2023-05-20 02:59:48,74.0356712962963,10,9615,3997,13612
2023-03-14 02:04:41,19.198946759259258,12,760,176,936
2023-03-31 07:36:16,25.431840277777777,3,35,11,46
2023-07-21 03:01:12,109.27899305555556,36,24656,17180,41836
2023-03-11 04:22:05,5.865289351851852,4,129,22,151
2023-03-15 21:35:45,10.262685185185186,2,15,0,15
2023-03-06 18:00:19,1.4209722222222223,3,16,2,18
2023-03-18 19:27:33,13.909548611111111,5,798,171,969
2023-03-15 15:30:23,10.780752314814816,4,689,124,813
2023-03-14 17:18:45,10.357233796296295,3,27,16,43
2023-03-06 21:49:41,3.0751157407407406,6,210,30,240
2023-03-04 08:51:41,1.7260300925925927,3,108,42,150
2023-03-02 16:25:29,0.03607638888888889,1,1,1,2
2023-03-03 10:03:08,0.8235416666666666,5,54,18,72
2023-03-04 16:56:17,2.2733333333333334,9,75,42,117
2023-04-22 07:13:37,51.29459490740741,4,9924,4597,14521
2023-03-01 22:51:08,0.05461805555555556,1,4,4,8
2023-03-02 07:42:26,0.6511689814814815,1,5,5,10
2023-03-01 02:50:52,0.15457175925925926,2,19,19,38
2023-03-01 15:47:51,0.9480439814814815,2,4,3,7
2023-04-16 08:58:10,46.81465277777778,14,4594,1613,6207
2023-03-02 05:11:31,2.1102546296296296,1,2,1,3
2023-03-01 14:50:19,1.6324652777777777,1,4,0,4
2023-03-02 11:46:36,2.976875,10,455,454,909
2023-03-14 17:21:23,15.289814814814815,1,8,0,8
2023-03-12 21:23:53,13.95630787037037,2,45,4,49
2023-02-27 16:53:06,0.8026967592592592,1,0,275,275
2023-03-10 21:10:27,13.0084375,9,2457,1731,4188
2023-02-27 21:11:58,1.0274421296296297,1,14,9,23
2023-02-26 15:38:50,0.24575231481481483,1,1,1,2
2023-02-27 20:38:55,1.5880092592592592,1,48,25,73
2023-03-01 17:43:39,3.8275578703703705,3,39,10,49
2023-02-25 21:17:39,0.32309027777777777,1,4,4,8
2023-02-25 21:18:50,0.6310416666666666,1,3,4,7
2023-05-20 19:59:30,85.05822916666666,4,17097,12214,29311
2023-03-01 17:09:32,5.004363425925926,2,6,5,11
2023-02-24 16:41:29,0.08625,1,2,2,4
2023-02-25 06:48:04,1.5232291666666666,1,4,0,4
2023-02-23 21:31:05,0.19013888888888889,1,2,1,3
2023-03-03 09:04:52,8.05451388888889,3,177,7,184
2023-03-06 14:40:03,10.997349537037037,1,88,46,134
2023-02-27 19:45:36,4.322708333333333,1,1,0,1
2023-03-01 17:05:17,6.9271412037037035,6,1199,980,2179
2023-02-22 14:59:19,0.11018518518518519,1,1,1,2
2023-02-22 10:42:17,0.014826388888888889,1,1,1,2
2023-03-01 15:30:20,7.765949074074074,6,107,34,141
2023-02-22 18:18:08,0.8809490740740741,1,2,1,3
2023-02-25 22:59:22,4.238657407407407,4,36,7,43
2023-04-20 22:46:14,58.24357638888889,4,11392,5661,17053
2023-03-18 21:02:27,25.240752314814817,7,4320,2273,6593
2023-03-14 19:19:24,22.588078703703705,2,62,5,67
2023-04-05 05:46:19,43.093842592592594,9,6737,2753,9490
2023-02-23 22:29:58,3.800625,4,248,165,413
2023-02-25 19:04:18,5.773657407407407,2,171,173,344
2023-02-26 00:31:15,6.019513888888889,15,99,70,169
2023-02-23 20:58:17,3.9133796296296297,1,1,1,2
2023-02-19 23:11:47,0.01871527777777778,1,110,1,111
2023-02-22 22:00:41,2.99099537037037,2,154,125,279
2023-02-20 08:43:52,0.9802314814814815,1,14,1,15
2023-03-07 06:27:51,15.939050925925926,5,1944,1361,3305
2023-02-20 08:48:12,1.4959375,1,104,109,213
2023-02-19 01:32:44,0.6502777777777777,2,14,17,31
2023-02-18 08:33:33,0.11626157407407407,1,1,0,1
2023-02-24 18:33:14,7.053055555555556,4,1003,640,1643
2023-02-24 11:14:22,7.573738425925926,1,4,19,23
2023-02-17 10:54:28,0.5674074074074074,1,1,97,98
2023-03-02 12:42:57,13.733958333333334,6,2354,2281,4635
2023-02-16 23:13:16,0.15453703703703703,1,3,3,6
2023-02-16 14:49:18,0.09678240740740741,1,2,0,2
2023-02-17 11:35:15,0.3154976851851852,1,5,5,10
2023-02-16 12:21:05,0.8511458333333334,3,63,120,183
2023-02-15 22:48:18,1.0271412037037038,6,13,12,25
2023-02-15 22:03:35,1.331400462962963,7,23,22,45
2023-02-16 00:05:46,2.3206481481481482,1,2,2,4
2023-02-13 14:53:36,1.6716666666666666,5,138,77,215
2023-02-26 21:01:23,16.13515046296296,5,3394,1774,5168
2023-02-21 23:41:02,11.44824074074074,15,157,160,317
2023-02-10 11:59:45,0.18885416666666666,1,24,2,26
2023-07-20 01:28:10,161.14670138888889,19,45111,25176,70287
2023-02-16 16:34:24,10.529155092592593,2,149,92,241
2023-02-14 08:03:15,5.016423611111111,3,79,36,115
2023-02-14 11:00:58,5.438506944444445,1,42,16,58
2023-04-26 09:49:47,77.04421296296296,2,13,53,66
2023-02-18 02:37:22,9.217372685185186,2,30,2,32
2023-02-20 22:44:38,18.414583333333333,7,119,81,200
2023-02-08 16:44:59,0.8701041666666667,1,10,2,12
2023-02-07 21:52:44,0.23908564814814814,2,15,4,19
2023-02-07 22:22:01,0.2855787037037037,1,2,0,2
2023-02-07 10:04:22,0.3862962962962963,2,6,6,12
2023-02-06 23:24:23,0.049386574074074076,1,6,0,6
2023-02-20 13:20:00,14.022928240740741,3,5,6,11
2023-02-08 08:56:27,1.8108217592592593,1,12,12,24
2023-02-06 10:48:47,0.4732638888888889,1,1,1,2
2023-02-10 17:58:03,4.796469907407407,1,1,1,2
2023-03-06 08:35:43,28.858923611111113,12,6901,3319,10220
2023-02-06 21:48:41,1.6487037037037038,3,39,52,91
2023-02-04 03:11:03,0.5216319444444445,2,3,2,5
2023-02-03 15:12:33,0.19092592592592592,4,7,7,14
2023-08-11 21:07:54,189.94425925925927,1,1,1,2
2023-02-06 10:53:00,3.5736921296296296,3,80,130,210
2023-02-04 12:21:14,1.720787037037037,2,9,2,11
2023-02-04 00:17:28,2.020763888888889,1,1,1,2
2023-02-05 00:38:43,3.155266203703704,7,155,129,284
2023-03-18 18:44:26,47.01572916666667,19,10459,4723,15182
2023-02-09 13:51:23,7.755925925925926,2,53,3,56
2023-02-18 07:46:54,16.660416666666666,1,7,1,8
2023-02-13 18:15:30,13.080636574074074,18,327,262,589
2023-02-06 15:19:22,5.895844907407407,1,57,39,96
2023-01-31 22:00:00,0.21311342592592591,1,3,5,8
2023-02-14 19:51:35,14.162581018518518,6,81,93,174
2023-01-31 15:49:26,0.009756944444444445,1,2,2,4
2023-01-31 15:17:39,0.15274305555555556,1,1,1,2
2023-01-31 11:51:05,0.004224537037037037,1,11,2,13
2023-01-31 16:32:00,0.46359953703703705,2,206,157,363
2023-03-21 12:47:03,49.72094907407408,4,12483,6002,18485
2023-02-02 15:26:42,3.019502314814815,3,6,3,9
2023-02-04 10:05:07,5.3505671296296295,4,13,10,23
2023-02-10 17:43:34,11.83849537037037,1,32,5,37
2023-04-10 12:57:33,71.21872685185186,2,95,5,100
2023-01-30 23:15:02,0.03998842592592593,2,96,25,121
2023-01-30 17:24:27,1.7960648148148148,7,1301,1236,2537
2023-01-29 20:03:48,1.1786921296296295,4,17,12,29
2023-02-14 02:11:09,16.78185185185185,13,143,107,250
2023-03-06 00:26:35,36.90083333333333,25,29229,9334,38563
2023-01-29 22:55:28,1.9602777777777778,1,32,1,33
2023-02-05 04:58:57,8.815532407407407,6,72,10,82
2023-02-05 21:41:53,9.578611111111112,7,3250,1731,4981
2023-01-27 09:33:26,0.38524305555555555,2,14,9,23
2023-02-13 21:29:49,18.39326388888889,1,17,9,26
2023-01-30 22:10:30,4.63630787037037,6,271,30,301
2023-01-26 00:01:49,0.08003472222222222,1,20,8,28
2023-01-26 23:55:21,1.218449074074074,5,22,8,30
2023-01-26 04:28:53,0.40913194444444445,2,10,5,15
2023-01-25 17:48:05,0.012175925925925925,1,1,1,2
2023-01-25 18:26:16,0.09221064814814815,2,25,12,37
2023-02-05 00:25:38,11.492604166666666,6,24,13,37
2023-01-24 15:50:22,0.18346064814814814,2,108,18,126
2023-02-28 03:19:59,34.770821759259256,2,204,9,213
2023-03-04 18:42:25,40.00836805555556,11,12327,5245,17572
2023-01-25 16:22:47,2.8444560185185184,2,33,7,40
2023-01-29 11:01:59,7.498738425925926,3,88,42,130
2023-01-25 12:00:16,3.1614351851851854,1,8,0,8
2023-01-25 12:08:14,3.191666666666667,3,60,15,75
2023-02-25 21:20:28,34.97241898148148,3,11223,4157,15380
2023-01-23 09:20:44,1.577048611111111,1,30,0,30
2023-01-24 00:13:12,2.3552199074074074,3,75,17,92
2023-01-22 20:40:17,1.9124768518518518,1,4,1,5
2023-02-07 22:43:54,18.094768518518517,2,41,10,51
2023-01-23 09:10:42,2.632175925925926,1,16,0,16
2023-01-20 14:44:38,0.661261574074074,3,42,41,83
2023-01-23 21:35:41,8.110659722222222,11,1736,329,2065
2023-01-19 11:37:43,0.24660879629629628,2,2,2,4
2023-01-22 17:37:33,3.992025462962963,5,52,8,60
2023-01-18 18:47:19,0.04972222222222222,2,10,10,20
2023-01-18 17:56:58,2.9960300925925925,1,17,9,26
2023-01-18 12:19:43,0.1745486111111111,2,39,31,70
2023-01-29 19:31:29,11.47869212962963,19,247,157,404
2023-01-18 07:58:09,0.1373263888888889,2,33,59,92
2023-01-18 12:33:23,0.6255092592592593,3,413,124,537
2023-01-20 14:40:10,3.020960648148148,2,1,0,1
2023-02-13 21:18:53,27.5675,5,117,73,190
2023-01-21 15:00:31,5.313611111111111,1,24,21,45
2023-01-18 17:03:31,2.7521412037037036,9,59,72,131
2023-01-19 11:52:10,3.518414351851852,1,58,22,80
2023-01-17 01:45:44,1.1394097222222221,1,2,27,29
2023-01-15 20:19:16,0.06236111111111111,1,1,1,2
2023-01-17 16:24:40,3.819699074074074,3,63,9,72
2023-01-13 15:34:12,0.06528935185185185,1,3,3,6
2023-01-13 16:49:42,0.19543981481481482,1,50,4,54
2023-01-15 21:22:15,2.5363657407407407,3,19,19,38
2023-01-27 18:52:35,15.0284375,11,534,117,651
2023-01-25 17:11:12,13.050995370370371,2,52,13,65
2023-01-13 13:39:59,1.4165162037037038,2,304,84,388
2023-01-12 00:12:35,0.15340277777777778,1,2,110,112
2023-01-12 19:46:15,0.9194907407407408,4,9,16,25
2023-01-11 23:11:39,0.09842592592592593,1,4,0,4
2023-01-11 23:13:07,0.10724537037037037,1,14,17,31
2023-01-23 18:51:15,13.618680555555555,4,3546,875,4421
2023-01-11 23:03:40,1.8733449074074073,5,712,97,809
2023-01-11 12:46:34,0.7650578703703703,2,46,5,51
2023-01-10 14:32:36,0.040706018518518516,1,3,3,6
2023-01-10 13:00:24,0.008032407407407408,1,3,3,6
2023-01-10 12:12:58,0.44989583333333333,1,105,18,123
2023-01-26 18:59:32,16.9,8,83,72,155
2023-08-24 21:06:03,227.00912037037037,2,4,4,8
2023-01-22 15:54:06,13.927407407407408,4,56,43,99
2023-01-09 23:41:10,1.9502199074074074,5,134,38,172
2023-01-11 11:33:23,4.018252314814815,1,36,2,38
2023-01-10 12:58:52,3.65318287037037,5,82,19,101
2023-01-10 12:14:53,4.2361458333333335,2,44,9,53
2023-01-06 13:06:24,0.3508101851851852,1,9,9,18
2023-01-05 21:24:49,0.03678240740740741,1,1,1,2
2023-01-05 19:51:31,0.026111111111111113,1,2,2,4
2023-10-27 10:14:53,295.7998958333333,74,95474,42711,138185
2023-01-14 09:00:04,8.979733796296296,2,32,2,34
2023-01-05 11:46:13,0.4700347222222222,1,121,5,126
2023-09-14 19:18:30,252.94150462962963,60,67703,33341,101044
2023-01-04 22:09:35,0.08516203703703704,1,19,1,20
2023-06-20 16:55:16,175.84158564814814,2,977,304,1281
2023-01-06 18:24:42,2.0633333333333335,1,66,5,71
2023-01-11 09:34:15,6.955,1,27,0,27
2023-01-04 15:33:03,0.6429861111111111,1,135,104,239
2023-01-04 20:56:46,0.9505208333333334,1,1,1,2
2023-01-06 13:23:02,3.609027777777778,1,46,13,59
2023-01-04 22:44:52,1.144201388888889,7,99,45,144
2023-05-12 07:55:13,129.3545138888889,1,58,44,102
2023-05-13 07:19:54,130.364375,17,20948,8036,28984
2023-01-06 16:55:20,3.830208333333333,6,33,8,41
2023-01-02 22:32:12,0.07020833333333333,1,3,2,5
2023-01-05 21:43:27,4.157604166666666,4,30,15,45
2023-01-14 05:15:02,11.577222222222222,2,3,3,6
2023-08-31 19:22:33,241.7528125,33,61224,29501,90725
2023-01-02 08:30:10,0.5751273148148148,1,3,2,5
2023-01-06 13:41:32,4.921030092592592,1,67,2,69
2023-01-05 20:30:49,4.266157407407407,4,17,15,32
2023-01-06 17:25:32,5.341527777777777,2,37,11,48
2023-01-16 12:47:53,15.501319444444444,3,63,28,91
2023-01-13 08:58:03,12.935381944444444,2,51,6,57
2022-12-31 12:05:27,0.1062037037037037,1,24,1,25
2022-12-31 20:25:00,0.9074421296296297,2,9,10,19
2023-01-01 04:26:50,1.3555439814814816,2,29,2,31
2022-12-31 01:26:54,0.23923611111111112,3,36,11,47
2023-01-05 04:22:03,5.5016087962962965,7,78,37,115
2023-04-24 10:37:10,115.67857638888889,11,26863,10815,37678
2023-01-05 22:26:25,7.0509375,2,118,36,154
2023-01-03 21:39:16,5.113333333333333,1,63,26,89
2023-01-10 08:53:11,11.614780092592593,1,13,0,13
2023-05-27 00:53:34,148.3352199074074,118,39228,20201,59429
2022-12-29 08:37:01,0.2761226851851852,1,18,2,20
2023-01-05 21:22:30,8.46761574074074,5,294,110,404
2022-12-28 14:49:28,0.29314814814814816,3,44,20,64
2023-02-06 10:32:10,40.32133101851852,1,5,5,10
2023-01-22 17:41:37,25.838935185185186,3,21,10,31
2022-12-28 09:48:09,0.5250810185185185,3,56,28,84
2022-12-28 16:19:10,0.8471296296296297,3,6,6,12
2023-01-01 21:27:32,5.111261574074074,3,8,7,15
2023-01-10 12:24:25,13.890578703703703,5,319,66,385
2023-01-16 17:53:51,21.650613425925926,1,27,7,34
2023-01-16 17:49:57,22.15939814814815,13,243,51,294
2022-12-25 19:31:49,0.9123148148148148,1,1,0,1
2022-12-25 11:07:27,0.6979976851851852,1,2,2,4
2022-12-25 19:33:47,2.0875810185185184,2,11,13,24
2022-12-22 19:35:18,0.06908564814814815,2,22,22,44
2022-12-22 19:40:53,0.7747453703703704,3,19,10,29
2022-12-31 11:57:13,10.073229166666666,1,34,28,62
2022-12-21 00:30:56,0.2653935185185185,1,7,0,7
2023-01-12 01:10:17,22.429606481481482,6,575,190,765
2022-12-20 15:45:05,0.515787037037037,1,14,7,21
2023-09-10 22:28:38,265.10216435185185,2,74,2,76
2022-12-25 08:04:40,5.835011574074074,4,45,27,72
2023-01-18 08:01:08,140.4728587962963,92,3175,1955,5130
2022-12-19 17:22:28,0.5993518518518518,1,1,1,2
2023-01-22 18:59:24,35.166863425925925,1,46,86,132
2023-01-10 12:22:59,22.71556712962963,7,1107,341,1448
2023-04-17 11:56:08,135.6628125,78,31185,12787,43972
2022-12-26 09:51:27,9.075381944444445,2,86,29,115
2022-12-16 11:32:17,0.04905092592592593,1,1,1,2
2022-12-16 10:25:32,0.48586805555555557,1,0,16,16
2022-12-28 10:15:13,12.088958333333334,1,40,19,59
2022-12-16 16:09:48,0.37560185185185185,1,29,3,32
2022-12-17 17:13:30,1.4547337962962963,1,38,3,41
2022-12-16 10:12:39,0.4637384259259259,1,2,2,4
2022-12-19 19:13:55,4.0505555555555555,1,1,1,2
2022-12-25 08:15:51,9.622118055555555,9,81,32,113
2022-12-15 10:12:05,0.28324074074074074,1,2,1,3
2022-12-16 06:28:14,1.51625,5,67,47,114
2022-12-15 13:25:48,0.8857175925925926,3,57,190,247
2023-03-22 23:17:29,140.22224537037036,8,129,20,149
2022-12-15 10:25:46,1.1255902777777778,1,11,3,14
2022-12-13 22:00:55,1.034513888888889,3,14,3,17
2022-12-14 14:57:48,1.7857060185185185,4,19,22,41
2023-05-25 17:11:02,163.90651620370372,5,49,22,71
2023-02-05 05:32:36,55.169826388888886,1,66,11,77
2022-12-26 19:26:34,14.919363425925926,16,2301,1889,4190
2022-12-11 12:58:28,0.016944444444444446,1,1,1,2
2022-12-11 18:16:58,0.7112384259259259,2,13,115,128
2022-12-11 18:08:16,0.8466666666666667,1,124,136,260
2022-12-12 20:17:52,3.2959375,2,204,324,528
2023-01-25 15:22:15,47.100405092592595,2,181,188,369
2022-12-09 10:47:00,0.3895486111111111,1,3,4,7
2022-12-15 16:17:44,6.931967592592593,23,991,909,1900
2022-12-08 15:44:38,0.2871064814814815,1,1,69,70
2022-12-08 08:51:45,0.10903935185185185,1,31,0,31
2023-01-06 14:13:42,29.634085648148147,4,2500,1975,4475
2022-12-08 13:09:14,0.9100462962962963,1,2,2,4
2022-12-14 23:15:09,7.4171875,2,2,2,4
2022-12-07 23:36:55,0.44309027777777776,3,18,262,280
2022-12-26 10:05:56,19.181527777777777,2,32,2,34
2022-12-07 02:19:45,0.3165046296296296,4,19,3,22
2022-12-06 03:23:58,1.2948842592592593,1,13,2,15
2022-12-05 09:28:31,0.2548148148148148,3,12,5,17
2023-09-06 02:10:19,9.276516203703704,5,437,92,529
2022-12-07 04:13:32,2.2523263888888887,1,133,2,135
2022-12-05 13:51:18,0.6856712962962963,2,13,12,25
2023-05-25 18:41:09,172.1281712962963,3,551,22,573
2022-12-04 17:25:02,0.11783564814814815,1,1,1,2
2022-12-06 11:07:02,3.941851851851852,4,116,3,119
2022-12-08 13:06:10,4.271909722222222,1,11,3,14
2022-12-07 04:10:08,3.3222800925925924,6,1164,101,1265
2023-04-19 06:41:15,136.5915625,5,8332,3544,11876
2022-12-08 08:40:45,5.124606481481481,1,15,3,18
2022-12-02 23:29:35,0.002349537037037037,1,3,2,5
2022-12-02 22:53:31,0.14840277777777777,1,2,1,3
2024-02-29 10:51:49,453.7517361111111,2,2,2,4
2022-11-30 20:53:36,0.6244444444444445,2,6,2,8
2022-11-30 03:17:24,0.36694444444444446,2,2,6,8
2022-11-29 23:06:38,1.4137962962962962,6,94,60,154
2023-04-06 18:32:38,147.81427083333332,70,30417,11469,41886
2022-11-29 21:36:46,1.9350231481481481,1,46,10,56
2022-11-27 22:57:16,0.005069444444444444,1,4,4,8
2022-11-30 03:21:11,2.2402430555555557,1,1,4,5
2023-01-25 14:58:02,58.79521990740741,2,21,81,102
2022-11-28 10:30:00,0.9224074074074075,4,96,85,181
2023-08-26 01:58:07,272.1986342592593,5,69319,30981,100300
2022-11-26 20:02:31,0.23225694444444445,2,6,7,13
2022-11-26 08:59:28,0.034525462962962966,2,4,1,5
2022-12-16 07:12:22,20.298912037037038,11,6517,2636,9153
2022-11-26 00:18:43,0.09143518518518519,1,30,2,32
2022-11-25 17:47:23,0.03274305555555555,1,1,1,2
2022-12-10 15:07:04,14.930752314814814,3,89,32,121
2022-11-27 04:04:41,1.5252430555555556,2,16,9,25
2022-11-27 21:09:54,2.631238425925926,5,126,141,267
2022-12-12 05:55:12,17.204340277777778,3,1774,788,2562
2022-12-09 11:40:33,14.713402777777778,4,11,3,14
2022-12-05 12:27:28,55.60087962962963,5,209,62,271
2023-07-13 17:14:14,231.37408564814814,45,49183,27502,76685
2022-11-26 14:21:07,2.335023148148148,4,42,71,113
2022-12-03 05:08:21,8.998483796296297,1,6,192,198
2022-11-24 06:12:48,0.13425925925925927,1,7,5,12
2022-11-24 00:19:57,0.11951388888888889,1,1,2,3
2022-11-29 02:26:02,5.2455439814814815,2,29,2,31
2023-07-28 21:24:54,249.1928472222222,4,213,132,345
2022-11-21 17:41:33,0.4460763888888889,2,9268,3188,12456
2023-04-18 17:59:21,148.47385416666665,7,171,163,334
2023-07-24 13:23:15,246.31135416666666,2,139,16,155
2022-12-07 04:16:11,17.220694444444444,1,0,25,25
2022-11-19 21:44:04,0.5278587962962963,1,8,8,16
2022-12-20 15:54:48,31.331446759259258,3,55,15,70
2022-12-06 18:13:33,17.456967592592594,1,43,14,57
2022-11-26 21:32:46,7.6554976851851855,1,23,0,23
2022-11-18 15:19:32,0.7791782407407407,2,26,18,44
2022-11-18 15:11:07,1.7830902777777777,7,124,26,150
2023-02-27 22:24:21,103.8171412037037,53,26568,10356,36924
2022-11-26 21:45:11,10.825046296296296,1,3,1,4
2022-11-15 22:33:32,0.08447916666666666,1,7,7,14
2022-11-16 03:17:08,0.3308449074074074,1,2,2,4
2022-11-15 21:11:07,0.7139351851851852,2,6,2,8
2022-11-15 22:41:37,1.668761574074074,1,3,27,30
2022-11-20 17:27:57,6.5170717592592595,3,26,10,36
2022-11-14 03:31:01,0.25253472222222223,1,73,186,259
2022-12-06 10:34:06,22.724363425925926,1,11,21,32
2022-12-11 15:35:23,28.793460648148148,1,117,8,125
2023-02-06 20:46:10,85.80341435185186,14,20655,6460,27115
2022-12-01 22:45:31,19.105706018518518,5,3223,821,4044
2023-07-08 20:26:16,311.1863310185185,38,7602,1983,9585
2023-01-30 17:56:40,79.90395833333334,8,17261,4635,21896
2022-11-12 17:54:57,1.1332523148148148,1,4,4,8
2022-11-17 16:15:11,6.0762731481481485,1,0,1,1
2022-11-11 20:37:53,0.13820601851851852,1,18,4,22
2022-11-11 05:01:29,0.25550925925925927,2,13,7,20
2022-12-07 20:51:00,30.304027777777776,47,2350,1321,3671
2022-11-09 11:29:10,0.11143518518518518,1,13,0,13
2022-11-10 15:25:05,1.7493402777777778,3,40,2,42
2022-11-08 17:59:09,0.04883101851851852,1,15,121,136
2022-11-09 03:46:32,0.5008217592592593,1,29,20,49
2022-11-08 03:30:27,0.1905902777777778,1,22,22,44
2022-11-08 03:23:56,0.41989583333333336,2,11,7,18
2022-11-09 04:15:21,1.5927199074074074,4,84,39,123
2022-11-07 11:09:44,0.037280092592592594,1,10,9,19
2022-11-08 17:12:51,1.8782060185185185,11,204,71,275
2022-11-07 04:09:08,0.5694212962962963,1,7,8,15
2022-12-06 04:15:04,31.45150462962963,22,1092,393,1485
2022-11-08 03:32:31,1.9127662037037036,2,52,19,71
2022-11-06 02:48:12,0.25318287037037035,1,8,7,15
2022-11-05 20:07:31,0.10758101851851852,2,146,133,279
2022-11-06 03:30:28,1.2713078703703704,1,14,10,24
2022-11-18 02:20:57,4184.161377314815,7,798979,638553,1437532
2022-11-09 00:23:36,5.215416666666667,4,53,72,125
2023-05-27 21:10:00,174.94958333333332,3,78,21,99
2022-11-03 08:29:56,0.14765046296296297,1,3,1,4
2023-01-06 12:51:38,64.95094907407407,2,4,3,7
2023-04-07 15:07:38,177.0980324074074,12,27177,9889,37066
2022-11-01 23:40:11,0.5727199074074074,11,211,33,244
2022-11-05 05:35:50,4.436736111111111,2,63,7,70
2022-11-01 09:58:49,0.38377314814814817,1,1,813,814
2022-11-01 15:24:33,0.9417476851851851,1,14,0,14
2022-11-01 17:22:42,1.1255555555555556,1,49,0,49
2023-01-27 19:11:55,88.53314814814814,2,43,3,46
2022-10-31 05:40:25,0.0029745370370370373,1,0,9,9
2022-11-06 14:14:23,6.7480671296296295,3,18,21,39
2022-10-31 05:18:57,1.2988773148148147,1,9,0,9
2022-11-26 23:08:33,37.518252314814816,1,203,143,346
2022-10-29 04:07:26,0.06302083333333333,1,28,2,30
2022-10-29 04:38:22,24.667546296296297,4,32,63,95
2022-11-08 13:16:28,11.390381944444444,1,173,127,300
2022-10-28 10:52:43,0.43974537037037037,1,2,4,6
2022-11-14 23:30:34,18.637256944444445,8,579,95,674
2022-10-28 08:24:47,1.044363425925926,2,35,13,48
2022-10-26 05:38:53,0.25101851851851853,4,17,13,30
2022-11-01 10:46:57,11.28244212962963,9,84,50,134
2022-11-06 07:29:33,130.8940162037037,14,3942,1989,5931
2023-03-30 14:45:44,157.1409490740741,1,3,0,3
2022-10-24 10:17:17,0.41638888888888886,1,2,2,4
2022-10-24 01:21:11,0.030810185185185184,1,2,2,4
2022-10-30 22:38:39,7.486493055555556,4,63,8,71
2022-10-24 00:14:46,0.5673148148148148,1,1,0,1
2022-11-06 04:44:05,13.911782407407408,38,5054,2106,7160
2022-10-23 20:50:41,1.1650810185185185,5,281,76,357
2022-10-23 09:00:29,1.4299189814814814,2,2,2,4
2022-10-23 02:46:47,1.2017476851851852,1,11,0,11
2023-01-06 13:26:10,77.69008101851851,1,40,2,42
2023-04-21 18:00:17,184.03241898148147,8,20896,7839,28735
2024-03-12 17:21:32,509.1818402777778,1,1,1,2
2022-10-20 08:09:09,0.16924768518518518,1,6,1,7
2022-10-20 08:11:36,0.1815625,1,124,0,124
2022-10-19 01:57:04,0.07282407407407407,2,4,1,5
2022-10-18 23:42:33,0.004803240740740741,1,1,0,1
2022-10-19 00:16:30,0.10938657407407408,1,24,2,26
2022-11-04 20:43:25,17.16976851851852,5,41,39,80
2022-10-18 17:45:54,0.05112268518518519,1,3,2,5
2022-10-19 12:37:15,0.8583449074074074,1,0,1,1
2022-10-18 02:56:11,0.14207175925925927,1,2,2,4
2022-11-10 03:30:02,23.08476851851852,9,6286,2554,8840
2022-11-18 23:50:27,32.353912037037034,2,6422,2599,9021
2022-10-17 08:05:16,0.5943055555555555,2,163,155,318
2022-10-31 00:59:34,26.53335648148148,31,2626,943,3569
2022-10-24 04:08:55,8.864513888888888,5,234,48,282
2023-03-31 08:25:30,166.34543981481482,1,1,1,2
2022-10-17 01:06:25,7.3644791666666665,10,2147,907,3054
2022-11-04 08:15:42,20.958206018518517,12,204,84,288
2022-10-14 22:40:22,0.7070138888888889,1,2,6,8
2022-10-13 19:15:44,0.1254861111111111,1,70,17,87
2022-10-13 22:47:00,0.5133101851851852,1,12,12,24
2022-10-13 18:30:09,0.3756365740740741,1,4,4,8
2022-10-12 20:33:20,0.1560763888888889,1,24,232,256
2023-05-21 18:20:50,221.50005787037037,5,105,37,142
2023-02-07 23:32:39,118.67015046296297,3,3533,2020,5553
2022-10-12 04:49:20,0.03817129629629629,1,1,1,2
2022-10-12 05:29:42,0.15855324074074073,1,16,8,24
2023-01-02 13:03:20,87.89688657407407,4,92,9,101
2022-10-11 19:58:39,0.0708912037037037,2,16,16,32
2022-10-12 05:40:28,0.6868055555555556,1,9,9,18
2022-11-05 17:24:32,25.185289351851853,1,7,7,14
2022-10-14 04:37:18,2.738472222222222,3,60,56,116
2022-10-12 12:40:47,1.2858796296296295,3,10,2,12
2022-10-11 07:41:20,0.32306712962962963,1,7,4,11
2022-10-10 20:22:23,0.13203703703703704,1,6,1,7
2022-10-10 17:09:06,1.1441550925925925,1,1,1,2
2022-10-10 20:45:44,2.990740740740741,7,183,64,247
2022-10-09 09:48:05,0.057164351851851855,1,1,1,2
2022-10-14 23:24:58,5.639097222222222,3,42,43,85
2022-11-06 09:24:16,28.06255787037037,6,106,59,165
2022-11-04 07:50:40,26.07028935185185,1,12,0,12
2022-10-09 05:49:29,0.0837962962962963,1,1,1,2
2022-10-09 17:35:04,0.7295486111111111,1,73,0,73
2022-10-09 14:49:52,10.762939814814814,2,40,15,55
2022-10-08 18:19:07,0.2834143518518519,1,9,9,18
2022-10-15 06:04:43,7.382858796296296,2,26,3,29
2022-10-07 17:34:26,0.002951388888888889,1,1,11,12
2022-11-24 16:52:01,48.67488425925926,6,91,22,113
2022-10-21 06:24:09,14.447766203703704,3,1532,665,2197
2022-10-08 04:03:50,1.5640509259259259,1,10,2,12
2022-11-09 11:23:46,34.14326388888889,20,497,118,615
2022-10-12 02:39:39,5.80125,1,70,1,71
2022-10-13 20:33:25,10.01545138888889,5,99,55,154
2022-10-05 08:21:45,0.4181712962962963,2,3,12,15
2022-10-04 19:16:18,0.1850925925925926,1,1,1,2
2022-10-05 17:37:06,1.2351851851851852,1,1,1,2
2022-11-03 16:48:03,30.382743055555554,14,2727,1031,3758
2022-11-25 00:35:25,52.08834490740741,8,10648,3751,14399
2022-10-05 18:23:15,2.0171412037037038,1,27,0,27
2022-10-04 19:11:34,1.8259722222222223,4,259,25,284
2022-10-05 01:12:48,2.097650462962963,8,140,68,208
2022-10-02 17:39:44,0.07858796296296296,1,4,4,8
2022-10-02 18:14:39,0.17232638888888888,1,1,4,5
2022-10-02 20:31:07,1.1150462962962964,1,48,3,51
2022-10-02 00:20:43,0.8385648148148148,1,4,3,7
2022-10-31 04:41:01,87.47989583333333,15,4776,1357,6133
2022-10-25 23:23:06,25.180902777777778,2,2,3,5
2022-10-24 04:04:42,23.65798611111111,20,3540,1170,4710
2022-09-30 09:29:02,0.21481481481481482,2,41,26,67
2023-05-27 00:34:27,243.6852199074074,7,27639,8688,36327
2022-10-11 22:20:02,12.74554398148148,15,5112,1056,6168
2022-10-13 18:31:55,14.438877314814814,1,1,1,2
2022-09-29 07:46:08,0.4820138888888889,4,35,16,51
2022-09-28 22:18:01,0.21912037037037038,1,5,0,5
2022-09-29 20:14:07,1.1773726851851851,1,6,1,7
2022-09-29 07:49:31,0.6977430555555556,3,32,19,51
2022-10-05 19:13:58,7.236539351851852,3,22,9,31
2022-09-28 17:42:49,0.3188888888888889,1,5,2,7
2022-10-01 09:29:27,3.416053240740741,6,233,86,319
2022-09-27 20:21:29,0.9648611111111111,1,23,4,27
2022-09-27 04:57:09,1.0520949074074073,5,40,21,61
2022-09-26 01:06:54,0.0998263888888889,2,3,3,6
2022-09-27 21:47:29,3.576261574074074,15,383,124,507
2022-09-25 17:31:08,0.019525462962962963,1,41,4,45
2022-10-04 05:58:52,8.719108796296297,2,32,83,115
2022-10-15 07:49:00,20.229537037037037,2,2660,529,3189
2022-09-26 01:06:25,2.052650462962963,2,7,2,9
2022-09-23 19:15:54,0.05236111111111111,1,2,3,5
2022-09-23 18:09:14,0.04795138888888889,1,5,1,6
2022-09-25 22:09:54,2.4052430555555557,1,3,1,4
2022-09-22 23:16:01,0.0341087962962963,2,13,10,23
2022-09-23 14:06:56,0.7636226851851852,8,712,428,1140
2022-09-22 16:38:42,0.04356481481481481,1,3,1,4
2022-09-21 21:49:28,0.08120370370370371,1,4,8,12
2022-09-23 16:44:11,2.192835648148148,2,47,20,67
2022-09-21 11:05:06,0.0067708333333333336,1,6,3,9
2022-10-23 01:49:05,32.11826388888889,19,4841,1576,6417
2022-09-20 16:34:23,0.20099537037037038,5,28,12,40
2022-10-03 19:39:03,13.6284375,2,25,3,28
2022-09-21 07:19:24,1.673136574074074,3,149,84,233
2022-11-24 10:01:20,65.8090162037037,22,6322,2004,8326
2022-09-19 16:22:47,0.09626157407407407,1,2,2,4
2022-09-19 13:44:14,0.0571412037037037,1,4,4,8
2022-09-22 01:48:02,2.4752662037037036,1,1,1,2
2022-09-20 14:42:55,1.280775462962963,5,15,9,24
2022-09-20 08:59:33,1.8998726851851853,13,224,52,276
2022-11-01 00:03:38,44.587743055555556,34,6496,1978,8474
2022-09-20 16:27:27,21.162349537037038,4,60,69,129
2022-09-22 14:51:44,5.9144907407407405,3,11,179,190
2022-09-16 20:09:19,0.18138888888888888,1,15,2,17
2022-09-16 20:07:08,0.18998842592592594,1,1,5,6
2022-09-16 20:06:22,0.23625,1,7,2,9
2022-11-07 19:09:14,62.55689814814815,11,11949,4127,16076
2022-10-02 18:05:46,17.826886574074074,10,207,94,301
2022-09-16 12:48:24,0.822488425925926,1,1,1,2
2022-09-14 21:32:47,0.15744212962962964,1,1,2,3
2022-09-13 19:59:40,0.016724537037037038,1,6,5,11
2022-09-13 06:20:16,0.20804398148148148,1,1,1,2
2022-09-12 20:38:18,0.04600694444444445,1,5,1,6
2022-09-12 20:45:58,0.8731018518518519,1,25,13,38
2022-09-20 08:33:03,7.897175925925926,1,40,128,168
2022-09-20 17:24:31,8.329305555555555,2,14,6,20
2022-09-13 03:53:38,0.9557407407407408,1,28,16,44
2022-09-12 02:22:13,0.0005671296296296297,1,1,1,2
2022-09-12 20:35:55,1.9070486111111111,2,44,28,72
2022-09-12 21:03:59,1.9804513888888888,2,44,29,73
2022-09-12 21:05:34,1.2655439814814815,4,104,68,172
2022-09-11 19:31:14,0.15032407407407408,1,1,1,2
2022-09-22 16:41:56,12.27355324074074,12,18097,4705,22802
2022-09-11 09:47:15,0.011238425925925926,1,1,1,2
2022-12-09 18:22:21,90.7857986111111,8,22258,7103,29361
2022-09-10 00:32:58,0.1250925925925926,1,1,1,2
2022-09-09 14:54:04,0.04125,1,1,1,2
2022-09-13 11:56:04,8.713854166666666,3,27,8,35
2022-09-11 07:34:05,1.9210532407407408,3,20,20,40
2022-09-23 22:48:04,14.827256944444445,3,7,6,13
2022-09-20 21:48:55,12.035729166666666,2,21,19,40
2022-09-08 21:27:59,0.050902777777777776,1,1,1,2
2022-09-08 10:35:05,0.0827662037037037,1,37,37,74
2022-09-07 20:07:18,0.11061342592592592,1,39,46,85
2022-09-07 18:16:56,0.44810185185185186,1,2,1,3
2022-09-09 07:19:48,2.8915625,1,9,7,16
2022-09-06 06:54:45,0.03136574074074074,1,1,1,2
2022-11-20 12:51:25,82.23574074074074,24,13644,4895,18539
2022-09-11 20:15:14,5.979409722222222,1,24,33,57
2022-09-05 11:26:23,0.06655092592592593,1,2,2,4
2023-01-22 00:58:17,138.76818287037037,28,196,91,287
2022-09-05 05:38:57,0.2907986111111111,1,1,1,2
2022-09-05 07:49:12,694.0484606481482,1,12,0,12
2022-09-05 16:08:41,0.8329861111111111,4,485,145,630
2022-09-04 08:34:23,0.2570601851851852,1,1,1,2
2022-09-05 08:45:12,1.825150462962963,4,20,5,25
2022-09-15 08:53:46,11.797037037037038,2,18,6,24
2022-09-04 20:33:35,1.4643055555555555,1,1,1,2
2022-09-09 14:48:40,6.646608796296296,7,178,39,217
2022-09-22 20:31:45,20.174652777777776,16,490,167,657
2022-09-05 07:55:29,3.3907175925925928,1,2,2,4
2022-09-01 22:21:03,0.04825231481481482,2,3,3,6
2022-09-03 07:45:43,2.4590162037037038,1,154,186,340
2022-10-21 06:30:08,63.405347222222225,2,99,17,116
2022-08-31 18:23:19,0.25783564814814813,4,17,19,36
2022-09-02 05:35:06,1.7173958333333332,3,99,100,199
2022-09-01 08:14:01,1.2924421296296296,2,6,4,10
2023-05-24 18:52:28,266.7675925925926,9,68901,26592,95493
2022-08-31 10:41:57,0.6551157407407407,1,1,1,2
2022-09-06 06:45:07,6.754791666666667,2,12,2,14
2022-09-09 11:03:18,10.004016203703705,2,226,1,227
2022-08-30 02:27:59,0.11293981481481481,1,4,3,7
2022-09-14 16:46:37,15.898113425925926,14,1728,877,2605
2022-08-29 13:19:54,0.04238425925925926,2,9,4,13
2022-08-28 13:56:28,0.11709490740740741,1,2,0,2
2022-08-28 19:01:38,6.9357291666666665,4,21,9,30
2022-08-27 16:29:20,0.5671875,1,55,0,55
2022-08-27 00:14:41,0.05957175925925926,1,1,1,2
2022-12-04 04:51:57,99.57689814814815,12,25049,8099,33148
2022-08-31 09:36:06,4.816412037037037,3,20,16,36
2022-08-27 09:09:02,1.0407060185185186,1,4,0,4
2022-09-11 02:32:41,15.867557870370371,3,113,58,171
2022-08-25 09:10:57,0.11979166666666667,1,7,5,12
2022-10-11 20:09:04,47.87078703703704,9,6863,2042,8905
2022-08-25 08:18:26,0.3489814814814815,1,1,1,2
2022-08-25 01:32:29,0.1116087962962963,1,4,0,4
2022-08-26 14:12:14,1.959375,1,26,1,27
2022-08-24 10:26:26,0.07928240740740741,1,2,2,4
2022-09-08 01:56:23,14.826157407407408,5,246,140,386
2022-08-24 08:06:35,0.13896990740740742,1,0,4,4
2022-08-24 15:20:17,0.5782060185185185,1,28,1,29
2022-08-24 09:09:10,0.4428240740740741,4,31,56,87
2022-08-23 21:38:21,0.006597222222222222,1,1,2,3
2022-08-24 00:01:54,0.14238425925925927,4,40,41,81
2022-08-23 19:14:16,0.18375,1,39,22,61
2022-08-23 14:39:32,0.5192013888888889,1,37,5,42
2022-09-08 15:21:40,17.15565972222222,1,1,1,2
2022-08-22 09:21:09,0.18100694444444446,3,53,13,66
2022-08-22 13:56:24,0.6453935185185186,1,18,2,20
2022-08-29 12:13:49,7.755578703703704,1,15,1,16
2022-09-05 08:33:27,15.568912037037038,4,135,35,170
2022-08-21 10:15:27,0.7608912037037037,11,86,79,165
2022-08-31 16:50:22,152.9088888888889,2,28466,13798,42264
2022-08-23 20:28:24,8.099375,5,20,6,26
2022-08-20 07:16:36,0.2732986111111111,2,11,9,20
2022-08-20 04:01:03,0.2520949074074074,1,28,7,35
2022-08-31 16:44:15,11.88351851851852,2,162,117,279
2022-08-19 10:05:59,0.09420138888888889,1,10,0,10
2022-08-19 20:13:54,0.834212962962963,1,18,7,25
2022-08-24 14:05:34,5.848703703703704,10,79,39,118
2022-08-19 20:26:19,1.5160648148148148,4,149,5,154
2022-08-19 20:10:25,1.544537037037037,3,5,4,9
2022-08-28 16:44:05,10.829247685185186,3,41,13,54
2022-08-19 01:26:17,1.226423611111111,1,50,51,101
2022-08-17 14:16:47,0.06400462962962963,1,9,9,18
2022-08-21 08:09:28,3.927534722222222,2,4,4,8
2022-08-17 09:29:29,0.5479861111111111,2,58,21,79
2022-08-18 06:15:12,1.3827083333333334,3,20,8,28
2022-09-15 13:19:05,30.428981481481483,5,27,24,51
2022-08-23 13:10:43,142.5333912037037,37,6137,2865,9002
2022-08-19 21:02:24,4.094791666666667,7,78,49,127
2023-02-19 22:53:24,188.35336805555556,14,40853,11681,52534
2022-08-14 09:55:27,0.1365162037037037,1,2,2,4
2022-08-22 06:31:00,7.685196759259259,1,25,25,50
2022-08-25 07:12:24,11.47454861111111,9,300,105,405
2022-08-16 09:14:02,3.730289351851852,6,825,768,1593
2022-08-16 09:19:18,4.133333333333334,3,37,11,48
2022-08-16 09:22:56,4.255752314814814,4,254,32,286
2022-08-12 06:50:58,0.4670023148148148,5,31,13,44
2022-08-13 15:47:49,1.8690972222222222,2,6,8,14
2022-08-11 17:53:59,0.23846064814814816,1,2,0,2
2022-09-09 11:48:52,28.959629629629628,1,9,2,11
2022-08-13 15:42:28,2.1061111111111113,1,86,2,88
2022-08-11 06:55:17,0.2643171296296296,1,27,68,95
2022-08-11 08:38:10,0.6231134259259259,1,1,1,2
2022-08-10 16:00:03,0.11747685185185185,1,128,130,258
2022-08-14 09:58:36,4.075300925925926,2,674,739,1413
2022-10-03 00:45:49,53.93442129629629,23,12885,3823,16708
2022-08-09 13:22:21,0.08471064814814815,2,15,16,31
2022-08-09 09:14:53,0.5992939814814815,1,11,0,11
2022-08-08 12:44:43,0.1267939814814815,2,5,2,7
2022-08-26 12:19:30,18.236793981481483,10,2018,1479,3497
2022-11-20 01:15:48,104.33672453703704,15,22930,7131,30061
2022-08-10 06:38:29,2.6628819444444445,8,141,376,517
2022-08-09 15:29:08,1.9709837962962964,5,1644,217,1861
2022-08-07 13:13:10,0.7203240740740741,4,83,29,112
2022-08-08 10:12:25,1.9621412037037036,1,23,0,23
2022-08-16 06:46:22,9.836238425925925,2,9,3,12
2022-09-07 14:35:31,32.33505787037037,7,11159,2998,14157
2022-08-17 18:14:32,11.552650462962964,2,37,16,53
2022-08-16 02:17:39,12.098738425925927,5,3771,1735,5506
2022-09-01 08:23:16,26.427083333333332,1,42,1,43
2023-03-19 22:18:08,226.3608449074074,9,51488,16429,67917
2022-08-08 08:57:55,3.4304282407407407,3,36,12,48
2022-08-04 23:06:24,0.09930555555555555,2,84,78,162
2022-08-04 21:55:11,0.03469907407407408,1,3,1,4
2022-08-31 20:16:35,27.11060185185185,6,60,45,105
2022-08-04 05:20:56,0.05748842592592593,1,3,3,6
2022-08-05 15:37:18,1.7400578703703704,2,129,19,148
2022-08-04 09:42:12,0.6882175925925926,2,6,4,10
2022-08-04 01:17:33,0.4476967592592593,1,1,1,2
2022-08-03 11:57:10,0.410474537037037,1,9,9,18
2022-08-03 03:05:16,0.32296296296296295,1,6,0,6
2022-08-02 20:04:17,0.05590277777777778,1,7,7,14
2022-09-02 03:09:59,31.07689814814815,5,9735,2371,12106
2022-08-02 02:51:52,7.303553240740741,1,21,9,30
2022-08-02 09:03:55,0.801238425925926,1,1,1,2
2022-08-01 14:45:01,0.10608796296296297,1,1,1,2
2022-08-07 09:00:52,6.361875,9,33,12,45
2022-08-01 17:26:53,0.7403703703703703,2,29,29,58
2022-08-01 08:06:18,0.5609375,1,12,2,14
2022-08-01 07:16:48,0.7022569444444444,10,19,22,41
2022-08-01 07:47:39,1.4514467592592593,1,6,6,12
2022-08-04 07:36:31,4.980011574074074,2,1,11,12
2022-08-04 20:49:45,5.959131944444445,5,34,56,90
2022-07-29 20:11:20,0.02199074074074074,1,1,1,2
2022-07-29 20:09:00,0.23453703703703704,1,8,7,15
2022-07-29 20:18:31,0.06243055555555556,2,7,2,9
2022-07-29 18:51:55,0.14733796296296298,1,208,30,238
2022-07-29 08:09:38,0.3363888888888889,1,5,1,6
2022-07-29 20:15:05,0.896087962962963,2,58,54,112
2022-07-29 06:15:48,0.3850462962962963,1,12,0,12
2022-07-30 16:44:35,1.8236342592592591,1,4,4,8
2022-07-30 21:31:55,2.586087962962963,3,26,12,38
2022-07-28 06:43:47,0.028877314814814814,1,19,3,22
2022-07-28 07:07:02,0.05229166666666667,1,13,6,19
2022-07-29 09:58:09,1.3663194444444444,1,22,65,87
2022-08-01 08:01:12,4.4199421296296295,3,58,6,64
2022-08-01 07:12:56,4.385810185185186,3,90,14,104
2022-11-27 20:42:56,123.24083333333333,67,25370,8051,33421
2022-07-27 15:25:21,0.07641203703703704,1,2,1,3
2022-10-31 05:19:59,109.5182638888889,28,2669,1689,4358
2022-07-27 09:21:19,0.004537037037037037,1,1,1,2
2022-07-27 14:49:05,0.8540856481481481,5,33,13,46
2022-07-27 09:50:55,0.7167476851851852,1,31,27,58
2022-07-26 20:06:40,0.37559027777777776,2,39,110,149
2022-07-26 05:13:33,0.3591550925925926,1,4,4,8
2022-09-08 01:52:10,44.41796296296296,12,15406,7158,22564
2022-11-25 00:23:38,122.6594212962963,4,72,60,132
2022-08-26 21:51:38,2588.9205439814814,13,652469,408387,1060856
2022-07-28 00:28:57,703.4293518518518,1,26,0,26
2022-07-27 13:38:31,3.6814930555555554,4,8,9,17
2022-07-24 08:57:44,0.5017824074074074,1,0,62,62
2022-07-23 21:10:46,0.1491898148148148,1,3,0,3
2022-07-26 11:35:12,2.776087962962963,1,46,41,87
2022-07-23 21:08:35,0.21563657407407408,1,13,0,13
2022-07-24 21:36:37,1.224074074074074,1,4,3,7
2022-07-23 17:19:22,0.11350694444444444,1,20,9,29
2022-09-15 09:48:30,54.44048611111111,2,5919,2463,8382
2022-07-26 11:37:22,3.6205902777777776,1,0,53,53
2022-07-23 13:16:55,0.6919328703703703,1,1,3,4
2022-07-22 20:10:00,0.12127314814814814,1,6,14,20
2022-07-22 19:17:05,0.13876157407407408,2,2,2,4
2022-07-22 12:30:38,0.1161574074074074,1,2,2,4
2022-07-22 14:30:48,0.20399305555555555,1,1,1,2
2022-07-22 22:51:24,0.8116203703703704,1,15,4,19
2022-07-22 02:15:40,0.14671296296296296,1,6,6,12
2022-07-21 22:13:25,0.01597222222222222,1,1,1,2
2022-07-21 21:35:07,0.10893518518518519,1,1,199,200
2022-07-22 16:48:05,1.1149421296296296,4,86,16,102
2024-01-24 00:23:28,551.7341319444445,42,147505,66392,213897
2022-07-21 12:51:04,1.1990509259259259,3,127,122,249
2022-07-25 02:33:51,4.106840277777778,3,28,9,37
2022-07-22 00:21:35,1.0785763888888888,2,25,12,37
2022-08-04 22:22:36,15.220497685185185,9,129,105,234
2022-12-03 05:40:38,136.66207175925925,10,26518,8686,35204
2022-07-20 07:05:55,0.0863425925925926,1,12,34,46
2022-07-20 21:34:53,0.7930208333333333,3,165,113,278
2022-07-20 07:02:41,0.2374189814814815,1,20,0,20
2022-07-19 23:19:28,747.3668865740741,5,29,17,46
2022-07-19 23:31:15,0.2,1,9,9,18
2022-10-04 18:01:01,36.48972222222222,1,11,9,20
2022-07-19 23:57:17,0.47280092592592593,1,3,3,6
2022-07-19 23:49:25,0.8910069444444444,3,148,17,165
2022-07-24 07:47:43,5.85431712962963,3,278,47,325
2022-09-01 08:50:55,44.36739583333333,2,3,2,5
2022-07-23 13:39:28,4.645034722222222,1,2,1,3
2022-07-22 20:01:56,4.0771875,2,3,2,5
2022-07-22 07:04:59,3.6040277777777776,4,37,47,84
2022-07-17 17:58:35,0.02914351851851852,1,3,3,6
2022-07-20 07:16:57,2.605439814814815,5,96,33,129
2022-09-04 19:18:06,49.12244212962963,5,16,15,31
2022-07-17 21:11:03,0.20668981481481483,1,3,1,4
2022-07-17 21:23:26,0.5953240740740741,2,50,20,70
2022-07-20 00:17:31,2.776712962962963,4,29,14,43
2022-07-17 05:09:15,0.1360300925925926,1,7,7,14
2022-09-27 15:44:26,72.72609953703704,31,17118,5545,22663
2022-07-17 02:20:18,0.169375,1,8,8,16
2022-12-03 03:02:00,139.2065625,7,85,53,138
2022-07-17 15:03:33,0.7881712962962963,9,118,75,193
2022-07-18 06:57:22,1.6442592592592593,9,71,22,93
2022-07-17 05:12:04,0.38752314814814814,2,6,5,11
2022-07-22 11:07:32,5.675925925925926,6,71,70,141
2022-07-16 20:59:45,0.13921296296296296,3,3,5,8
2022-07-16 16:55:12,0.024918981481481483,1,9,0,9
2022-07-17 14:50:04,0.9665162037037037,10,235,301,536
2022-07-16 16:56:59,0.06390046296296296,2,9,2,11
2022-07-16 16:07:21,0.013819444444444445,1,6,2,8
2022-07-18 06:52:16,1.642673611111111,9,22,1,23
2022-07-18 07:00:50,1.650613425925926,11,90,50,140
2022-07-16 16:04:53,0.03836805555555556,1,33,0,33
2022-07-16 18:48:59,0.17175925925925925,3,28,8,36
2022-07-27 15:28:40,17.216805555555556,7,82,56,138
2022-07-17 06:37:26,1.341261574074074,1,10,10,20
2022-07-15 18:35:50,0.09752314814814815,1,0,7,7
2022-07-16 23:41:27,2.7144328703703704,4,300,583,883
2022-07-15 21:18:13,1.6149652777777779,2,41,169,210
2022-07-15 21:14:08,1.7838078703703704,7,48,18,66
2022-07-14 13:52:56,0.7229050925925926,3,11,3,14
2022-07-14 23:19:00,1.2769560185185185,7,208,301,509
2022-07-13 13:14:57,0.21949074074074074,1,63,2,65
2022-07-14 16:34:33,1.4850347222222222,3,209,136,345
2022-07-13 07:34:52,0.20751157407407408,4,177,84,261
2022-07-23 20:47:30,10.972997685185184,3,89,28,117
2022-07-12 20:33:45,0.06385416666666667,1,10,1,11
2022-07-21 21:50:26,9.165474537037037,4,9,4,13
2022-07-13 14:04:40,0.9095138888888888,1,55,92,147
2022-07-12 13:52:19,0.3723726851851852,1,23,22,45
2022-07-13 00:08:22,1.8288078703703703,1,1,1,2
2022-07-10 22:00:27,0.2814699074074074,1,1,1,2
2022-07-15 15:29:30,9.145358796296296,15,135,110,245
2022-07-11 06:06:41,1.2413657407407408,7,18,11,29
2022-07-10 00:08:41,0.28541666666666665,1,3,4,7
2022-07-09 09:53:45,0.13982638888888888,2,55,11,66
2022-07-09 09:51:46,0.5331134259259259,1,6,3,9
2022-07-15 12:26:58,6.891030092592593,26,114,113,227
2022-07-27 19:01:25,19.24965277777778,1,7,8,15
2022-07-08 16:11:19,1.7382638888888888,2,99,35,134
2022-07-07 07:37:39,0.21590277777777778,1,26,4,30
2022-07-07 07:34:42,0.32944444444444443,2,51,47,98
2022-07-08 23:33:26,2.481423611111111,8,60,65,125
2022-07-12 03:46:49,5.946365740740741,9,31,14,45
2022-07-08 08:57:03,2.6475925925925927,3,48,37,85
2022-07-05 13:54:52,0.0038657407407407408,1,1,0,1
2022-07-05 13:30:11,36.85787037037037,1,2,8,10
2022-07-05 11:56:47,0.041944444444444444,1,2,2,4
2022-07-05 09:28:42,0.010532407407407407,1,1,1,2
2022-07-05 14:14:02,1.168576388888889,1,4,3,7
2022-10-09 19:38:32,97.03894675925926,7,20859,6635,27494
2022-08-04 14:06:03,30.903055555555557,4,124,62,186
2022-07-04 16:02:17,0.20628472222222222,1,20,2,22
2022-07-24 08:14:37,20.114050925925927,4,3180,1894,5074
2022-07-04 00:57:17,0.04833333333333333,1,1,1,2
2022-07-05 14:16:08,1.8533680555555556,1,2,2,4
2022-07-04 10:07:52,0.7055555555555556,1,7,5,12
2022-07-04 14:55:41,1.0194907407407408,1,3,3,6
2022-07-27 18:00:20,24.171215277777776,8,173,13,186
2022-09-19 18:16:23,86.0341087962963,3,10,5,15
2022-07-03 14:14:32,0.12611111111111112,1,5,1,6
2022-07-03 14:19:56,0.13820601851851852,1,10,4,14
2022-07-03 14:22:17,0.2992939814814815,1,8,8,16
2022-07-07 08:26:04,4.480266203703704,2,48,24,72
2022-07-04 20:46:28,2.2160185185185184,2,10,8,18
2022-07-02 10:39:19,0.0734837962962963,1,11,1,12
2022-07-04 19:12:12,3.089965277777778,7,38,36,74
2022-09-01 08:40:56,61.763888888888886,1,3,2,5
2022-07-01 14:30:16,0.10268518518518518,1,1,1,2
2022-07-24 14:14:40,23.150844907407407,2,42,41,83
2022-07-18 06:56:48,16.87159722222222,7,265,14,279
2022-08-11 18:45:40,45.901238425925925,27,8498,3261,11759
2022-06-30 22:56:35,0.4512847222222222,1,4,4,8
2022-10-09 19:02:36,178.93119212962964,8,58805,21579,80384
2022-06-30 17:40:40,0.09539351851851852,1,3,3,6
2022-08-16 18:00:37,47.15222222222222,9,6436,2965,9401
2022-06-30 14:13:11,0.010810185185185185,1,5,6,11
2022-06-30 13:32:19,0.09778935185185185,1,1,1,2
2022-07-01 14:17:27,1.8869560185185186,2,14,9,23
2022-06-30 14:11:45,0.8969444444444444,1,53,0,53
2022-06-30 14:23:05,0.9367592592592593,4,58,14,72
2022-06-29 15:10:56,0.1287962962962963,1,24,0,24
2022-06-30 14:17:09,1.920960648148148,9,46,29,75
2022-07-05 09:41:29,6.762141203703703,3,46,27,73
2022-07-01 14:34:51,3.124212962962963,1,240,1,241
2022-06-29 00:12:55,0.5402893518518519,1,0,9,9
2022-06-29 17:18:12,1.3151736111111112,2,5,2,7
2022-06-29 06:00:51,0.9931365740740741,3,44,36,80
2022-06-28 11:19:31,0.9355902777777778,2,13,8,21
2022-06-28 11:26:57,1.5397222222222222,1,48,42,90
2022-06-27 15:28:25,0.9136689814814815,15,177,110,287
2022-06-26 13:52:14,0.2032986111111111,1,2,1,3
2022-06-26 18:07:44,0.7185532407407408,1,25,5,30
2022-06-26 18:09:29,2.614074074074074,5,49,22,71
2022-06-23 16:48:43,0.08881944444444445,1,1,1,2
2022-06-24 04:47:38,0.8779166666666667,14,127,108,235
2022-06-23 08:57:44,0.3043865740740741,1,5,1,6
2022-08-16 00:32:29,54.12424768518518,9,17444,7675,25119
2022-06-28 09:09:55,5.528935185185185,4,77,23,100
2022-06-22 21:41:06,0.29899305555555555,1,37,37,74
2022-06-30 14:20:44,8.610671296296296,6,817,260,1077
2022-06-24 07:18:58,2.6209375,2,54,6,60
2022-06-24 14:04:24,3.8555439814814814,2,26,8,34
2022-07-02 11:16:40,18.91695601851852,1,13,11,24
2022-06-20 12:56:43,2.8011574074074073,1,12,8,20
2022-06-21 22:28:46,1.9959027777777778,3,29,15,44
2022-06-21 22:33:40,8.189652777777777,1,44,27,71
2022-06-22 09:31:56,8.663287037037037,4,114,97,211
2022-06-19 20:42:08,0.19177083333333333,1,0,35,35
2022-06-19 20:48:34,0.23377314814814815,1,5,4,9
2022-07-25 22:24:13,37.3628125,37,8180,4760,12940
2022-06-28 04:11:36,9.021666666666667,5,118,8,126
2022-06-18 23:23:22,0.29484953703703703,1,3,5,8
2022-06-18 11:42:30,0.0010069444444444444,1,4,4,8
2022-06-19 03:09:45,0.812650462962963,1,10,0,10
2022-07-22 16:36:35,34.47429398148148,15,4535,2347,6882
2022-06-18 11:28:59,0.8793865740740741,1,30,47,77
2022-06-17 22:18:11,0.25475694444444447,1,1,1,2
2022-06-17 21:56:49,0.29814814814814816,1,1,1,2
2022-06-18 11:25:10,0.9619212962962963,2,8,12,20
2022-08-04 16:33:32,48.44171296296296,10,33,53,86
2022-06-17 12:57:21,0.32288194444444446,1,14,4,18
2022-06-16 08:29:24,0.1428125,1,18,18,36
2022-06-16 08:35:36,0.2909259259259259,1,12,10,22
2022-06-27 06:28:13,11.809409722222222,3,17,6,23
2022-06-16 01:59:02,2.4956134259259257,4,362,142,504
2022-08-26 19:07:31,73.0275925925926,1,8,8,16
2022-06-14 08:52:05,0.5846990740740741,1,16,16,32
2022-06-14 03:04:51,0.3700347222222222,2,5,3,8
2022-06-13 14:12:58,0.07609953703703703,1,1,26,27
2022-06-14 15:18:14,1.2738194444444444,2,2,2,4
2022-06-13 07:32:50,0.8377314814814815,2,17,3,20
2022-06-15 07:03:59,3.1902314814814816,1,8,1,9
2022-06-13 07:43:36,1.4412268518518518,4,23,14,37
2022-06-13 07:36:53,1.7841319444444443,1,19,5,24
2022-06-15 22:06:53,4.643356481481481,3,27,15,42
2022-06-10 20:12:23,0.513425925925926,3,6,6,12
2022-06-13 17:53:06,4.169560185185185,1,37,0,37
2022-06-14 08:42:12,5.135613425925926,3,11,8,19
2022-06-09 09:08:54,0.7377546296296297,5,10,7,17
2022-06-09 10:29:57,0.7992013888888889,2,6,2,8
2022-06-17 10:21:50,8.834953703703704,3,27,684,711
2022-06-13 10:03:52,4.831840277777777,3,12,10,22
2022-06-08 13:06:09,0.30453703703703705,1,1,1,2
2022-06-13 20:29:01,6.33925925925926,18,5941,2186,8127
2022-06-06 19:00:37,0.4152662037037037,3,24,8,32
2022-06-08 05:58:02,2.0977083333333333,3,64,5,69
2022-06-05 22:43:22,0.24247685185185186,1,2,1,3
2022-06-05 12:24:12,0.0016087962962962963,1,1,0,1
2022-10-08 07:13:11,126.59711805555555,5,8778,5017,13795
2022-07-03 12:28:03,28.74525462962963,7,84,35,119
2022-12-06 03:41:47,189.31204861111112,11,39027,13924,52951
2022-06-04 14:06:08,0.1632986111111111,2,0,6,6
2022-07-29 15:08:42,55.78936342592593,3,19,2,21
2022-06-02 19:08:22,0.1180787037037037,1,14,2,16
2022-06-02 09:40:08,0.04920138888888889,1,6,6,12
2022-06-02 15:03:11,0.34457175925925926,1,4,58,62
2022-06-02 14:54:36,0.518449074074074,1,5,1,6
2022-06-01 16:41:18,0.028668981481481483,1,7,1,8
2022-06-03 09:06:02,1.8876157407407408,4,229,133,362
2022-06-01 07:10:34,0.1253587962962963,1,17,1,18
2022-05-31 12:15:17,0.02820601851851852,1,11,5,16
2022-05-31 11:45:38,0.053460648148148146,2,28,36,64
2022-05-31 14:04:56,0.5680787037037037,1,3,3,6
2022-05-30 22:04:10,0.07135416666666666,1,5,7,12
2022-12-05 21:34:29,189.15609953703705,68,41206,14978,56184
2022-06-12 15:55:02,13.083518518518519,1,2,0,2
2022-07-01 15:35:21,35.199699074074076,4,182,37,219
2022-05-30 17:06:40,0.36572916666666666,3,17,3,20
2022-06-07 23:05:21,8.617673611111112,10,1897,664,2561
2022-05-30 00:58:45,0.043298611111111114,1,3,2,5
2023-02-13 15:51:34,259.72702546296296,45,86388,30294,116682
2022-05-29 16:23:18,0.0487037037037037,2,41,8,49
2022-06-10 11:57:01,11.942361111111111,7,169,156,325
2022-05-29 16:24:13,0.26744212962962965,1,11,1,12
2022-05-29 20:39:30,0.4508564814814815,2,74,266,340
2022-06-18 11:36:09,20.750173611111112,1,0,4,4
2022-05-30 23:02:52,2.25125,1,133,2,135
2022-05-28 14:12:10,0.024780092592592593,1,1,1,2
2022-05-28 15:44:45,0.1024074074074074,1,21,44,65
2022-12-02 23:15:21,188.50241898148147,3,92,11,103
2022-05-27 11:25:12,0.12369212962962962,1,7,7,14
2022-05-30 18:06:08,77.42096064814815,30,28751,15793,44544
2022-06-26 11:02:08,30.808611111111112,1,36,2,38
2022-05-26 20:57:15,0.30074074074074075,1,9,3,12
2022-05-26 11:33:45,0.2472337962962963,2,19,19,38
2022-05-26 08:51:40,0.32895833333333335,1,16,0,16
2022-05-28 16:23:24,2.8975115740740742,1,40,7,47
2022-05-25 18:04:23,0.10552083333333333,1,22,18,40
2022-05-26 12:55:03,0.9981018518518519,1,5,7,12
2022-05-25 19:15:09,0.32513888888888887,5,12,24,36
2022-08-01 02:18:19,67.87828703703704,2,27,0,27
2022-05-25 02:56:05,0.14255787037037038,1,1,1,2
2022-05-24 22:18:56,167.3677662037037,5,72,31,103
2022-05-27 22:36:55,3.581770833333333,5,43,33,76
2022-05-24 21:34:08,0.4225,4,46,27,73
2022-05-23 23:24:57,0.14569444444444443,1,2,2,4
2022-05-24 21:37:13,1.127164351851852,2,32,12,44
2022-05-24 22:24:52,1.3978009259259259,3,33,16,49
2022-05-23 12:49:11,0.7048611111111112,3,14,1,15
2022-05-30 22:57:59,8.033773148148148,7,1131,215,1346
2022-05-23 13:39:58,0.7132291666666667,3,7,11,18
2022-05-22 13:20:48,0.13761574074074073,2,20,81,101
2022-06-21 00:03:32,30.084988425925925,1,11,1,12
2022-05-30 21:55:37,9.096886574074073,2,21,17,38
2022-05-22 18:07:58,1.1125462962962962,1,7,4,11
2022-06-12 06:58:32,21.690300925925925,11,5952,2767,8719
2022-05-20 19:49:51,0.012824074074074075,1,2,1,3
2022-05-22 11:24:18,1.9137731481481481,1,2,3,5
2022-05-21 17:12:24,1.013425925925926,1,10,15,25
2022-11-29 11:25:27,1.5507870370370371,3,248,89,337
2022-05-20 17:54:20,0.12321759259259259,1,3,3,6
2022-06-24 11:37:11,34.87393518518518,2,45,21,66
2022-05-22 16:41:17,2.0944328703703703,2,1434,1412,2846
2022-05-23 06:52:30,1115.8905902777778,17,2587,2176,4763
2022-05-19 04:37:33,0.14041666666666666,1,79,0,79
2022-06-02 15:01:42,420.5317592592593,28,227661,218285,445946
2022-05-18 22:22:36,0.2147800925925926,2,2,2,4
2022-05-20 10:24:52,2.058923611111111,2,2,14,16
2022-05-18 08:56:27,0.5522106481481481,1,4,4,8
2022-05-19 19:57:20,3.014212962962963,1,28,8,36
2022-05-28 04:22:23,136.38881944444444,17,460,379,839
2022-05-18 17:59:28,298.0000462962963,5,28,16,44
2022-05-20 13:35:29,5.820150462962963,2,59,36,95
2022-05-15 14:19:57,0.9215162037037037,2,17,40,57
2022-05-16 06:43:30,1.6609027777777778,2,50,51,101
2022-05-14 09:33:52,0.10629629629629629,2,17,4,21
2022-05-14 14:01:44,0.3955092592592593,1,4,3,7
2022-05-14 12:30:51,0.43950231481481483,1,1,1,2
2022-05-14 21:27:56,0.9357638888888888,1,1,6,7
2022-05-24 12:24:33,10.665034722222222,1,89,71,160
2022-05-13 20:11:34,0.042291666666666665,1,2,1,3
2022-05-13 18:54:19,0.0961111111111111,2,4,1,5
2022-05-13 18:34:14,0.02435185185185185,1,2,2,4
2022-05-16 15:30:36,3.511689814814815,1,24,31,55
2022-05-13 16:17:44,0.5988657407407407,2,91,28,119
2022-05-16 14:15:22,6.148368055555555,6,185,149,334
2022-05-13 20:09:50,1.0203819444444444,2,51,46,97
2022-05-13 18:47:19,1.095636574074074,1,1,1,2
2022-05-16 17:13:29,4.554942129629629,2,12,5,17
2022-05-11 17:37:58,0.09498842592592592,3,8,3,11
2022-05-10 17:18:54,0.09038194444444445,2,12,7,19
2022-05-11 01:39:53,1.2033680555555555,1,2,4,6
2022-05-13 12:54:03,3.796284722222222,1,3,1,4
2022-05-16 16:29:51,23.52375,10,75,22,97
2022-05-13 23:22:29,5.097939814814815,1,19,66,85
2022-05-08 18:58:46,0.6069675925925926,2,4,4,8
2022-06-14 18:22:25,37.64761574074074,12,10215,3066,13281
2022-05-10 16:11:36,3.250590277777778,1,1,0,1
2022-05-08 14:43:57,16.269201388888888,7,152,226,378
2022-05-13 21:24:07,6.744537037037037,1,13,5,18
2022-05-13 17:06:14,6.711712962962963,2,98,21,119
2022-05-06 16:08:43,0.08902777777777778,1,6,0,6
2022-05-07 07:10:40,1.2237037037037037,2,61,13,74
2022-05-05 20:43:16,0.19583333333333333,2,19,17,36
2022-05-05 13:53:40,0.011770833333333333,1,3,3,6
2022-05-05 01:29:59,0.05451388888888889,1,2,2,4
2022-05-06 02:34:18,1.3440625,1,3,3,6
2022-05-29 21:44:44,25.264074074074074,7,8139,2759,10898
2022-05-04 14:27:20,0.059131944444444445,2,39,91,130
2022-05-13 21:27:55,10.142662037037036,1,20,2,22
2022-07-04 18:35:54,63.040613425925926,16,13737,6206,19943
2022-05-03 14:14:38,0.06298611111111112,1,25,25,50
2022-05-03 15:45:55,0.14788194444444444,2,18,2,20
2022-05-03 14:17:15,0.12899305555555557,2,9,2,11
2022-05-03 16:02:06,0.6138310185185185,1,11,0,11
2022-05-03 02:27:38,0.16403935185185184,2,4,2,6
2022-05-03 07:34:33,0.6484375,1,2,1,3
2022-11-20 19:56:20,202.22090277777778,5,33,20,53
2022-05-02 22:46:03,0.3392939814814815,4,4,16,20
2022-05-04 01:54:41,1.7555439814814815,2,7,7,14
2022-05-05 17:06:25,3.459861111111111,2,127,10,137
2022-05-02 14:57:58,0.3707986111111111,1,5,0,5
2022-05-02 01:58:07,0.981400462962963,1,1,1,2
2022-04-30 20:59:54,0.05028935185185185,1,1,1,2
2022-04-30 17:18:18,0.41171296296296295,15,295,144,439
2022-05-04 18:15:08,13.233541666666667,9,1157,237,1394
2022-04-30 07:48:22,0.00018518518518518518,1,43,288,331
2022-04-30 04:31:32,0.1991550925925926,2,3,3,6
2022-05-04 14:42:04,13.870486111111111,6,100,20,120
2022-12-10 15:08:31,224.96708333333333,2,1,8,9
2022-05-01 23:02:57,2.3181712962962964,3,131,4,135
2022-06-09 06:36:57,41.304398148148145,10,12416,3938,16354
2022-04-28 23:29:40,0.10663194444444445,1,3,15,18
2022-04-29 22:05:38,1.0810416666666667,4,295,50,345
2022-05-02 10:04:06,3.99375,4,187,37,224
2022-04-28 15:33:37,0.2244560185185185,2,18,18,36
2022-04-28 16:19:59,0.38274305555555554,1,4,4,8
2022-05-18 17:50:12,20.746157407407406,6,146,103,249
2022-05-03 08:00:28,5.414780092592593,1,22,4,26
2022-04-30 05:36:00,2.3944328703703706,1,34,17,51
2022-05-25 03:33:25,27.604664351851852,3,232,145,377
2022-04-27 21:54:59,1.3285416666666667,6,34,33,67
2022-04-25 13:57:20,0.01412037037037037,1,13,1,14
2022-05-04 14:35:50,14.585543981481482,2,69,183,252
2022-04-25 12:00:24,0.14563657407407407,3,97,12,109
2022-05-25 03:48:19,30.32287037037037,6,271,71,342
2022-04-25 18:59:20,1.0261458333333333,1,3,3,6
2022-04-24 22:08:54,0.23855324074074075,1,3,3,6
2022-04-24 16:02:47,0.05197916666666667,1,2,2,4
2022-04-24 09:06:45,0.3891898148148148,1,2,2,4
2022-04-26 19:53:44,3.225023148148148,1,13,2,15
2022-04-23 17:41:08,0.42637731481481483,4,13,12,25
2022-04-26 19:19:08,4.038703703703704,1,25,0,25
2022-04-22 16:56:08,0.42236111111111113,5,33,20,53
2022-04-22 09:09:13,0.16694444444444445,2,22,13,35
2022-04-26 21:43:41,5.283136574074074,5,25,5,30
2022-04-21 23:49:50,0.6640972222222222,1,4,4,8
2022-04-21 07:32:21,0.6025115740740741,1,6,6,12
2022-04-20 21:34:37,0.04857638888888889,1,1,1,2
2022-04-22 12:15:36,1.7081365740740742,2,2,2,4
2022-10-02 20:12:19,165.19377314814815,5,33854,11761,45615
2022-04-20 08:01:22,0.006875,1,1,1,2
2022-04-19 22:13:37,0.0042592592592592595,1,1,1,2
2022-04-20 03:50:10,0.27412037037037035,1,2,5,7
2022-04-22 19:13:51,2.1978125,4,45,11,56
2022-04-18 09:25:07,0.12033564814814815,1,3,3,6
2022-04-18 17:37:37,0.4320833333333333,2,65,48,113
2022-04-20 12:37:00,2.4398032407407406,1,1,1,2
2022-09-27 06:02:09,190.28739583333333,33,46818,21591,68409
2022-04-18 23:10:29,1.210787037037037,2,2,0,2
2022-04-17 23:48:53,0.28805555555555556,5,44,18,62
2022-05-12 19:24:10,25.109641203703703,1,57,53,110
2022-04-26 08:52:06,86.66824074074074,3,17933,7056,24989
2022-04-15 12:35:24,0.1841898148148148,1,8,3,11
2022-04-14 21:01:48,0.13311342592592593,2,7,8,15
2022-04-22 12:37:34,9.223252314814815,1,21,0,21
2022-04-26 22:47:58,30.191666666666666,13,2194,1043,3237
2022-04-27 22:08:00,15.555208333333333,4,100,44,144
2022-04-22 12:04:54,10.788715277777778,6,82,53,135
2022-11-27 15:51:51,229.9854398148148,4,46918,18046,64964
2022-04-11 16:23:12,0.07981481481481481,1,1,1,2
2022-04-12 10:54:34,0.994386574074074,3,4,19,23
2022-06-04 17:03:48,55.43306712962963,4,773,96,869
2022-04-26 10:37:53,16.616701388888888,2,44,1,45
2022-04-15 14:57:35,40.33209490740741,50,14002,7670,21672
2023-04-18 13:48:22,375.025150462963,5,134,72,206
2022-04-07 20:37:42,0.05064814814814815,1,17,17,34
2022-06-17 04:23:18,70.43112268518519,5,45,41,86
2022-04-10 16:45:56,3.1133449074074075,5,93,28,121
2022-04-19 19:19:29,27.775868055555556,8,859,887,1746
2022-04-22 16:46:19,16.20652777777778,11,132,203,335
2022-04-27 21:10:38,21.418043981481482,4,3444,4476,7920
2022-04-05 02:21:53,0.20452546296296295,3,3,3,6
2022-04-04 22:43:55,0.07587962962962963,1,13,1,14
2022-04-14 04:41:20,10.030381944444445,4,52,22,74
2022-04-26 20:53:31,22.97195601851852,2,9,5,14
2022-04-10 11:37:44,6.771157407407407,5,134,10,144
2023-05-15 22:32:59,411.13039351851853,54,88378,37162,125540
2022-05-24 21:26:05,71.55981481481481,29,25256,13658,38914
2022-04-06 04:12:25,4.995358796296296,4,167,59,226
2022-04-02 17:36:34,0.7897685185185185,2,4,33,37
2022-04-01 23:56:36,0.11336805555555556,2,9,8,17
2022-04-01 21:46:57,0.06219907407407407,1,49,42,91
2022-04-01 17:06:58,0.6686689814814815,3,18,14,32
2022-03-31 22:40:36,0.06936342592592593,1,12,22,34
2022-04-27 17:52:17,27.455208333333335,6,75,32,107
2022-09-05 08:16:50,158.4545601851852,19,503,304,807
2022-03-30 08:35:49,0.01136574074074074,1,1,1,2
2022-04-09 12:02:41,10.238090277777777,2,56,32,88
2022-04-01 08:19:07,2.7535648148148146,2,2,2,4
2022-03-30 03:26:28,0.6511574074074075,3,13,7,20
2022-10-16 05:36:59,201.06137731481482,6,40681,16618,57299
2022-04-13 23:18:58,15.901319444444445,2,23,8,31
2022-03-27 21:50:56,0.1699537037037037,1,0,24,24
2022-05-20 11:33:14,54.00491898148148,2,15,1,16
2022-03-27 20:35:23,0.5143518518518518,3,13,13,26
2022-04-22 09:36:44,26.499583333333334,3,7,3140,3147
2022-03-30 02:19:35,3.4254166666666666,6,136,106,242
2022-03-27 23:10:44,2.1723958333333333,1,5,19,24
2022-06-09 09:14:39,75.74663194444445,1,3,24,27
2022-12-12 06:54:08,261.5315509259259,3,55636,20460,76096
2022-03-27 01:40:40,0.5832986111111111,1,2,49,51
2022-03-27 01:48:41,1.2477083333333334,1,0,12,12
2022-03-27 19:26:33,1.5172222222222222,1,0,4,4
2022-12-15 16:20:41,265.0721412037037,2,55949,20852,76801
2022-03-27 19:23:40,1.2944791666666666,1,3,6,9
2022-03-26 15:15:38,0.31787037037037036,1,3,1,4
2022-04-09 10:25:23,14.216319444444444,4,114,17,131
2022-03-25 15:14:03,0.11381944444444445,3,9,3,12
2022-03-25 11:21:09,0.07039351851851852,1,10,4,14
2022-04-06 05:37:12,12.579085648148148,11,1609,487,2096
2022-03-25 05:52:43,1.5395254629629629,3,87,36,123
2022-03-24 02:47:24,0.5932175925925925,1,4,23,27
2022-03-23 08:59:01,67.94737268518519,1,3,3,6
2022-03-27 20:01:25,5.064467592592592,1,7,7,14
2022-03-22 22:56:59,0.21841435185185185,5,38,10,48
2022-04-26 19:59:11,35.09450231481482,7,6368,2409,8777
2022-04-09 11:10:35,17.93724537037037,4,3337,1299,4636
2023-05-03 00:57:58,409.80655092592593,19,667,282,949
2022-03-25 15:43:39,3.4253240740740742,1,31,0,31
2022-03-22 02:25:46,0.27297453703703706,1,2,2,4
2022-03-28 13:53:24,6.88712962962963,5,3527,871,4398
2022-03-21 09:41:58,0.11224537037037037,1,18,1,19
2022-03-21 09:43:24,0.480462962962963,3,1335,1335,2670
2022-03-21 10:24:31,0.7455324074074074,1,9,1,10
2022-04-26 20:05:17,37.14619212962963,10,8718,7758,16476
2022-04-19 18:25:04,30.125381944444445,2,10,12,22
2022-03-20 21:39:51,0.2582407407407407,1,2,0,2
2022-04-02 09:39:15,12.791087962962964,17,86,55,141
2022-03-21 09:58:44,0.858761574074074,1,1,1,2
2022-03-21 10:50:53,6.664768518518518,10,1790,471,2261
2022-03-20 20:12:11,0.9820601851851852,9,70,52,122
2022-05-20 10:03:34,61.679594907407406,8,6082,3677,9759
2022-03-21 10:38:10,2.736111111111111,9,1523,353,1876
2022-03-18 17:30:24,0.20037037037037037,2,8,3,11
2022-03-18 12:19:17,0.0857175925925926,2,14,14,28
2022-03-18 07:25:50,0.008368055555555556,1,4,5,9
2022-03-18 07:50:56,0.0403125,1,3,0,3
2022-04-23 18:01:37,36.488680555555554,1,8,33,41
2022-03-17 20:53:51,0.01678240740740741,2,8,3,11
2022-03-17 20:36:42,0.022581018518518518,1,1,1,2
2022-03-17 20:40:38,0.15579861111111112,1,1,1,2
2022-03-17 20:31:50,0.1711111111111111,1,2,2,4
2022-03-18 20:25:30,1.377974537037037,1,13,1,14
2022-04-29 16:58:58,43.4246412037037,5,9650,8224,17874
2022-03-18 20:13:23,1.5663425925925927,2,2,2,4
2022-03-17 09:11:26,0.49125,2,8,30,38
2022-03-17 04:44:58,0.38310185185185186,3,54,15,69
2022-03-24 07:24:08,19.485578703703705,17,2879,1557,4436
2022-03-25 12:19:59,9.690659722222222,7,2,16,18
2022-03-15 20:22:20,0.02087962962962963,1,2,2,4
2022-03-16 12:23:36,1.154085648148148,4,62,26,88
2022-03-15 16:34:22,0.455,2,1,89,90
2022-03-15 13:59:11,0.7178587962962963,2,3,3,6
2022-03-19 01:33:54,4.2779745370370375,14,551,289,840
2022-03-21 19:36:03,7.109861111111111,3,10,6,16
2022-03-14 16:33:34,0.31668981481481484,4,15,15,30
2022-03-30 20:04:53,16.503425925925924,6,6217,3252,9469
2022-03-14 08:21:53,0.02144675925925926,1,19,0,19
2022-03-14 08:11:51,0.26958333333333334,1,9,0,9
2022-03-14 08:15:11,0.3005787037037037,1,3,5,8
2022-03-13 10:06:42,0.27524305555555556,1,1,195,196
2022-03-12 06:43:54,0.18568287037037037,2,10,1,11
2022-07-12 04:02:53,122.19688657407407,18,53081,27870,80951
2022-03-27 15:55:03,15.722233796296296,4,6300,3369,9669
2022-03-18 20:07:39,6.9483449074074075,1,1,1,2
2022-03-11 20:09:15,0.5466203703703704,9,19,40,59
2022-03-11 05:46:12,0.08027777777777778,4,47,30,77
2022-05-25 09:45:42,75.58392361111112,17,373,132,505
2022-03-10 22:03:18,0.36799768518518516,2,7,7,14
2022-03-10 11:27:35,0.11432870370370371,1,25,24,49
2022-03-21 19:41:49,11.609872685185184,1,10,22,32
2022-04-04 21:02:58,26.55033564814815,4,6590,3545,10135
2022-03-11 20:32:31,22.38515046296296,53,6624,2365,8989
2022-05-04 13:41:01,56.93114583333333,13,14316,10038,24354
2022-03-08 15:44:29,0.0003935185185185185,1,23,24,47
2022-03-14 15:28:07,6.7233680555555555,9,209,119,328
2022-03-08 08:14:04,0.19121527777777778,1,7,6,13
2022-08-02 17:59:03,147.63268518518518,11,31097,16339,47436
2022-03-07 07:41:14,0.12739583333333335,1,12,14,26
2022-03-07 07:07:52,0.45589120370370373,3,40,10,50
2022-03-18 20:24:29,70.48976851851852,3,135,24,159
2022-03-06 18:23:15,0.10969907407407407,1,1,1,2
2022-03-07 04:07:01,0.8000925925925926,1,1,1,2
2022-03-05 09:40:02,0.24986111111111112,1,49,32,81
2022-03-05 23:38:48,1.4312268518518518,3,50,39,89
2022-03-05 20:50:22,1.5663541666666667,3,10,12,22
2022-03-04 06:23:24,0.20586805555555557,1,19,1,20
2022-03-27 13:45:19,23.702881944444446,6,7723,4415,12138
2022-03-21 16:27:02,19.267766203703705,13,68,56,124
2022-03-16 12:53:28,14.605208333333334,4,2427,1276,3703
2022-03-02 03:39:22,0.8796180555555555,1,1,2,3
2022-03-02 01:54:19,0.8410300925925925,4,98,1,99
2022-02-28 12:42:01,0.03159722222222222,1,2,2,4
2022-02-28 18:40:59,0.5001157407407407,3,73,1,74
2022-03-09 11:34:59,10.009016203703704,1,3,0,3
2022-03-16 16:20:44,18.867650462962963,7,114,12,126
2022-02-26 11:08:20,0.31180555555555556,1,1,1,2
2022-02-26 02:33:55,0.07023148148148148,1,12,10,22
2022-04-14 13:41:33,47.65032407407407,4,14777,6321,21098
2022-02-25 20:49:02,0.06785879629629629,1,3,3,6
2022-02-25 18:13:24,0.1331365740740741,1,1,1,2
2022-02-25 13:41:49,0.002905092592592593,1,5,2,7
2022-02-26 15:11:17,1.2982175925925925,11,94,20,114
2022-03-04 16:50:20,7.376319444444444,5,2511,1312,3823
2022-02-25 10:06:52,0.4269675925925926,2,82,54,136
2022-02-27 01:11:19,2.5352430555555556,7,60,274,334
2022-03-11 17:01:58,15.564710648148148,2,216,26,242
2022-03-08 04:34:05,12.448703703703703,9,2783,1514,4297
2022-02-24 23:07:16,1.160775462962963,4,50,58,108
2022-02-25 13:17:26,1.8243981481481482,1,18,1,19
2022-02-23 12:52:08,0.3070023148148148,3,39,38,77
2022-02-23 14:55:15,1.257037037037037,3,11,3,14
2022-02-22 13:11:36,0.3383101851851852,3,19,0,19
2022-03-22 03:03:49,28.355231481481482,5,5834,2503,8337
2022-02-21 09:59:16,0.6996527777777778,1,16,3,19
2022-02-20 14:54:48,0.6011226851851852,1,1,0,1
2022-03-08 15:21:48,16.745729166666667,5,42,48,90
2022-03-16 03:32:40,24.745601851851852,10,3406,1511,4917
2022-02-26 12:21:44,7.916724537037037,9,1492,440,1932
2022-02-18 13:35:02,0.13559027777777777,1,4,5,9
2022-02-18 01:06:41,0.037349537037037035,1,4,3,7
2022-02-17 22:04:43,0.02847222222222222,1,568,563,1131
2022-02-18 03:49:33,0.6268981481481481,5,28,19,47
2022-02-18 09:48:22,1.0391087962962964,1,20,2,22
2022-08-12 06:21:05,189.72425925925927,12,576,120,696
2022-02-17 08:43:17,0.41684027777777777,1,1,1,2
2022-02-17 00:46:27,0.1504050925925926,2,11,3,14
2022-02-21 23:08:22,21.749641203703703,4,80,5,85
2022-05-28 22:47:28,102.07692129629629,17,38516,17597,56113
2022-02-16 10:19:53,0.5623842592592593,1,1,1,2
2022-02-14 14:23:30,0.015243055555555555,1,2,1,3
2022-02-14 13:51:30,0.7773958333333333,2,4,3,7
2022-05-01 18:51:49,77.59709490740741,45,872,621,1493
2022-03-02 10:22:26,586.5486111111111,18,244046,122950,366996
2022-02-14 14:06:21,1.2595601851851852,1,3,3,6
2022-02-14 14:25:29,1.6458680555555556,1,3,2,5
2022-02-15 06:45:10,2.754861111111111,4,20,14,34
2022-02-12 03:25:44,0.4053703703703704,1,6,10,16
2022-02-14 17:20:13,3.0171412037037038,4,16,5,21
2022-02-21 08:25:43,10.03380787037037,7,70,42,112
2022-02-10 17:02:17,0.04703703703703704,1,1,1,2
2022-02-10 16:27:05,0.030914351851851853,1,1,1,2
2022-02-10 15:45:11,0.9481481481481482,2,11,15,26
2022-03-14 20:21:45,49.76046296296296,17,9791,3580,13371
2022-02-10 15:35:36,0.731724537037037,7,15,15,30
2022-02-10 04:06:33,0.4787962962962963,1,1,1,2
2022-02-09 14:40:01,0.052800925925925925,1,4,4,8
2022-02-11 03:12:14,1.6685416666666666,1,86,0,86
2022-02-09 12:01:54,0.0446875,1,1,1,2
2022-02-09 14:45:35,1.103900462962963,4,13,8,21
2022-02-10 09:05:57,1.2498726851851851,2,7,16,23
2022-02-09 00:03:52,0.1181712962962963,1,0,1,1
2022-02-08 19:16:19,0.013761574074074074,1,1,1,2
2022-02-09 00:07:05,0.3257523148148148,1,1,0,1
2022-02-09 18:57:13,1.1533680555555557,2,32,20,52
2022-02-07 19:29:44,0.12049768518518518,1,3,0,3
2022-02-07 14:06:35,1.2477083333333334,2,46,44,90
2022-02-08 21:08:21,2.5686342592592593,1,8,6,14
2022-02-07 12:13:53,1.4765625,1,77,11,88
2022-03-08 04:55:43,32.286574074074075,8,6670,2195,8865
2022-03-28 04:23:56,51.35244212962963,5,19,8,27
2022-02-10 11:23:54,5.697199074074074,1,4,28,32
2022-02-06 17:18:25,2.237974537037037,1,1,1,2
2022-02-04 01:20:20,0.06008101851851852,1,14,1,15
2022-02-08 11:08:15,4.822523148148148,3,56,35,91
2022-02-04 03:37:10,0.5980439814814815,1,5,17,22
2022-02-09 14:28:53,6.823726851851852,1,54,60,114
2022-02-02 08:40:22,0.031342592592592596,1,1,1,2
2022-02-03 23:12:16,1.9313425925925927,1,89,5,94
2022-02-03 12:38:03,1.7807870370370371,7,75,33,108
2022-02-01 14:39:58,0.08033564814814814,1,0,2,2
2022-02-01 12:13:52,0.10614583333333333,1,1,1,2
2022-02-01 09:50:17,0.059618055555555556,1,56,43,99
2022-02-01 18:30:21,0.4720023148148148,2,7,4,11
2022-02-02 23:26:54,0.6028125,1,5,5,10
2022-08-29 14:25:49,210.15590277777778,23,49878,22568,72446
2022-03-08 05:01:08,35.93165509259259,5,7388,2270,9658
2022-01-30 05:37:30,0.12174768518518518,1,1,1,2
2022-01-31 01:14:51,1.1906828703703705,6,78,58,136
2022-01-31 15:39:03,1.810636574074074,4,8,5,13
2022-02-25 20:46:00,28.061354166666668,12,5518,1331,6849
2022-01-27 13:27:51,3.2172800925925924,5,126,118,244
2022-01-27 03:04:28,1.399861111111111,1,7,3,10
2022-02-07 18:01:53,21.302743055555556,4,85,86,171
2022-01-27 19:43:24,0.6393402777777778,1,73,4,77
2022-01-25 06:23:19,0.3924768518518518,1,38,38,76
2022-01-25 00:05:58,0.20539351851851853,4,40,13,53
2022-05-26 03:03:28,0.4191435185185185,1,123,129,252
2022-02-01 04:23:01,8.262731481481481,4,119,13,132
2022-02-16 15:37:15,24.3578125,17,2672,1514,4186
2022-01-23 02:26:16,0.2458101851851852,1,3,0,3
2022-01-24 10:31:35,1.9351851851851851,4,38,14,52
2022-01-21 23:36:00,0.07552083333333333,1,3,5,8
2022-01-23 15:51:26,1.7747800925925925,10,76,39,115
2022-02-15 15:52:33,25.22797453703704,34,214,161,375
2022-01-21 21:55:51,1.235324074074074,1,11,6,17
2022-01-29 18:38:29,9.208113425925927,7,128,63,191
2022-01-21 21:58:59,0.885162037037037,3,86,48,134
2022-06-07 15:00:52,137.72253472222224,13,21259,12281,33540
2022-03-25 22:32:24,63.665983796296295,3,8,5,13
2022-01-21 22:01:47,0.667025462962963,4,257,257,514
2022-01-21 06:31:31,0.007638888888888889,1,1,1,2
2022-01-24 20:56:37,3.6916550925925926,6,58,26,84
2022-02-01 10:46:47,11.33798611111111,16,519,220,739
2022-02-17 21:07:25,31.537141203703705,35,4088,1691,5779
2022-01-17 20:11:26,0.0011805555555555556,1,8,55,63
2022-01-17 09:14:32,0.15327546296296296,1,3,3,6
2022-01-16 21:37:33,0.2102662037037037,6,109,52,161
2022-02-03 09:28:21,17.717256944444443,5,81,71,152
2022-01-19 03:47:49,2.5991435185185185,1,5,1,6
2022-01-16 09:49:56,0.07518518518518519,1,9,2,11
2022-01-16 00:38:22,1.1915509259259258,1,1,1,2
2022-01-15 15:41:23,0.887962962962963,4,49,4,53
2022-01-17 19:53:07,3.3092939814814817,9,98,45,143
2022-01-14 12:06:19,0.12969907407407408,1,6,0,6
2022-01-18 06:50:35,7.551620370370371,23,324,335,659
2022-01-14 12:07:49,0.6406712962962963,1,5,5,10
2022-01-14 04:52:31,0.7282523148148148,2,8,4,12
2022-01-18 19:18:07,5.365648148148148,1,17,0,17
2022-01-16 17:16:44,3.3529976851851853,1,11,13,24
2022-01-12 21:35:43,137.11770833333333,19,163453,195363,358816
2022-01-12 13:27:17,0.08879629629629629,1,1,1,2
2022-01-12 16:10:31,0.991712962962963,1,3,3,6
2022-01-26 16:21:17,25.710127314814816,4,88,12,100
2022-01-15 04:37:01,5.185231481481481,12,256,100,356
2022-03-25 12:21:48,74.7384837962963,112,13690,5183,18873
2022-01-09 08:08:02,0.10442129629629629,1,3,1,4
2022-01-09 09:23:29,0.26417824074074076,2,2,3,5
2022-01-08 21:40:00,0.036099537037037034,1,6,6,12
2022-08-03 05:51:17,207.2175462962963,8,40290,18833,59123
2022-04-02 17:40:02,85.26847222222223,18,382,170,552
2022-03-17 12:45:29,69.12789351851852,2,72,32,104
2022-01-07 12:36:39,0.11181712962962963,1,6,6,12
2022-01-07 17:33:32,1.1207291666666668,1,9,3,12
2022-01-11 15:26:15,5.027615740740741,1,3,58,61
2022-01-06 15:58:37,0.06568287037037036,1,3,3,6
2022-01-14 20:32:05,8.673726851851852,5,25,9,34
2022-10-09 17:29:30,276.7559606481482,9,55348,22115,77463
2022-01-06 03:50:59,0.7297569444444445,1,4,6,10
2022-01-10 12:02:58,5.202418981481482,3,18,3,21
2022-03-09 15:29:31,63.76212962962963,21,153,100,253
2022-05-01 13:58:41,117.01886574074074,5,253,62,315
2022-01-05 03:18:10,0.8246643518518518,1,2,0,2
2022-01-07 13:55:03,3.7783912037037037,6,73,23,96
2022-02-26 15:16:13,54.17601851851852,9,8910,2712,11622
2022-01-06 08:49:35,5.652523148148148,2,51,16,67
2022-01-03 16:34:27,3.9021875,2,131,131,262
2022-04-16 05:42:58,106.5247337962963,1,21,21,42
2022-01-05 13:03:47,6.221145833333333,20,197,66,263
2022-01-10 15:30:52,13.379328703703704,12,9697,88969,98666
2022-01-08 07:04:57,34.12538194444444,39,4013,89287,93300
2022-01-04 05:21:52,12.343113425925926,8,553,44,597
2022-01-05 13:35:52,17.043796296296296,13,95,42,137
2022-01-03 21:49:01,15.102777777777778,60,332,250,582
2022-01-29 01:31:59,31.175069444444443,12,11161,1784,12945
2022-01-07 15:56:40,20.08763888888889,19,12322,89759,102081
2022-06-30 02:12:15,194.80752314814814,6,12357,3686,16043
2022-01-07 16:25:54,21.823877314814816,4,70,47,117
2022-02-07 14:26:01,54.65892361111111,5,13973,90597,104570
2022-04-30 08:25:19,143.51725694444445,18,258,161,419
2022-03-25 15:57:17,106.51572916666667,2,28157,96613,124770
2022-03-27 12:57:35,110.61950231481481,1,2,2,4
2022-01-10 17:42:42,41.10458333333333,8,33180,1140,34320
2022-08-31 09:10:55,279.6600231481481,5,76,18,94
2022-03-16 20:08:54,116.8612962962963,22,1218,347,1565
2023-05-15 08:36:00,543.9644560185185,4,393,325,718
2022-02-02 22:50:32,82.60267361111111,5,64,41,105
2022-08-02 18:53:11,1097.9056944444444,37,535762,305576,841338
2024-03-16 08:19:47,913.1473263888889,8,189050,100618,289668
2022-01-12 09:10:41,136.60032407407408,13,153071,106190,259261
2022-04-19 16:10:25,240.07960648148148,24,184840,203959,388799
2022-10-04 23:08:53,403.2486689814815,4,209348,209463,418811
2022-11-13 23:48:08,468.76752314814814,19,77118,113359,190477
2022-02-18 09:58:35,191.14909722222222,8,158580,105565,264145
2022-07-30 23:42:34,356.3363078703704,11,221794,223780,445574
2023-06-02 18:37:55,229.79438657407408,5,103,25,128
2022-02-22 13:42:32,211.90277777777777,15,178318,198289,376607
2022-10-03 00:09:11,442.4245138888889,11,228772,219573,448345
2022-10-07 09:09:07,451.003599537037,5,227616,218694,446310
2022-07-22 19:15:47,388.8629513888889,1,35,6,41
2022-05-20 11:08:12,328.1467592592593,177,216142,224209,440351
2022-10-02 23:55:03,472.6424768518518,5,230742,219658,450400
2022-05-30 19:08:34,368.9414814814815,26,220219,221582,441801
2022-04-18 09:40:09,326.5192476851852,5,202623,209712,412335
2023-08-25 07:14:25,825.6256365740741,9,320863,254681,575544
2022-02-21 17:14:04,278.50604166666665,5,199446,206197,405643
2023-02-10 16:59:56,634.8841782407408,7,267161,227381,494542
2022-02-23 03:49:50,282.35590277777777,4,200000,206187,406187
2022-05-20 12:35:55,372.31457175925925,4,103,39,142
2022-02-26 03:11:49,293.8887731481482,4,203578,206402,409980
2022-11-27 05:59:09,576.7922800925926,32,257399,228920,486319
2022-03-24 15:57:47,329.8098611111111,15,196688,208588,405276
2022-05-23 01:37:18,395.7300578703704,20,571,198,769
2022-10-26 20:39:01,625.245462962963,6,267127,238573,505700
2023-01-24 17:52:02,677.2154861111111,61,284500,239653,524153
2022-07-11 06:53:10,538.8513310185185,5,439,18,457
2022-05-28 16:39:30,466.1666666666667,38,238560,223017,461577
2024-04-27 09:06:38,1173.7646412037036,45,522052,433289,955341
2022-02-27 07:49:27,385.23229166666664,4,223379,209532,432911
2022-02-03 07:33:49,366.04579861111114,23,163135,194802,357937
2022-02-27 01:38:10,396.66743055555554,19,232158,209605,441763
2022-10-09 20:07:37,626.5422106481482,4,288477,236551,525028
2022-08-18 17:45:44,590.4210763888889,5,279484,235854,515338
2022-08-08 03:17:49,580.7068518518519,37,269834,226925,496759
2022-03-29 17:59:46,449.7861574074074,5,254242,226111,480353
2022-10-16 00:13:12,652.6204050925926,4,289881,236030,525911
2022-07-31 04:35:33,576.4720486111111,5,193655,206165,399820
2022-02-21 17:52:57,448.616087962963,4,254791,225272,480063
2022-02-18 09:48:51,454.0091898148148,8,253944,225271,479215
2022-09-15 05:02:20,821.869837962963,51,331477,167151,498628
2023-01-21 19:04:55,875.3768402777778,19,419309,253264,672573
2023-08-04 18:57:22,1095.1331828703703,83,494214,280639,774853
2022-10-09 02:52:37,809.5946064814815,3,321767,151260,473027
2022-08-21 04:53:41,782.2979166666667,7,314206,151892,466098
2022-02-27 18:10:34,642.3545833333334,9,400583,255288,655871
2022-11-20 22:14:54,909.8369907407407,4,12,6,18
2022-01-12 07:42:22,604.5492824074074,13,286891,145443,432334
2022-05-30 19:43:28,785.1150694444444,109,422590,262158,684748
2022-10-27 19:43:44,948.9364699074074,6,450641,269934,720575
2022-02-20 16:43:13,813.7088773148148,7,312484,155314,467798
2022-02-21 09:04:10,1209.0042939814814,48,259867,227778,487645
2022-08-18 08:10:43,1256.5547685185186,14,407266,200180,607446
2022-08-19 18:25:04,1486.4605787037037,11,877536,428627,1306163
2023-04-04 14:02:36,1816.0528356481482,3,325972,244381,570353
2024-01-19 16:31:55,9.083668981481482,5,34,34,68
2022-02-20 18:47:43,1499.6242824074075,5,409983,206368,616351
2022-03-31 23:00:57,2265.9641087962964,7,555470,400462,955932
2022-06-23 16:44:26,2463.944537037037,13,577694,402309,980003
2022-01-03 02:27:22,0.32528935185185187,2,6,2,8
2022-01-03 00:36:23,1.1696527777777779,1,64,49,113
2022-01-01 21:36:10,0.0755787037037037,1,1,1,2
2022-01-01 21:39:49,0.1479398148148148,1,24,0,24
2022-01-01 17:03:42,0.03346064814814815,1,1,1,2
2022-01-01 17:02:40,0.06293981481481481,1,11,6,17
2022-01-02 12:14:27,0.9835069444444444,4,83,18,101
2022-01-02 02:04:44,0.6723263888888888,1,4,4,8
2022-01-01 09:17:45,0.14982638888888888,2,2,3,5
2022-01-02 00:39:32,1.2044560185185185,2,5,5,10
2021-12-31 14:56:00,0.5872685185185185,1,1,1,2
2021-12-31 23:15:26,1.1690972222222222,1,5,5,10
2021-12-31 23:34:53,1.3977430555555554,1,19,2,21
2021-12-30 08:07:07,0.16643518518518519,1,2,2,4
2021-12-29 21:47:28,0.00017361111111111112,1,0,2,2
2021-12-29 23:04:02,0.08128472222222222,1,12,17,29
2021-12-29 14:31:56,0.001261574074074074,1,1,0,1
2021-12-28 16:12:59,0.07467592592592592,1,83,95,178
2021-12-31 13:42:40,2.995810185185185,5,17,9,26
2021-12-28 16:09:30,0.08251157407407407,2,13,11,24
2021-12-28 12:54:50,0.2848263888888889,1,1,1,2
2021-12-28 16:15:22,0.6338773148148148,1,18,4,22
2021-12-27 20:05:38,0.08846064814814815,1,61,65,126
2021-12-27 16:00:12,0.21140046296296297,1,26,28,54
2021-12-27 09:27:40,0.1907060185185185,1,2,0,2
2021-12-27 09:39:53,0.48865740740740743,2,2,1,3
2021-12-30 07:16:17,3.515416666666667,1,1,1,2
2021-12-26 19:05:30,0.33903935185185186,1,22,9,31
2021-12-27 14:29:55,3.7244444444444444,7,109,28,137
2021-12-24 22:25:46,0.01125,1,0,4,4
2021-12-24 09:36:34,0.115625,2,5,3,8
2021-12-24 09:41:12,0.1607060185185185,1,1,1,2
2021-12-30 01:10:22,6.275185185185185,3,13,2,15
2021-12-23 17:52:17,0.016238425925925927,1,1,1,2
2021-12-23 18:18:00,0.10587962962962963,1,3,3,6
2021-12-24 09:39:10,0.7714814814814814,2,35,13,48
2021-12-25 20:53:51,2.459386574074074,4,6,6,12
2021-12-23 16:16:44,0.2956712962962963,1,1,6,7
2021-12-24 09:59:33,1.0909375,1,1,1,2
2021-12-22 17:42:21,0.6285416666666667,1,7,2,9
2021-12-25 18:06:12,7.61875,9,623,207,830
2021-12-22 20:26:15,1.9503125,1,19,17,36
2021-12-23 06:34:34,0.0580787037037037,2,24,7,31
2021-12-28 02:12:30,7.8566666666666665,2,61,1,62
2021-12-28 00:45:53,8.785300925925926,6,77,45,122
2021-12-24 10:18:55,5.893194444444444,2,10,0,10
2021-12-18 13:41:46,0.4135300925925926,1,0,1,1
2021-12-21 05:02:11,3.0742939814814814,3,278,20,298
2021-12-17 18:00:40,0.03947916666666667,2,5,4,9
2021-12-23 08:30:29,6.1488657407407405,1,21,15,36
2021-12-17 15:29:46,0.6860416666666667,1,17,0,17
2021-12-17 16:23:56,0.8449421296296297,2,16,2,18
2021-12-17 06:05:48,0.9672453703703704,2,17,17,34
2021-12-16 02:57:37,0.03315972222222222,1,5,5,10
2021-12-23 06:55:32,7.659155092592592,1,19,6,25
2021-12-16 02:56:06,0.47001157407407407,1,3,3,6
2021-12-26 18:35:19,21.60480324074074,31,2934,88947,91881
2021-12-16 19:49:13,1.9278356481481482,5,21,113,134
2021-12-13 21:55:39,0.6546759259259259,1,3,5,8
2021-12-13 22:09:50,0.8520833333333333,1,21,24,45
2021-12-13 21:57:01,2.1411805555555556,1,6,23,29
2021-12-10 20:19:53,0.1841898148148148,3,10,7,17
2021-12-12 11:35:15,2.424525462962963,2,93,18,111
2021-12-10 18:04:59,0.8999652777777778,1,51,4,55
2021-12-09 21:22:58,0.13402777777777777,1,1,1,2
2021-12-10 18:00:11,1.0347916666666668,1,7,3,10
2021-12-09 15:06:01,0.470162037037037,1,9,9,18
2021-12-09 16:01:56,0.773125,1,2,2,4
2021-12-08 20:42:31,0.06253472222222223,1,4,4,8
2021-12-08 18:49:41,0.1502314814814815,1,5,4,9
2021-12-13 21:49:43,5.826006944444444,1,141,168,309
2021-12-07 20:13:28,0.0027199074074074074,1,2,0,2
2021-12-14 17:50:31,7.442303240740741,1,31,4,35
2021-12-09 16:00:20,2.2955324074074075,1,40,40,80
2021-12-07 05:08:17,0.05133101851851852,1,134,3,137
2021-12-08 11:26:26,1.7739699074074073,1,6,11,17
2021-12-07 05:04:18,1.1091203703703705,6,870,81,951
2021-12-05 23:12:14,0.4583564814814815,1,1,0,1
2021-12-06 18:50:15,167.03258101851853,2,54,22,76
2021-12-08 11:34:54,4.7197453703703705,4,28,15,43
2021-12-03 12:58:52,0.34322916666666664,6,35,14,49
2021-12-03 03:54:41,0.6301157407407407,1,1,0,1
2021-12-03 04:02:34,0.6379166666666667,1,15,39,54
2021-12-04 00:45:41,1.6412615740740741,4,460,45,505
2021-12-18 15:24:09,16.363622685185184,5,34,26,60
2021-12-02 08:07:40,0.1451388888888889,1,6,7,13
2021-12-02 19:23:56,0.8133796296296296,1,1,1,2
2021-12-02 11:02:41,0.7825694444444444,2,85,3,88
2021-12-03 04:29:03,863.6382638888889,3,26218,85,26303
2021-11-30 23:25:10,92.83211805555555,1,11,12,23
2021-12-01 11:26:15,0.8753240740740741,1,2,2,4
2021-12-02 09:15:56,1.8846180555555556,2,7,6,13
2021-12-01 00:08:00,0.6744097222222222,2,10,9,19
2021-12-02 11:19:51,2.257766203703704,4,121,40,161
2021-11-30 08:19:56,0.47939814814814813,3,5,5,10
2021-11-29 06:50:04,0.3999652777777778,1,12,3,15
2021-11-30 06:25:30,2.538275462962963,1,4,4,8
2021-12-01 11:52:46,3.8839930555555555,4,221,16,237
2021-11-28 08:01:43,0.8445833333333334,1,1,730,731
2021-11-28 19:13:17,1.305011574074074,3,9,2,11
2021-11-30 05:37:53,2.9307060185185185,3,371,89,460
2021-12-02 03:12:38,6.304189814814815,2,218,99,317
2021-11-30 05:25:00,4.967060185185185,3,15,9,24
2021-11-25 10:54:34,0.5718287037037038,2,35,5,40
2021-11-24 19:53:47,0.024027777777777776,1,43,0,43
2021-11-26 10:44:31,1.7273842592592592,1,13,13,26
2021-11-30 19:50:27,6.435925925925926,1,129,9,138
2021-12-02 23:56:50,9.526655092592593,9,4113,1931,6044
2021-11-23 17:16:39,0.3463310185185185,1,17,7,24
2021-11-30 22:03:15,9.403854166666667,2,2835,1571,4406
2021-11-23 18:10:22,0.5902777777777778,3,409,145,554
2021-11-25 21:28:07,6.450636574074074,4,162,93,255
2021-11-22 06:44:52,0.38494212962962965,1,31,37,68
2021-11-19 07:20:49,0.03184027777777778,1,1,1,2
2021-11-20 17:55:42,319.5142939814815,2,12,12,24
2021-11-19 10:18:15,1.2916666666666667,1,7,8,15
2021-11-18 04:06:25,0.16670138888888889,1,8,5,13
2021-11-30 08:11:03,12.826898148148148,3,43,35,78
2021-11-20 11:34:18,3.0999305555555554,2,169,472,641
2021-11-20 11:22:16,3.1627662037037036,2,11,0,11
2021-11-16 11:30:14,0.0019328703703703704,1,1,1,2
2021-11-30 06:12:49,14.136689814814815,7,107,121,228
2021-11-20 11:40:51,4.792025462962963,2,34,8,42
2021-11-20 10:09:51,5.223599537037037,6,480,107,587
2021-11-15 18:57:29,0.9232523148148148,8,127,73,200
2021-11-23 03:21:49,9.529918981481481,7,79,187,266
2021-11-14 21:39:11,1.1310416666666667,2,24,17,41
2021-11-14 09:10:14,1.7320833333333334,2,226,84,310
2021-11-12 11:05:00,0.01138888888888889,1,1,1,2
2021-11-11 20:49:19,0.07539351851851851,1,1,1,2
2021-11-12 03:55:23,0.684525462962963,1,3,3,6
2021-11-11 09:54:14,0.1370949074074074,1,11,4,15
2021-11-13 08:16:02,2.2689814814814815,11,180,119,299
2021-11-10 19:24:29,0.01326388888888889,1,1,1,2
2021-11-10 15:06:06,0.4164814814814815,2,6,6,12
2021-11-11 09:59:34,0.8564930555555555,1,0,1,1
2021-11-10 07:12:29,0.011122685185185185,1,7,7,14
2021-11-11 03:10:13,0.8482175925925926,1,0,55,55
2021-11-10 10:18:11,0.7251388888888889,1,63,3,66
2021-11-14 21:24:25,5.441331018518518,2,17,23,40
2021-11-08 21:32:51,0.04902777777777778,1,1,1,2
2021-11-11 18:21:47,3.022685185185185,12,283,127,410
2021-11-08 18:44:46,0.15752314814814813,5,12,3,15
2021-12-13 22:02:28,4.799664351851852,1,21,17,38
2021-11-07 06:54:16,0.3406134259259259,1,72,0,72
2021-12-02 03:04:37,25.213356481481483,1,39,4,43
2021-11-06 21:02:18,0.16326388888888888,1,3,2,5
2021-11-06 22:01:35,0.19255787037037037,1,4,2,6
2021-11-16 16:40:35,11.912557870370371,1,21,21,42
2021-11-04 19:19:59,0.03186342592592593,1,1,1,2
2021-11-04 09:51:52,0.16675925925925925,2,9,8,17
2021-11-03 21:37:19,0.03355324074074074,1,2,2,4
2021-11-03 15:38:39,0.1791898148148148,1,0,2,2
2021-11-02 13:52:24,0.10864583333333333,1,0,67,67
2021-11-06 16:41:03,4.297650462962963,3,657,239,896
2021-11-02 11:23:41,0.07344907407407407,1,140,2,142
2021-11-02 14:04:56,0.24533564814814815,1,7,4,11
2021-11-02 08:39:07,0.025,1,4,4,8
2021-11-02 12:42:32,0.27621527777777777,2,473,174,647
2021-11-02 14:46:24,0.36011574074074076,1,1,1,2
2021-11-02 16:59:12,0.6716203703703704,4,16,16,32
2021-11-08 15:56:57,7.3275,2,16,4,20
2021-11-02 03:11:53,0.9095833333333333,1,8,0,8
2021-11-01 19:45:36,5.646631944444445,17,70,70,140
2021-11-01 18:29:34,1.952013888888889,2,52,16,68
2021-11-02 08:29:43,2.6831944444444447,4,17,9,26
2021-10-30 15:42:59,0.03113425925925926,1,3,1,4
2021-11-11 13:56:30,11.986192129629629,4,53,17,70
2021-11-02 15:43:08,2.8577083333333335,2,791,155,946
2021-10-30 02:01:19,0.1705787037037037,3,9,1,10
2021-10-30 13:03:44,0.9623958333333333,2,33,9,42
2021-11-02 15:02:10,4.390925925925926,2,240,72,312
2021-10-29 20:07:05,1.3994675925925926,2,7,6,13
2021-10-28 10:02:41,0.2284027777777778,2,63,7,70
2021-10-27 10:04:15,0.017175925925925924,2,3,4,7
2021-10-27 10:31:13,0.09615740740740741,2,2,2,4
2021-10-30 09:14:17,0.6036574074074074,2,161,23,184
2021-11-30 03:15:47,34.20641203703704,12,120,64,184
2021-10-26 15:16:29,0.1871875,2,106,23,129
2021-10-28 09:56:57,2.071388888888889,2,266,26,292
2021-10-26 06:53:10,0.09791666666666667,2,40,9,49
2021-10-25 10:51:02,0.20782407407407408,2,122,10,132
2021-10-25 14:14:37,0.6198611111111111,1,2,0,2
2021-10-25 09:52:22,2.2901504629629628,2,144,16,160
2021-10-21 21:58:39,0.5157060185185185,1,22,22,44
2021-10-24 22:10:32,3.6593287037037037,4,11,9,20
2021-10-25 14:40:45,5.368009259259259,2,350,96,446
2021-10-21 05:54:57,0.10601851851851851,1,4,4,8
2021-10-20 19:14:22,0.1403125,1,7,0,7
2021-10-20 15:52:40,0.042025462962962966,3,3,3,6
2021-10-19 18:42:12,0.0046875,1,4,1,5
2021-10-26 10:53:48,6.876412037037037,4,43,28,71
2021-10-19 11:13:36,0.0028703703703703703,1,2,0,2
2021-12-04 23:21:14,46.714363425925924,4,284,24,308
2021-10-20 16:37:30,0.563587962962963,2,374,104,478
2021-10-19 06:22:42,0.2877777777777778,2,24,3,27
2021-12-14 09:03:26,56.71672453703704,1,5,1,6
2021-11-10 07:09:24,22.722083333333334,3,6,4,10
2021-10-19 10:32:17,0.9004282407407408,2,346,50,396
2021-10-29 22:49:28,13.217476851851853,39,334,307,641
2021-10-27 13:37:28,1.2863310185185186,3,32,6,38
2021-10-15 05:56:14,0.07385416666666667,4,30,3,33
2021-11-12 05:43:31,28.67673611111111,2,9,3,12
2021-11-10 12:43:17,27.66815972222222,1,5,5,10
2021-10-17 08:55:04,2.0563194444444446,2,61,4,65
2021-10-12 22:25:32,0.001979166666666667,1,1,1,2
2021-12-29 21:45:09,78.32395833333334,33,7751,619,8370
2021-11-10 10:59:46,29.125300925925927,1,1,1,2
2021-10-12 06:09:24,0.30280092592592595,1,3,0,3
2021-10-11 21:51:00,0.5563888888888889,3,6,6,12
2021-11-23 14:04:49,43.32123842592593,4,105973,98557,204530
2021-10-11 06:41:07,0.058055555555555555,1,1,0,1
2021-12-06 18:55:06,14.571770833333334,1,8,8,16
2021-10-13 08:08:42,2.7761342592592593,1,1,1,2
2021-11-10 13:19:29,31.58215277777778,5,971,163,1134
2021-11-10 12:18:25,31.83571759259259,13,101972,95844,197816
2021-10-09 23:30:28,0.35346064814814815,4,6,5,11
2021-11-08 18:56:26,30.344178240740742,47,102654,95979,198633
2021-10-25 18:13:28,20.573796296296297,9,46400,43095,89495
2021-12-01 03:39:00,53.8666087962963,16,886,317,1203
2021-10-07 17:58:30,0.07924768518518518,1,2,1,3
2021-10-10 17:22:36,3.294560185185185,2,52,49,101
2021-11-15 19:22:44,18.386134259259258,2,177,74,251
2021-10-06 08:26:45,0.30416666666666664,1,1,1,2
2021-10-06 15:50:07,0.9102430555555555,3,53,1,54
2021-10-05 14:16:08,0.03166666666666667,1,2,2,4
2021-10-06 09:10:45,1.3488194444444443,2,2,2,4
2021-10-12 22:29:00,8.343217592592593,10,105,84,189
2021-10-04 10:56:47,0.02505787037037037,2,2,1,3
2021-10-04 08:16:34,0.25913194444444443,1,1,1,2
2021-10-10 20:22:03,10.285347222222223,9,55,41,96
2021-10-06 21:20:57,4.449351851851852,3,5,2,7
2021-10-01 16:32:23,0.03425925925925926,1,5,5,10
2021-10-16 14:49:12,15.68579861111111,14,189,141,330
2021-09-30 19:18:05,0.010115740740740741,1,0,1,1
2021-09-30 17:17:31,0.1806712962962963,2,4,4,8
2021-12-31 20:47:36,94.58255787037037,11,148218,192601,340819
2021-09-27 05:30:12,0.08665509259259259,1,47,47,94
2021-09-24 11:37:01,1.8158680555555555,1,1,1,2
2021-09-21 22:39:09,0.07608796296296297,1,1,1,2
2021-09-22 02:29:57,0.24157407407407408,1,0,15,15
2021-09-22 02:37:11,0.2631597222222222,1,2,0,2
2021-09-21 19:22:07,0.01855324074074074,1,1,1,2
2021-09-27 08:43:33,5.979525462962963,2,24,1,25
2021-09-22 15:50:24,1.3303587962962964,1,4,4,8
2021-11-10 18:26:01,50.68045138888889,4,1277,452,1729
2021-09-20 07:16:03,0.5796759259259259,1,9,0,9
2021-09-19 16:52:37,0.9480439814814815,2,3,3,6
2021-09-20 09:11:53,1.6513078703703703,4,64,55,119
2021-11-03 09:48:47,47.22863425925926,2,5,5,10
2021-09-17 08:31:03,0.6918865740740741,1,1,1,2
2021-09-21 14:57:41,5.473715277777778,1,10,1,11
2021-09-20 21:56:21,5.101655092592592,3,12,3,15
2021-09-15 17:06:40,0.04990740740740741,1,1,1,2
2021-11-10 13:17:04,56.74415509259259,2,30,25,55
2021-10-20 19:19:36,36.463622685185186,7,51,25,76
2021-09-29 20:46:50,16.164803240740742,7,368,340,708
2021-09-15 02:23:42,1.5271990740740742,1,2,2,4
2021-10-13 00:13:02,30.08451388888889,3,14,14,28
2021-12-07 12:50:02,86.29961805555556,1,10,10,20
2021-10-14 05:51:47,34.574363425925924,8,883,139,1022
2021-09-10 04:19:14,0.13038194444444445,1,11,8,19
2021-09-09 15:13:47,0.011168981481481481,1,1,1,2
2021-09-09 17:14:44,0.12171296296296297,1,1,1,2
2021-09-09 15:45:04,0.1501273148148148,1,2,0,2
2021-11-30 03:14:04,151.0725,20,1214,133,1347
2021-11-06 07:38:33,58.943587962962965,36,5664,1693,7357
2021-10-17 22:19:37,42.229756944444446,13,663,75,738
2021-11-30 05:55:08,83.33296296296297,1,15,24,39
2021-09-07 15:11:43,0.19371527777777778,1,1,1,2
2021-09-06 20:16:38,0.09298611111111112,1,3,3,6
2021-09-06 15:06:28,0.7423726851851852,1,5,14,19
2021-09-05 03:08:06,0.7905439814814815,2,6,6,12
2021-09-07 03:05:02,67.29679398148149,10,88,31,119
2021-09-03 06:26:31,0.19622685185185185,1,27,33,60
2021-09-02 20:06:24,0.006354166666666667,1,3,4,7
2021-09-03 07:48:20,0.5463541666666667,2,11,6,17
2021-09-21 14:50:03,18.93784722222222,1,1,1,2
2021-09-02 20:09:05,0.2620138888888889,1,1,1,2
2021-09-02 15:36:51,1.2246643518518519,2,76,9,85
2021-09-01 12:08:24,0.2046875,1,1,1,2
2021-09-05 21:49:52,5.082291666666666,3,20,20,40
2021-08-31 23:13:14,0.07795138888888889,1,1,0,1
2021-09-02 12:35:22,2.268611111111111,2,12,20,32
2021-09-03 01:04:06,3.3343171296296297,4,139,207,346
2021-08-31 13:55:18,0.8780787037037037,1,1,1,2
2021-08-30 11:52:43,0.007743055555555556,1,2,2,4
2021-08-30 05:57:18,0.10478009259259259,1,50,58,108
2021-08-28 20:45:08,0.06609953703703704,1,1,1,2
2021-08-28 20:26:30,0.2245138888888889,1,84,88,172
2021-08-30 11:00:08,1.8836342592592592,1,49,63,112
2021-08-30 11:56:10,3.6469791666666667,1,18,12,30
2021-08-26 10:11:10,0.12518518518518518,1,8,0,8
2021-08-26 10:19:31,0.25599537037037035,2,79,16,95
2021-08-25 00:52:34,0.04859953703703704,1,1,1,2
2021-08-24 02:27:03,0.22417824074074075,1,1,1,2
2021-08-23 22:57:45,0.1622337962962963,1,1,1,2
2021-08-23 11:45:57,0.09646990740740741,1,1,1,2
2021-08-23 09:20:10,0.4421875,1,2,1,3
2021-08-24 02:41:41,1.600486111111111,1,23,0,23
2021-09-10 06:11:28,19.444479166666667,2,21,12,33
2021-08-23 04:43:51,1.7639004629629629,7,42,27,69
2021-08-21 14:12:58,0.3552314814814815,1,4,4,8
2021-11-11 09:35:13,0.569375,2,3,3,6
2021-09-06 18:37:09,16.825578703703705,1,15,3,18
2021-08-20 13:30:36,0.08396990740740741,1,1,1,2
2021-09-06 20:31:25,18.216805555555556,11,1315,194,1509
2021-08-25 20:41:24,5.725868055555556,3,235,154,389
2021-08-19 18:16:06,0.13163194444444445,1,1,0,1
2021-08-19 11:04:36,0.21427083333333333,1,1,0,1
2021-08-20 10:17:27,1.210798611111111,1,14,15,29
2021-08-19 20:31:46,6.970706018518518,3,120,156,276
2021-08-19 07:07:58,0.6331712962962963,2,3,2,5
2021-08-31 15:58:39,13.366030092592593,10,910,653,1563
2021-08-20 09:17:12,1.9376851851851853,4,4526,207,4733
2021-08-17 18:25:49,0.07574074074074075,3,14,118,132
2021-08-25 21:09:25,29.641365740740742,2,34,8,42
2021-08-28 11:30:52,14.105844907407407,9,5196,638,5834
2021-08-19 20:31:49,6.970740740740741,1,74,140,214
2021-09-07 03:06:47,26.61017361111111,3,185,35,220
2021-08-14 16:45:18,4.368333333333333,5,21,18,39
2021-08-09 20:17:29,0.021041666666666667,1,1,1,2
2021-08-23 18:28:14,14.932025462962963,3,216,84,300
2021-09-07 03:09:01,30.399722222222223,2,95,5,100
2021-12-05 04:20:13,119.56407407407407,5,222,117,339
2021-08-07 22:12:53,0.9531597222222222,1,11,11,22
2021-11-30 05:52:07,115.42685185185185,1,10,2,12
2021-08-28 08:37:44,2.002222222222222,6,252,63,315
2021-08-17 02:31:53,11.371006944444444,4,39,36,75
2021-08-06 13:35:20,0.8676041666666666,4,64,0,64
2021-08-18 18:14:21,14.88351851851852,15,350,192,542
2021-08-04 23:10:37,0.5925578703703703,1,115,0,115
2021-08-04 09:50:30,0.06825231481481482,3,7,7,14
2021-09-02 13:21:53,30.212743055555556,2,19,1,20
2021-08-04 22:22:13,2.254490740740741,5,45,7,52
2021-08-02 12:21:39,0.028402777777777777,1,11,7,18
2021-10-24 21:55:59,83.77631944444444,2,60,4,64
2021-08-02 20:59:36,1.185324074074074,1,38,0,38
2021-07-31 18:48:19,0.02966435185185185,1,1,1,2
2021-08-03 18:23:53,3.5560532407407406,8,67,51,118
2021-12-02 21:15:48,124.97579861111112,1,58,30,88
2021-07-29 13:41:17,0.5638194444444444,1,2,2,4
2021-10-18 13:03:15,81.80452546296296,3,846,774,1620
2021-08-18 17:07:53,21.217881944444443,1,67,64,131
2021-08-01 12:42:16,4.119293981481482,2,13,8,21
2021-07-30 04:38:01,2.1768287037037037,1,9,31,40
2021-07-29 12:21:39,1.7098842592592594,1,1,1,2
2021-07-26 16:41:55,0.03248842592592593,1,2,2,4
2021-08-06 02:04:35,11.121550925925925,1,40,10,50
2021-08-01 12:09:37,6.7236921296296295,7,294,1395,1689
2021-08-17 13:53:39,27.043078703703703,5,89,39,128
2021-07-23 19:07:50,0.22552083333333334,1,2,2,4
2021-07-23 10:10:55,0.0769212962962963,3,6,4,10
2021-07-24 13:56:18,1.4860069444444444,4,27,30,57
2021-07-23 21:35:15,0.9676388888888889,2,3,2,5
2021-07-24 11:10:43,1.7171296296296297,3,26,23,49
2021-08-28 18:18:21,57.98387731481481,15,253,46,299
2021-08-06 07:58:08,60.539039351851855,16,7067,2690,9757
2021-07-24 20:50:10,4.988854166666667,2,136,30,166
2021-12-29 22:52:12,161.22268518518518,4,171029,203718,374747
2021-07-31 15:55:09,3.5584953703703706,6,1325,698,2023
2021-12-02 03:29:44,90.26645833333333,2,46,2,48
2021-07-20 19:28:41,0.054363425925925926,1,3,2,5
2021-09-07 09:22:56,251.4541550925926,145,4487610,4358120,8845730
2021-09-21 17:26:08,65.35918981481481,2,121,110,231
2021-07-18 19:19:00,0.41980324074074077,1,3,0,3
2021-08-02 05:50:45,15.335659722222223,8,80,40,120
2021-07-17 16:30:28,0.10603009259259259,1,1,1,2
2021-07-19 18:29:37,2.4772916666666664,3,99,93,192
2021-07-22 04:41:03,6.329849537037037,2,47,7,54
2021-07-15 19:25:57,0.034340277777777775,1,2,2,4
2021-07-16 07:34:33,1.7232407407407409,7,22,13,35
2021-07-15 19:12:59,1.224548611111111,1,2,2,4
2021-07-14 08:33:13,0.24763888888888888,1,2,1,3
2021-07-15 09:52:04,1.7054282407407408,1,1,1,2
2021-07-13 16:11:33,0.021215277777777777,1,1,1,2
2021-07-13 08:32:53,0.4904513888888889,2,4,4,8
2021-07-13 07:38:05,0.6748958333333334,7,120,128,248
2021-07-20 08:56:59,565.6156481481481,11,1017,438,1455
2021-07-12 11:30:51,0.2818287037037037,2,17,18,35
2021-07-12 18:33:38,1.1602199074074073,2,25,2,27
2021-07-11 14:34:44,0.3915625,2,16,1,17
2021-08-09 10:36:08,30.073703703703703,7,112,45,157
2021-07-10 20:15:12,0.5445601851851852,6,173,172,345
2021-07-12 13:39:48,2.737673611111111,3,41,7,48
2021-07-08 10:46:36,0.1940625,1,11,3,14
2021-07-11 14:36:32,3.4311226851851853,5,380,377,757
2021-07-07 00:44:53,0.18454861111111112,1,1,1,2
2021-07-12 17:19:03,6.319212962962963,2,19,11,30
2021-07-15 19:21:47,10.340011574074074,17,425,196,621
2021-07-20 03:02:24,14.222789351851851,4,186,273,459
2021-11-04 17:56:09,122.88568287037037,4,115228,96101,211329
2021-07-16 07:39:50,11.786643518518519,6,25,16,41
2021-08-08 15:57:21,36.22888888888889,13,511,296,807
2021-12-05 04:07:24,2.448541666666667,3,59,16,75
2021-07-03 22:32:18,0.7146412037037037,1,1,1,2
2021-07-02 23:38:30,0.055949074074074075,1,6,4,10
2021-12-03 04:44:29,153.5717824074074,2,18,2,20
2021-07-02 23:57:26,1.3283449074074074,1,1,1,2
2021-07-15 18:28:07,14.258773148148148,4,50,25,75
2021-08-16 00:06:12,46.285868055555554,3,16,15,31
2021-07-02 07:25:58,1.7929861111111112,1,22,9,31
2021-06-30 11:06:09,0.08893518518518519,1,0,1,1
2021-07-04 01:12:42,4.061145833333334,5,39,17,56
2021-08-20 14:59:18,52.71761574074074,10,177,149,326
2021-07-10 21:31:59,12.520902777777778,9,115,49,164
2021-06-28 13:58:10,0.2451273148148148,1,122,122,244
2021-10-13 00:24:35,107.33880787037037,1,4,3,7
2021-06-27 18:01:34,0.13561342592592593,2,16,10,26
2021-07-05 08:58:58,7.921574074074074,3,95,81,176
2021-06-29 19:02:53,3.205347222222222,2,10,7,17
2021-07-01 07:56:26,4.779861111111111,1,6,6,12
2021-06-26 16:15:19,0.12314814814814815,1,4,2,6
2021-06-26 13:00:38,0.0583912037037037,1,1,1,2
2021-07-28 10:30:23,32.81505787037037,9,29,26,55
2021-06-29 10:26:57,0.10892361111111111,1,9,13,22
2021-06-27 22:25:23,2.573865740740741,4,41,31,72
2021-06-25 02:04:49,0.16623842592592591,1,2,2,4
2021-06-25 01:58:05,0.6273726851851852,1,20,6,26
2021-07-21 01:56:10,1346.2866203703704,48,2521,1474,3995
2021-06-24 01:52:11,0.43972222222222224,1,0,1,1
2021-06-24 19:39:03,1.4033333333333333,2,32,13,45
2021-06-23 02:25:29,0.19416666666666665,4,63,51,114
2021-08-17 02:48:19,11.681319444444444,1,5,4,9
2021-06-24 22:11:32,2.5772453703703704,8,1685,200,1885
2021-08-05 10:09:57,44.09471064814815,11,14738,10808,25546
2021-06-22 06:52:58,0.9443402777777777,3,50,50,100
2021-06-20 20:56:24,0.04510416666666667,1,17,1,18
2021-06-19 19:58:40,0.3213888888888889,1,3,5,8
2021-06-19 20:15:44,0.3854513888888889,1,7,4,11
2021-06-20 13:32:51,1.1250925925925925,1,3,3,6
2021-06-19 09:51:08,0.02207175925925926,1,2,2,4
2021-06-19 09:18:56,0.05527777777777778,1,3,3,6
2021-07-16 07:45:53,27.379050925925927,1,50,10,60
2021-06-18 23:30:29,0.2240162037037037,3,7,2,9
2021-06-24 05:43:11,6.547430555555556,9,1091,775,1866
2021-07-02 07:30:04,14.764826388888888,1,1,1,2
2021-06-19 09:58:39,3.010497685185185,2,32,4,36
2021-07-07 06:18:59,21.12412037037037,1,32,32,64
2021-06-15 23:09:57,0.10655092592592592,1,1,1,2
2021-06-13 20:09:26,0.20847222222222223,3,41,30,71
2021-07-31 18:03:08,48.136875,6,103,36,139
2021-06-13 16:30:40,0.17167824074074073,1,2,0,2
2021-06-13 17:04:34,0.20200231481481482,1,4,2,6
2021-06-12 23:40:01,0.0865625,1,1,1,2
2021-06-12 20:00:31,0.26461805555555556,12,118,119,237
2021-06-12 17:48:04,0.4482523148148148,1,1,1,2
2021-06-12 20:02:50,1.4426388888888888,1,2,1,3
2021-06-12 20:16:03,1.9991898148148148,1,2,1,3
2021-08-17 19:02:46,69.47898148148148,93,142921,138669,281590
2021-06-12 18:07:33,9.296655092592593,5,76,24,100
2021-08-17 04:08:04,68.34060185185186,2,92,19,111
2021-06-12 17:52:38,3.2942939814814816,1,3,2,5
2021-06-19 10:28:37,10.122349537037037,1,2,2,4
2021-08-13 00:30:37,64.99503472222223,7,425,130,555
2021-06-12 17:57:01,15.959664351851853,1,1,1,2
2021-08-17 02:40:58,69.38752314814815,3,9,14,23
2021-06-12 20:04:17,4.48193287037037,1,1,1,2
2021-06-12 20:11:23,5.094699074074074,1,22,25,47
2021-06-09 17:56:51,3.2471296296296295,4,4,2,6
2021-06-07 21:28:50,0.9048148148148148,3,3,3,6
2021-06-06 20:58:11,0.09572916666666667,1,1,0,1
2021-06-07 22:01:50,1.523298611111111,1,9,1,10
2021-06-11 22:40:12,5.638553240740741,1,35,32,67
2021-06-12 20:17:17,6.8125,1,1,1,2
2021-06-12 20:18:12,6.844606481481481,1,9,10,19
2021-06-15 19:30:28,10.58523148148148,3,300,142,442
2021-06-05 22:07:56,0.838761574074074,2,50,47,97
2021-06-23 17:44:59,19.19880787037037,4,672,383,1055
2021-06-04 17:16:24,1.0106134259259258,2,10,15,25
2021-07-07 00:17:44,33.6569212962963,2,12,6,18
2021-07-04 23:54:51,31.59696759259259,3,41,31,72
2021-06-03 03:04:40,0.32832175925925927,1,4,4,8
2021-06-02 09:19:44,0.2596643518518518,2,3,2,5
2021-06-02 01:13:45,0.1995023148148148,1,2,1,3
2021-06-07 21:46:03,6.231446759259259,5,68,44,112
2021-07-26 05:37:21,65.86724537037037,6,224,40,264
2021-06-13 18:31:52,14.938900462962962,10,412,99,511
2021-06-03 02:58:47,4.351724537037037,1,9,6,15
2021-05-27 09:47:54,0.04137731481481482,1,1,0,1
2021-05-27 05:27:04,0.04649305555555556,1,134,3,137
2021-05-26 19:44:42,0.09170138888888889,1,0,1,1
2021-05-25 20:02:00,0.22239583333333332,1,2,2,4
2021-07-21 21:01:25,57.32244212962963,4,40,3,43
2021-05-26 12:48:59,1.5649652777777778,1,30,6,36
2021-05-24 17:06:52,0.005231481481481481,1,1,0,1
2021-05-26 09:08:02,1.7936574074074074,6,2959,294,3253
2021-05-24 14:51:23,0.06368055555555556,1,4,4,8
2021-05-27 05:12:15,3.430717592592593,16,1102,186,1288
2021-05-23 18:19:02,0.21708333333333332,1,4,9,13
2021-05-25 23:23:43,2.976770833333333,6,2868,260,3128
2021-05-23 18:39:46,1.804386574074074,1,88,4,92
2021-05-24 08:01:46,1.6271875,1,2,2,4
2021-05-25 19:37:20,3.627986111111111,4,135,26,161
2021-05-26 05:58:30,4.160983796296296,1,1,1,2
2021-05-22 04:23:55,0.12864583333333332,1,44,34,78
2021-05-20 16:19:53,0.3508912037037037,5,11,11,22
2021-05-20 02:41:57,0.14630787037037038,1,1,1,2
2021-05-21 15:26:45,2.4084837962962964,1,2,1,3
2021-05-20 03:42:59,1.0930092592592593,1,7,1,8
2021-05-19 03:39:28,0.3655787037037037,1,36,2,38
2021-05-19 01:43:39,0.3612152777777778,1,0,4,4
2021-05-18 16:26:57,0.03903935185185185,1,0,18,18
2021-05-18 09:19:10,0.4536921296296296,1,71,53,124
2021-05-19 06:13:04,1.5953703703703703,2,172,146,318
2021-05-18 02:09:32,0.4287962962962963,1,2,3,5
2021-05-17 07:30:38,0.39538194444444447,2,9,4,13
2021-05-26 10:29:58,9.604675925925926,7,42,12,54
2021-05-26 10:26:46,9.644340277777777,8,50,19,69
2021-05-16 20:52:02,0.1153125,8,31,12,43
2021-05-16 20:33:44,0.126875,1,8,0,8
2021-05-26 11:46:19,9.831030092592593,5,90,61,151
2021-05-19 14:07:55,3.0438194444444444,4,42,12,54
2021-05-16 16:37:26,0.1585300925925926,1,3,3,6
2021-05-25 07:46:09,9.665520833333334,8,1334,657,1991
2021-05-16 16:33:27,0.27229166666666665,1,1,1,2
2021-05-17 16:45:15,1.3940277777777779,1,76,21,97
2021-05-16 18:36:16,0.5551736111111111,1,11,0,11
2021-05-15 16:43:00,0.10068287037037037,3,20,3,23
2021-05-15 17:29:31,0.15877314814814814,1,11,0,11
2021-06-27 20:44:05,43.351979166666666,6,29,9,38
2021-05-15 14:11:59,0.26024305555555555,2,8,5,13
2021-05-14 23:40:23,0.046157407407407404,1,1,1,2
2021-05-13 23:47:55,0.07137731481481481,1,0,2,2
2021-05-14 17:39:53,3.641111111111111,2,106,12,118
2021-05-14 11:59:02,0.722037037037037,1,1,0,1
2021-05-13 18:34:20,0.2738657407407407,1,7,7,14
2021-05-13 13:44:19,0.09872685185185186,1,7,11,18
2021-05-13 05:13:33,0.06943287037037037,1,1,0,1
2021-05-14 12:01:01,2.242962962962963,4,97,30,127
2021-05-12 07:42:37,0.780162037037037,2,16,3,19
2021-06-03 07:59:18,22.713113425925926,3,215,6,221
2021-05-12 02:33:30,0.9785185185185186,1,8,8,16
2021-05-21 16:06:00,10.98431712962963,2,1,1,2
2021-05-21 11:50:51,10.864710648148149,3,19,7,26
2021-05-10 15:23:33,0.0833912037037037,1,2,5,7
2021-05-11 02:03:04,0.7312962962962963,1,0,1,1
2021-05-18 09:07:20,16.13962962962963,17,4006,799,4805
2021-05-15 07:50:17,5.513657407407408,2,27,12,39
2021-05-16 00:42:34,6.344375,2,57,53,110
2021-05-10 12:38:52,4.38113425925926,2,22,5,27
2021-08-21 19:46:04,104.17064814814815,3,1002,33,1035
2021-05-26 13:06:21,16.971006944444444,1,13,0,13
2021-05-12 20:27:31,6.02662037037037,6,3145,555,3700
2021-05-07 12:34:29,0.3233912037037037,1,10,3,13
2021-05-14 16:55:06,8.272916666666667,7,123,24,147
2021-05-08 15:34:31,21.793449074074076,15,4604,3094,7698
2021-05-06 12:33:38,0.9713425925925926,4,17,7,24
2021-05-05 08:43:49,0.1200925925925926,1,2,1,3
2021-05-07 08:22:13,2.2890972222222223,2,47,11,58
2021-05-04 20:53:16,0.12942129629629628,2,8,8,16
2021-05-04 13:58:56,0.0011458333333333333,1,3,1,4
2021-05-20 04:00:46,26.369282407407407,28,614,308,922
2021-05-05 10:29:04,1.9087037037037038,6,155,121,276
2021-05-05 09:50:33,2.0062847222222224,4,151,100,251
2021-05-20 21:28:04,18.22679398148148,17,52,49,101
2021-05-02 17:24:09,0.3476736111111111,1,2,2,4
2021-05-04 16:35:41,2.336689814814815,14,198,139,337
2021-05-03 08:11:48,1.1010648148148148,7,23,13,36
2021-04-30 22:39:07,0.11642361111111112,1,9,11,20
2021-06-03 20:08:34,34.591446759259256,3,108,45,153
2021-06-13 00:44:10,44.23502314814815,12,15084,2390,17474
2021-05-03 14:08:24,4.264432870370371,8,72,16,88
2021-05-26 20:18:09,32.94027777777778,40,5928,2150,8078
2021-04-29 09:13:42,10.946643518518519,1,5,4,9
2021-04-28 02:18:03,0.4329398148148148,1,2,10,12
2021-04-27 15:46:50,0.14653935185185185,1,23,1,24
2021-04-27 10:18:38,0.326875,1,43,0,43
2021-04-27 03:16:41,0.5493518518518519,2,11,3,14
2021-04-26 13:16:16,1.0646527777777777,1,19,2,21
2021-05-08 20:30:42,14.098668981481481,2,28,48,76
2021-04-27 15:59:09,3.120775462962963,1,88,16,104
2021-04-24 15:32:47,1.0843171296296297,1,13,8,21
2021-04-24 12:09:53,1.1785416666666666,3,11,5,16
2021-04-23 11:36:08,0.04423611111111111,1,1,1,2
2021-05-31 23:22:55,38.71231481481482,1,13,1,14
2021-10-04 09:03:09,237.8875462962963,12,146,70,216
2021-04-23 07:15:00,0.8254976851851852,1,7,4,11
2021-04-22 06:21:15,0.840625,1,29,45,74
2021-04-27 10:17:59,6.017916666666666,6,69,36,105
2021-04-21 08:06:21,0.0005092592592592592,1,7,14,21
2021-05-09 21:37:36,23.20142361111111,10,1186,234,1420
2021-04-20 13:19:59,7.121261574074074,26,3468,2243,5711
2021-12-06 16:04:50,230.89989583333335,71,187345,118467,305812
2021-04-19 17:29:01,0.1961226851851852,5,14,5,19
2021-04-19 13:15:49,0.12446759259259259,1,14,13,27
2021-04-19 06:40:05,0.10600694444444445,1,2,0,2
2021-05-26 16:51:32,37.544375,11,10858,3179,14037
2021-04-18 19:37:14,0.08541666666666667,1,1,1,2
2021-04-18 20:27:58,0.42225694444444445,3,4,4,8
2021-04-18 20:29:21,1.0828587962962963,1,3,0,3
2021-06-23 13:50:16,66.93373842592592,1,19,10,29
2021-04-17 19:12:24,0.2037962962962963,1,24,7,31
2021-04-17 22:47:59,0.3949652777777778,2,2,219,221
2021-04-23 07:21:42,5.9564004629629625,2,24,5,29
2021-04-17 12:54:49,0.46197916666666666,1,48,53,101
2021-04-20 11:01:49,3.604074074074074,6,37,30,67
2021-04-19 18:49:39,6.350196759259259,10,289,115,404
2021-04-17 13:46:53,2.067650462962963,4,64,34,98
2021-04-15 09:09:02,0.07189814814814814,2,3,2,5
2021-05-26 12:10:02,41.54275462962963,2,104,17,121
2021-04-14 23:05:09,2.0035648148148146,1,0,1,1
2021-04-15 09:10:18,1.0472453703703704,1,2,2,4
2021-06-21 16:19:37,68.02796296296296,21,18349,4795,23144
2021-04-18 19:27:05,4.359629629629629,10,1606,1125,2731
2021-04-14 15:51:24,0.8583333333333333,2,23,17,40
2021-04-13 21:11:08,0.06881944444444445,1,5,6,11
2021-04-17 17:46:20,9.231481481481481,20,282,228,510
2021-04-13 02:34:58,0.24261574074074074,1,1,0,1
2021-05-14 16:30:47,32.11015046296296,3,21,28,49
2021-04-12 12:42:48,0.006782407407407407,1,7,7,14
2021-04-12 12:59:05,0.06412037037037037,1,6,0,6
2021-04-21 07:29:39,9.812962962962963,14,3672,2042,5714
2021-04-12 09:26:04,0.609525462962963,3,18,17,35
2021-07-21 07:04:35,100.53711805555555,3,49,36,85
2021-04-11 17:52:42,0.09447916666666667,1,20,17,37
2021-04-11 02:09:37,0.07820601851851852,1,2,2,4
2021-05-19 08:47:53,1.5227199074074074,1,130,182,312
2021-04-10 22:51:32,0.22587962962962962,2,17,4,21
2021-05-03 16:17:21,22.921087962962964,1,189,102,291
2021-04-07 08:28:19,0.19641203703703702,1,1,1,2
2021-04-07 04:08:22,0.06708333333333333,1,6,4,10
2021-04-07 08:25:37,0.42202546296296295,1,17,1,18
2021-04-07 08:12:35,0.4252546296296296,1,10,10,20
2021-04-26 13:11:31,20.10216435185185,17,4812,3524,8336
2021-04-07 08:26:59,1.5765625,1,332,308,640
2021-04-10 16:38:52,5.019328703703704,1,54,0,54
2021-04-23 07:26:06,18.075729166666665,1,7,6,13
2021-04-11 15:42:45,6.553148148148148,1,1,1,2
2021-04-05 03:47:26,0.2860648148148148,2,5,3,8
2021-04-04 20:26:11,0.07887731481481482,1,5,5,10
2021-04-12 13:31:51,7.8891782407407405,2,42,10,52
2021-04-04 13:04:33,0.1667361111111111,1,1,1,2
2021-04-04 16:31:50,0.32016203703703705,1,1,1,2
2021-04-09 02:23:06,4.76900462962963,2,8,6,14
2021-04-12 16:06:37,8.37324074074074,4,1172,897,2069
2021-04-08 18:14:49,4.9073263888888885,2,1299,513,1812
2021-04-03 23:24:25,0.403125,1,1,1,2
2021-04-03 06:09:16,1.403923611111111,2,404,391,795
2021-04-16 23:40:28,18.238217592592594,5,449,246,695
2021-04-01 20:54:46,0.16315972222222222,1,31,0,31
2021-04-02 01:27:30,0.997175925925926,2,4,3,7
2021-04-03 08:32:05,3.02556712962963,11,1247,1255,2502
2021-05-26 12:38:14,56.2840162037037,2,10,10,20
2021-04-11 19:13:24,11.788506944444444,1,61,11,72
2021-04-12 16:04:14,12.704537037037037,2,62,18,80
2021-03-31 03:14:45,0.22258101851851853,1,22,2,24
2021-03-30 13:47:27,0.46449074074074076,2,76,17,93
2021-03-29 19:49:18,0.09237268518518518,1,1,0,1
2021-03-30 06:41:53,0.8086226851851852,2,26,20,46
2021-03-30 06:55:20,2.037511574074074,2,6,6,12
2021-03-27 11:09:48,0.15150462962962963,4,5,7,12
2021-03-26 22:09:06,0.8388773148148149,1,43,0,43
2021-03-25 18:25:58,0.3161805555555556,1,4,0,4
2021-03-26 17:32:16,1.664849537037037,5,84,21,105
2021-03-25 01:38:29,0.3008449074074074,1,21,0,21
2021-03-24 20:44:26,0.16836805555555556,2,16,2,18
2021-03-24 00:44:55,0.05858796296296296,1,1,1,2
2021-05-26 08:15:36,168.44715277777777,150,45053,12283,57336
2021-03-24 21:16:17,1.1194791666666666,2,103,61,164
2021-04-04 17:08:04,12.310833333333333,1,0,3,3
2021-03-25 12:00:52,2.9093981481481483,3,27,6,33
2021-04-04 18:23:33,13.257511574074075,16,2522,852,3374
2021-03-22 12:28:10,0.1302662037037037,1,20,17,37
2021-03-22 08:55:15,0.3723958333333333,5,8,8,16
2021-03-21 15:21:28,0.06605324074074075,1,917,917,1834
2021-04-11 18:59:30,21.434166666666666,2,134,142,276
2021-03-21 06:39:21,0.18520833333333334,2,8,7,15
2021-03-21 04:41:04,0.14335648148148147,1,5,14,19
2021-03-24 10:07:39,83.74652777777777,9,110,58,168
2021-03-20 22:55:23,0.17152777777777778,2,49,11,60
2021-03-29 07:25:08,8.59125,1,16,2,18
2021-03-20 23:26:31,0.8043055555555556,3,55,15,70
2021-03-20 10:28:56,1.3990393518518518,3,41,36,77
2021-03-19 02:08:21,0.3154398148148148,3,26,141,167
2021-05-25 02:35:16,67.33626157407407,8,640,281,921
2021-03-18 09:27:16,0.08746527777777778,2,13,2,15
2021-05-04 20:51:41,841.8174305555556,67,281655,87359,369014
2021-03-17 01:48:29,0.18413194444444445,1,3,2,5
2021-03-14 16:53:10,0.20032407407407407,1,1,1,2
2021-03-16 21:14:34,2.502650462962963,1,2,1,3
2021-03-20 15:32:30,6.329259259259259,3,27,2,29
2021-03-20 20:03:40,6.853993055555556,4,50,28,78
2021-03-14 23:00:06,1.0866666666666667,2,52,43,95
2021-03-14 02:54:37,0.3442824074074074,1,7,0,7
2021-03-13 17:50:37,0.004375,1,3,2,5
2021-03-13 16:54:37,0.009467592592592593,1,3,0,3
2021-05-25 01:47:55,72.68607638888889,6,79,61,140
2021-03-12 03:01:04,0.9320138888888889,1,0,132,132
2021-03-12 22:09:43,3.0310763888888888,2,3,3,6
2021-03-09 21:18:01,0.001388888888888889,1,1,0,1
2021-03-09 20:41:58,0.02420138888888889,1,2,49,51
2021-05-19 00:59:35,71.17158564814815,12,15030,7760,22790
2021-03-09 02:59:25,0.2920949074074074,1,2,2,4
2021-03-09 12:52:01,0.7140162037037037,1,1,0,1
2021-03-08 20:42:41,0.10166666666666667,3,8,6,14
2021-03-19 14:18:31,12.681354166666667,23,1563,569,2132
2021-03-07 18:53:36,0.8403587962962963,2,43,46,89
2021-04-23 05:13:47,47.90479166666667,22,11476,6012,17488
2021-03-20 20:14:50,14.728391203703703,2,39,10,49
2021-03-06 01:35:01,0.5908449074074074,1,0,1,1
2021-03-06 18:59:35,2.8647685185185185,3,56,7,63
2021-03-13 20:33:23,12.252511574074074,1,1,1,2
2021-04-01 18:19:18,31.212962962962962,15,10086,4463,14549
2021-03-06 19:17:18,1.7247685185185184,4,89,202,291
2021-03-06 09:27:02,5.470451388888889,1,4,4,8
2021-03-01 01:11:41,0.47788194444444443,1,8,4,12
2021-02-28 13:13:10,0.017800925925925925,1,5,0,5
2021-02-28 13:14:00,0.022037037037037036,1,1,152,153
2021-02-28 12:30:33,58.80940972222222,2,10,10,20
2021-02-27 21:37:09,0.0010532407407407407,1,0,5,5
2021-02-28 14:07:05,1976.0350810185184,5,78,50,128
2021-03-03 17:44:16,5.8399074074074075,10,166,64,230
2021-02-27 18:56:20,2.4370833333333333,5,74,48,122
2021-02-26 00:39:37,0.40375,1,4,0,4
2021-02-28 16:00:23,6.394236111111111,8,1646,1620,3266
2021-02-27 18:38:26,3.131782407407407,4,20,8,28
2021-02-24 03:05:51,0.21648148148148147,1,3,0,3
2021-02-28 13:12:10,4.7155555555555555,1,2,2,4
2021-03-02 13:10:19,7.375069444444445,6,14,5,19
2021-02-26 00:29:17,3.650289351851852,5,54,43,97
2021-02-22 16:32:00,0.43475694444444446,1,17,15,32
2021-05-24 15:53:20,118.58799768518519,109,45518,13415,58933
2021-03-06 09:34:25,14.324965277777778,2,12,4,16
2021-02-19 06:30:33,0.25972222222222224,1,76,0,76
2021-02-27 00:49:51,8.27170138888889,1,32,9,41
2021-02-19 09:29:38,0.7561111111111111,2,1,4,5
2021-08-27 10:07:39,190.1929513888889,6,31948,8476,40424
2021-02-18 15:21:29,0.8656365740740741,1,1,0,1
2021-04-03 15:11:08,45.045150462962965,29,13919,3104,17023
2021-02-17 10:20:33,0.33819444444444446,1,1,1,2
2021-02-18 15:24:15,1.7562962962962962,1,1,1,2
2021-02-17 04:25:24,0.9168402777777778,1,14,140,154
2021-02-16 06:10:04,0.12059027777777778,1,2,1,3
2021-02-17 18:30:51,1.9641782407407407,3,6,7,13
2021-02-16 10:17:08,1.4894212962962963,1,4,0,4
2021-02-14 10:27:31,0.18481481481481482,1,1,8,9
2021-02-13 23:02:02,0.3385416666666667,1,57,10,67
2021-02-12 01:56:32,0.057743055555555554,1,1,1,2
2021-02-12 01:59:26,0.11947916666666666,1,1,7,8
2021-02-18 10:30:41,6.717291666666667,2,24,13,37
2021-03-16 23:58:26,33.52998842592593,11,14860,3199,18059
2021-02-10 18:51:53,0.06350694444444445,1,2,1,3
2021-02-09 23:17:20,0.016041666666666666,1,1,1,2
2021-04-12 17:30:56,63.11704861111111,3,134,51,185
2021-03-07 16:23:35,27.093333333333334,3,33,18,51
2021-02-09 03:07:23,1.2021296296296295,1,1,0,1
2021-02-12 23:45:43,0.057824074074074076,1,28,5,33
2021-02-11 13:50:41,4.7121759259259255,1,2,20,22
2021-02-06 22:19:37,0.26871527777777776,1,5,5,10
2021-04-12 08:28:51,64.80680555555556,11,199,102,301
2021-03-25 09:23:18,47.15130787037037,4,9933,2309,12242
2021-02-17 12:40:44,11.627106481481482,7,9691,2015,11706
2021-02-08 15:07:56,3.0532175925925924,2,5,3,8
2021-02-19 16:01:08,14.446354166666667,4,179,163,342
2021-02-05 04:19:07,0.19925925925925925,1,1,1,2
2021-02-05 20:43:12,0.8843981481481481,2,17,3,20
2021-02-05 20:40:09,2.3737037037037036,1,32,29,61
2021-02-02 19:47:06,0.0024189814814814816,1,1,1,2
2021-02-18 13:09:52,21.05818287037037,32,14774,2635,17409
2021-02-03 21:05:15,1.1148958333333334,3,25,4,29
2021-03-06 21:43:18,33.07478009259259,9,724,110,834
2021-02-01 23:58:41,0.8595486111111111,1,26,2,28
2021-02-01 19:40:06,0.19811342592592593,1,8,5,13
2021-02-01 07:25:23,0.11225694444444445,4,30,30,60
2021-02-01 21:50:52,1.006574074074074,2,5,5,10
2021-01-31 21:30:26,0.058784722222222224,1,1,1,2
2021-02-01 16:35:55,0.8893981481481481,2,9,15,24
2021-01-31 20:15:12,0.038391203703703705,1,3,3,6
2021-01-31 19:41:06,0.030555555555555555,1,1,1,2
2021-01-31 19:41:42,0.033622685185185186,1,1,1,2
2021-01-31 18:50:09,0.08348379629629629,1,1,10,11
2021-08-03 19:36:14,184.13837962962964,35,32286,11598,43884
2021-01-31 18:49:41,0.10736111111111112,1,8,2,10
2021-04-19 12:35:45,104.65880787037037,26,16506,5226,21732
2021-03-29 16:47:10,57.145439814814814,1,3,1,4
2021-01-31 07:24:12,0.00875,1,2,2,4
2021-01-31 14:20:41,0.6391782407407407,1,14,17,31
2021-02-01 22:03:42,2.2417592592592595,1,58,39,97
2021-01-30 02:35:27,0.10788194444444445,2,3,2,5
2021-01-29 23:12:02,0.09792824074074075,1,1,1,2
2021-01-28 15:27:26,0.39858796296296295,1,10,11,21
2021-02-28 15:58:51,31.874039351851852,5,250,27,277
2021-02-01 22:01:11,5.1149305555555555,11,274,63,337
2021-01-27 17:42:03,0.3076157407407407,1,11,15,26
2021-01-29 03:45:37,1.697511574074074,2,34,13,47
2021-02-06 15:28:56,10.207627314814815,5,9,7,16
2021-01-27 12:14:16,0.17422453703703702,2,15,6,21
2021-03-17 18:07:46,50.30160879629629,143,21780,4511,26291
2021-03-25 18:30:29,59.30261574074074,3,40,6,46
2021-04-18 15:06:39,83.36556712962962,2,7,2,9
2021-03-23 00:12:57,56.854618055555555,26,320,184,504
2021-01-26 03:30:26,1.1168171296296296,1,4,4,8
2021-05-26 13:18:51,121.59255787037037,5,23635,2834,26469
2021-01-26 03:07:46,1.1579166666666667,1,55,2,57
2021-01-27 03:49:58,3.3676157407407405,1,8,4,12
2021-02-05 21:05:23,13.166527777777778,1,23,0,23
2021-01-29 05:33:50,5.702835648148148,3,13,7,20
2021-01-24 00:20:45,0.8059953703703704,2,41,41,82
2021-12-06 18:18:18,317.9389351851852,10,430190,238107,668297
2021-04-18 19:31:09,86.01233796296296,1,120,29,149
2021-01-22 02:28:02,0.23931712962962962,1,11,1,12
2021-01-25 21:15:02,4.218067129629629,4,38,11,49
2021-01-21 03:47:20,0.3085300925925926,1,20,0,20
2021-01-30 14:25:41,10.788414351851852,4,21,11,32
2021-01-20 00:10:35,1.1911342592592593,1,19,4,23
2021-02-12 14:32:38,25.872511574074075,3,168,93,261
2021-02-20 16:06:40,34.10327546296296,25,17047,2826,19873
2021-01-15 23:45:52,0.01704861111111111,1,1,1,2
2021-01-17 16:11:24,2.0358680555555555,1,35,11,46
2021-01-20 23:10:29,5.539872685185185,2,24,12,36
2021-12-06 15:25:46,325.2675347222222,3,83,58,141
2021-01-15 00:01:01,0.006585648148148148,1,1,1,2
2021-04-07 08:08:38,82.38265046296296,1,5,6,11
2021-01-25 18:43:06,11.061828703703704,1,62,17,79
2021-01-25 17:03:29,11.1453125,1,18,3,21
2021-01-14 17:55:10,0.5555092592592593,1,1,1,2
2021-01-14 03:12:38,0.851712962962963,1,1,0,1
2021-02-04 19:55:42,22.69101851851852,8,167,257,424
2021-05-26 12:40:54,133.87127314814813,1,2,1,3
2021-01-09 21:28:50,1256.2037615740742,4,168,30,198
2021-04-05 19:06:07,85.99193287037038,2,33,25,58
2021-05-21 14:00:56,134.57135416666668,49,37939,9834,47773
2021-05-19 20:28:07,130.91234953703704,8,201,108,309
2021-01-14 06:49:38,6.029224537037037,1,10,0,10
2021-01-10 19:35:10,2.7764930555555556,3,33,4,37
2021-01-16 19:00:34,9.749282407407408,1,8,8,16
2021-01-09 12:00:54,3.3416782407407406,2,30,0,30
2021-02-07 18:09:07,32.66935185185185,4,48,45,93
2021-01-07 05:51:15,2.0687037037037035,4,52,16,68
2021-01-04 18:13:04,0.048275462962962964,1,10,10,20
2021-01-04 20:16:59,0.15366898148148148,1,20,1,21
2021-01-06 06:05:09,2.386886574074074,1,3,3,6
2021-01-23 20:09:42,20.069918981481482,1,102,1,103
2021-01-05 00:01:56,1.6648958333333332,1,18,13,31
2021-01-05 00:15:53,1.7396527777777777,1,49,2,51
2021-01-17 16:18:44,14.5190625,1,6,3,9
2021-01-04 22:07:11,1.0930092592592593,2,154,28,182
2021-02-22 04:04:52,50.345798611111114,52,34441,11589,46030
2021-05-08 12:37:43,125.65628472222222,38,40807,10885,51692
2021-01-02 19:52:21,0.6272453703703704,1,5,5,10
2021-01-04 13:22:30,2.9108796296296298,2,25,11,36
2021-01-01 23:08:33,0.5366782407407408,1,1,1,2
2021-01-04 16:33:31,3.3077314814814813,6,56,16,72
2021-05-26 20:41:46,145.60395833333334,34,51601,11737,63338
2021-01-01 14:58:25,0.9543981481481482,1,14,3,17
2021-01-04 16:20:16,4.172638888888889,1,91,3,94
2021-01-04 22:06:02,4.722372685185185,4,277,135,412
2021-08-27 06:15:19,239.22721064814814,70,78801,25644,104445
2020-12-29 14:29:12,0.026863425925925926,1,5,1,6
2021-01-24 21:03:35,26.97747685185185,8,146,69,215
2020-12-29 12:58:43,1.297997685185185,2,11,1,12
2021-04-18 22:16:06,122.30577546296297,110,134697,11030,145727
2020-12-26 22:38:07,0.017083333333333332,1,1,1,2
2020-12-26 22:01:41,0.21122685185185186,1,1,1,2
2021-02-04 23:36:04,38.26207175925926,6,200,22,222
2020-12-29 12:52:52,5.062303240740741,1,1,1,2
2021-02-03 01:49:41,40.721111111111114,7,4840,566,5406
2020-12-24 16:42:07,0.7413888888888889,1,4,4,8
2020-12-29 12:51:10,5.494907407407408,1,41,11,52
2020-12-24 01:49:33,0.18862268518518518,1,2,1,3
2021-01-03 18:57:04,10.94417824074074,1,21,20,41
2020-12-23 10:54:35,0.7281365740740741,1,2,2,4
2020-12-28 01:25:56,5.947951388888889,5,41,13,54
2020-12-21 07:52:14,0.09366898148148148,1,1,1,2
2020-12-20 21:07:39,0.04006944444444444,1,5,5,10
2020-12-19 22:28:53,0.02546296296296296,1,1,0,1
2020-12-20 04:34:49,0.29028935185185184,3,17,3,20
2020-12-19 05:23:54,0.07974537037037037,1,1,1,2
2021-03-06 19:19:32,83.08758101851852,5,335,49,384
2020-12-24 15:47:42,6.1653472222222225,4,65,32,97
2020-12-18 06:30:20,0.03995370370370371,3,42,54,96
2020-12-23 10:36:21,6.488159722222222,1,25,22,47
2021-01-04 20:49:49,19.12476851851852,5,46,23,69
2020-12-16 17:43:33,0.056226851851851854,1,5,12,17
2021-01-04 05:31:21,18.70449074074074,12,125,29,154
2020-12-20 17:10:20,4.721469907407408,6,174,48,222
2020-12-15 10:57:32,0.6731828703703704,1,8,0,8
2020-12-14 18:01:00,1.0189814814814815,3,14,4,18
2021-01-23 01:05:03,40.64738425925926,21,282,190,472
2020-12-13 10:33:05,0.11811342592592593,1,111,100,211
2020-12-20 21:41:05,8.59037037037037,4,22,13,35
2020-12-21 04:36:43,9.047789351851852,3,26,14,40
2021-01-05 02:09:12,24.508020833333333,1,103,0,103
2021-05-27 09:38:01,167.00583333333333,2,254,250,504
2020-12-11 22:41:58,0.8196643518518518,1,2,2,4
2021-01-22 08:20:51,42.80074074074074,3,230716,71834,302550
2020-12-13 10:49:58,4.259525462962963,2,47,29,76
2020-12-08 00:05:21,0.05060185185185185,1,11,11,22
2020-12-07 16:41:36,0.2762847222222222,1,1,0,1
2020-12-09 02:40:15,1.9256018518518518,1,108,3,111
2021-02-01 04:19:35,56.77733796296296,19,5090,840,5930
2020-12-06 09:24:25,0.3464583333333333,1,2,2,4
2020-12-09 02:34:57,4.983368055555555,4,875,35,910
2020-12-12 20:24:40,8.731828703703703,1,20,1,21
2021-02-13 06:43:39,76.06537037037037,8,27577,9525,37102
2020-12-03 08:43:40,0.08439814814814815,1,3,3,6
2020-12-21 04:31:16,18.290266203703705,6,117,72,189
2020-12-03 02:59:49,0.24072916666666666,1,8,1,9
2020-12-03 00:55:01,0.5179166666666667,1,1,1,2
2021-04-09 19:26:59,128.44771990740742,8,37120,7286,44406
2020-12-09 05:02:44,7.792280092592593,2,49,21,70
2020-12-01 01:25:49,0.006481481481481481,1,1,1,2
2020-12-01 00:27:47,0.0009143518518518518,1,0,0,0
2020-12-12 20:21:22,12.636747685185185,1,8,0,8
2020-12-01 03:29:25,1.3805787037037036,1,13,19,32
2020-11-29 19:42:18,0.1570138888888889,1,1,1,2
2020-12-20 22:30:27,21.29943287037037,4,116,65,181
2020-11-29 11:41:02,0.22328703703703703,2,14,2,16
2020-12-02 02:53:59,3.406203703703704,1,1,12,13
2020-11-28 23:12:28,0.28315972222222224,4,85,65,150
2020-11-29 15:40:09,0.9888541666666667,1,4,1,5
2020-11-28 13:31:44,0.7228472222222222,1,2,2,4
2020-11-28 13:36:44,0.8250925925925926,1,134,8,142
2020-12-25 05:23:16,27.495486111111113,21,3350,792,4142
2020-11-28 13:37:35,1.0533564814814815,1,1,6,7
2020-11-27 11:27:18,0.08648148148148148,1,4,3,7
2020-11-27 13:36:16,0.3778472222222222,1,19,4,23
2020-11-26 20:58:09,0.31778935185185186,1,1,1,2
2020-11-27 06:55:27,1.0291898148148149,2,14,4,18
2020-11-28 13:47:50,2.639849537037037,1,12,3,15
2020-11-26 23:06:54,1.2374537037037037,2,25,23,48
2020-11-28 13:45:31,2.79,3,264,127,391
2020-12-01 10:29:53,5.7080671296296295,6,97,73,170
2020-11-25 12:36:35,0.08009259259259259,1,8,0,8
2020-11-25 03:05:44,0.14733796296296298,1,5,1,6
2020-11-25 12:30:54,0.8343171296296297,1,2,2,4
2020-11-25 13:01:08,1.1978472222222223,1,1,1,2
2020-11-25 18:18:35,3.6413657407407407,2,50,13,63
2020-11-25 12:22:28,3.028900462962963,1,9,2,11
2020-11-28 10:49:01,1.9621527777777779,2,7,3,10
2020-11-22 03:06:31,0.06599537037037037,2,4,1,5
2020-11-22 02:26:48,0.1846412037037037,2,9,9,18
2020-11-21 23:58:41,0.09744212962962963,1,50,9,59
2020-11-24 19:37:52,3.083414351851852,4,57,36,93
2020-12-18 06:55:00,26.86650462962963,1,25,15,40
2020-11-21 00:18:11,0.5837152777777778,5,15,13,28
2020-11-25 13:10:08,6.686851851851852,2,28,1,29
2021-10-15 02:29:01,330.34815972222225,20,72747,22215,94962
2020-11-29 12:44:56,10.832766203703704,7,98,26,124
2020-11-21 21:15:45,3.1966435185185187,5,68,20,88
2020-11-17 17:12:02,0.05775462962962963,1,5,5,10
2020-11-20 03:18:49,2.928865740740741,1,9,0,9
2020-11-17 13:33:28,5.660486111111111,3,63,35,98
2020-11-25 12:24:53,8.67607638888889,1,2,0,2
2021-05-25 14:18:35,1498.9291666666666,16,394832,164915,559747
2020-11-25 22:49:57,10.017314814814815,3,29,19,48
2020-11-25 22:37:28,10.986006944444444,1,9,8,17
2020-11-16 01:36:32,2.1516203703703702,1,20,27,47
2020-11-14 22:50:36,1.8196990740740742,1,28,21,49
2020-11-14 22:06:04,2.3919675925925925,2,22,1,23
2020-11-12 06:06:28,0.2680787037037037,2,10,8,18
2021-01-23 03:00:35,73.1926388888889,12,70,29,99
2020-11-20 14:30:22,10.056793981481482,1,2,0,2
2020-11-10 13:50:10,0.3850462962962963,1,37,36,73
2020-11-10 14:03:22,0.410162037037037,1,4,4,8
2020-11-14 21:39:55,4.7794791666666665,3,46,27,73
2020-11-10 12:44:19,0.45413194444444444,1,1,1,2
2020-11-11 21:11:18,1.8461689814814815,1,2,2,4
2020-11-10 15:53:56,0.7458217592592593,1,3,3,6
2020-11-27 03:23:47,17.625173611111112,14,136,29,165
2020-11-08 21:40:35,0.04599537037037037,1,2,2,4
2021-03-06 15:50:54,119.26643518518519,22,117119,5664,122783
2020-11-08 11:18:16,1.934386574074074,1,11,4,15
2020-11-06 06:39:16,0.1144212962962963,1,2,2,4
2020-11-07 02:16:05,1.8800925925925926,1,54,0,54
2020-11-08 12:47:23,3.546990740740741,2,5,3,8
2021-03-25 18:37:28,141.28653935185184,3,93667,1667,95334
2020-11-08 21:31:17,4.990138888888889,2,6,3,9
2020-11-02 12:40:48,0.046377314814814816,1,11,11,22
2020-11-25 12:05:34,23.4921875,3,12,2,14
2020-11-01 10:59:56,0.47541666666666665,1,5,1,6
2020-11-01 10:56:32,1.7968287037037036,1,1,1,2
2020-11-03 09:49:55,4.5458796296296295,2,87,5,92
2020-10-29 19:23:05,0.09637731481481482,2,21,15,36
2020-11-03 13:12:20,6.336342592592593,2,108,37,145
2021-04-15 00:19:03,169.23679398148147,24,131129,7939,139068
2020-11-01 11:01:13,4.740277777777778,1,4,1,5
2020-10-27 19:24:13,0.6462152777777778,2,6,2,8
2021-10-03 09:02:20,131.06703703703704,47,39965,17593,57558
2020-11-01 12:18:40,6.290335648148148,9,245,71,316
2020-11-01 21:00:15,8.684305555555556,2,30,0,30
2020-10-26 02:18:52,1.0915277777777779,2,7,6,13
2020-10-23 20:20:50,0.8685532407407407,5,10,8,18
2020-11-02 09:25:40,12.007256944444444,5,66,31,97
2020-10-27 02:38:19,5.481354166666667,7,42,24,66
2020-11-10 00:19:59,20.107164351851853,18,1655,1040,2695
2020-10-27 02:55:44,6.5196875,4,17,6,23
2020-10-20 17:33:49,0.17599537037037036,1,17,12,29
2020-10-20 21:01:58,0.29322916666666665,2,8,8,16
2020-10-19 17:43:01,0.09313657407407408,1,14,5,19
2020-10-19 16:48:31,0.275162037037037,2,19,44,63
2020-10-19 10:51:32,0.03283564814814815,1,1,0,1
2020-11-12 14:24:54,24.6065625,5,57,45,102
2020-11-01 11:07:26,13.716180555555555,6,22,4,26
2020-10-18 19:17:41,0.20274305555555555,3,35,26,61
2020-10-19 17:28:04,1.7591319444444444,1,75,0,75
2020-10-28 02:25:27,10.18125,1,5,0,5
2020-10-22 08:22:45,6.009456018518518,2,52,3,55
2020-11-01 11:17:07,15.96857638888889,3,21,1,22
2020-10-16 13:48:41,3.9357291666666665,1,3,6,9
2020-10-12 03:50:29,0.18784722222222222,2,2,1,3
2020-11-01 00:13:39,20.129421296296297,1,3,3,6
2020-11-11 15:56:19,30.840243055555554,2,31,6,37
2020-10-16 18:42:10,6.825300925925926,4,253,184,437
2020-10-09 22:51:18,1.5227546296296297,1,45,26,71
2020-10-08 09:54:09,2.4960532407407405,1,2,2,4
2020-10-04 02:28:47,0.3618634259259259,1,1,0,1
2020-10-31 12:45:45,28.28962962962963,1,4,4,8
2020-10-03 17:09:28,0.6728240740740741,1,0,6,6
2020-10-03 00:56:30,0.19049768518518517,1,27,0,27
2020-10-02 20:45:48,0.07390046296296296,1,0,2,2
2020-10-16 14:07:02,13.825335648148148,1,1,1,2
2020-10-16 13:53:18,15.562083333333334,1,66,50,116
2020-10-01 00:46:34,0.2017824074074074,1,0,3,3
2020-10-01 18:56:57,1.3837037037037037,1,2,0,2
2020-09-25 15:57:49,0.24357638888888888,1,11,9,20
2020-11-01 22:33:20,38.02481481481482,1,10,10,20
2020-09-24 15:09:57,0.059953703703703703,1,21,12,33
2020-09-23 21:26:46,0.45927083333333335,2,65,5,70
2020-10-09 01:04:59,16.51150462962963,3,32,18,50
2021-02-20 03:38:14,161.15677083333333,55,117842,5181,123023
2020-11-10 15:55:29,49.2112037037037,3,23,14,37
2020-09-22 03:28:53,12.687546296296297,2,3,3,6
2020-09-20 13:04:48,0.16267361111111112,1,1,1,2
2021-02-21 03:28:11,155.51976851851853,13,117710,4698,122408
2020-09-18 04:52:54,1.124074074074074,1,55,46,101
2020-11-15 11:44:56,61.64717592592593,1,524,396,920
2020-11-01 11:34:17,47.62896990740741,1,11,1,12
2020-10-22 15:25:07,38.99646990740741,10,183,245,428
2020-11-01 11:56:13,50.35635416666667,1,8,8,16
2020-09-12 03:51:10,0.24050925925925926,1,8,8,16
2020-09-13 22:53:46,2.2933564814814815,3,23,4,27
2020-09-11 15:10:26,0.03671296296296296,1,8,8,16
2020-09-14 15:11:25,3.286979166666667,2,14,2,16
2020-11-21 01:08:18,71.21158564814814,37,4699,887,5586
2020-09-10 12:54:55,0.7949305555555556,1,27,2,29
2020-09-10 01:57:05,1.0695486111111112,1,1,1,2
2020-09-08 11:50:27,0.02662037037037037,1,1,1,2
2020-09-09 02:12:40,0.8188541666666667,1,10,1,11
2020-09-07 17:24:21,0.0903587962962963,1,1,1,2
2020-09-15 02:32:28,9.073611111111111,1,1,4,5
2020-09-04 20:34:28,0.0009606481481481482,1,1,1,2
2020-12-01 12:00:45,88.23405092592593,12,106084,5015,111099
2020-11-14 21:16:13,72.33776620370371,5,191,60,251
2020-09-04 08:33:19,0.9223148148148148,2,14,5,19
2020-09-03 10:09:16,0.9314351851851852,1,4,2,6
2020-09-02 19:02:29,1.0549768518518519,1,68,0,68
2021-04-15 18:49:50,239.94202546296296,25,138100,11198,149298
2020-08-31 17:17:08,0.15736111111111112,1,3,2,5
2020-09-05 21:13:11,5.164826388888889,2,15,1,16
2020-11-01 10:11:24,62.42021990740741,2,0,261,261
2020-08-30 09:18:01,0.47020833333333334,1,2,0,2
2020-09-04 18:58:20,6.801782407407408,2,76,27,103
2020-08-29 04:45:37,0.06673611111111111,1,23,1,24
2020-10-08 13:57:21,42.07222222222222,1,181,68,249
2020-11-17 12:44:38,1129.3026967592593,39,394696,184597,579293
2020-11-13 02:27:04,74.24408564814814,17,534,240,774
2020-09-12 10:49:02,171.61038194444444,51,33096,31782,64878
2020-08-26 03:47:58,0.20527777777777778,2,12,14,26
2020-11-19 05:23:48,85.28268518518519,7,61,22,83
2020-08-25 23:24:27,0.0903125,1,1,1,2
2020-11-10 12:43:30,79.93373842592592,14,459,122,581
2020-08-26 03:50:17,1.0654166666666667,1,7,2,9
2021-05-24 00:00:52,273.67155092592594,4,39,6,45
2020-08-24 20:13:18,1.6748032407407407,2,27,0,27
2020-08-23 08:34:22,0.22350694444444444,2,32,16,48
2020-08-25 09:29:52,2.416678240740741,1,13,4,17
2020-11-01 12:16:13,71.26548611111112,2,77,1,78
2020-08-29 16:30:38,10.153518518518519,12,7283,7233,14516
2020-09-05 23:01:12,17.996365740740742,1,7,1,8
2020-11-01 18:07:20,73.97591435185186,3,22,7,29
2020-10-18 03:22:54,60.75599537037037,6,10806,6773,17579
2020-11-17 21:42:48,91.51204861111111,17,39579,19509,59088
2020-08-19 17:12:51,0.9785416666666666,1,4,1,5
2020-08-17 18:52:41,0.05489583333333333,1,1,1,2
2020-08-19 06:33:01,2.7598842592592594,1,69,53,122
2020-08-16 15:01:36,0.6448726851851851,1,1,1,2
2020-11-01 22:05:58,78.04104166666667,4,11768,7254,19022
2020-08-18 11:55:28,2.784872685185185,3,37,16,53
2020-11-13 02:41:20,255.13873842592594,5,263,30,293
2020-08-22 21:01:00,7.284537037037037,2,7,6,13
2020-08-15 22:52:42,1.1261574074074074,1,7,2,9
2020-09-29 17:41:47,46.86447916666667,2,3,2,5
2020-08-20 06:26:08,6.794108796296296,9,87,23,110
2020-08-13 09:50:10,0.4227314814814815,1,3,3,6
2020-08-13 02:30:02,0.2677777777777778,1,4,4,8
2020-11-08 14:46:25,87.8628125,4,105,64,169
2020-08-12 13:33:16,0.010590277777777778,1,2,2,4
2020-08-14 14:00:08,2.6611458333333333,3,12,2,14
2020-08-12 02:27:23,0.727662037037037,1,3,1,4
2020-08-11 17:46:11,0.6582638888888889,2,49,6,55
2020-08-11 02:40:20,0.10380787037037037,1,3,3,6
2020-08-11 02:29:30,0.10662037037037037,1,2,2,4
2020-09-14 15:17:58,34.66577546296296,2,9,3,12
2020-10-31 12:21:09,81.8140162037037,7,50,45,95
2020-11-27 08:52:49,108.69597222222222,8,208,34,242
2020-10-07 09:14:03,58.623194444444444,3,74,135,209
2020-08-09 17:55:23,0.0996875,1,3,0,3
2020-08-09 13:43:22,1.8020833333333333,2,15,29,44
2020-08-09 13:44:02,2.492326388888889,1,3,0,3
2021-05-03 12:43:44,269.6065625,2,10,2,12
2020-08-09 13:53:59,3.0289236111111113,1,2,25,27
2020-08-07 09:59:22,1.3544444444444443,3,15,4,19
2020-08-18 06:07:47,12.744375,3,42,31,73
2020-08-17 21:06:59,13.052268518518519,1,278,1,279
2020-08-09 13:48:14,4.63636574074074,1,23,26,49
2020-08-08 20:40:12,4.051770833333333,1,36,2,38
2020-08-05 18:22:27,2.125208333333333,3,48,3,51
2020-08-01 23:36:43,0.022754629629629628,1,5,2,7
2021-01-30 01:36:53,182.85645833333334,17,127623,10716,138339
2020-08-04 08:26:11,3.723402777777778,1,1,1,2
2020-08-01 21:56:33,1.3275578703703703,2,145,21,166
2020-08-05 22:15:32,5.554976851851852,2,32,12,44
2020-08-05 22:14:58,5.5702893518518515,1,11598,1,11599
2020-10-17 03:12:33,79.1379513888889,11,72,32,104
2020-08-07 16:54:55,8.491527777777778,6,159,101,260
2020-07-30 08:58:57,0.2653009259259259,1,1,1,2
2020-07-28 00:06:25,0.24368055555555557,1,2,2,4
2020-07-27 01:19:55,15.493483796296296,2,12,8,20
2020-07-28 07:36:45,1.575798611111111,2,23,6,29
2020-08-02 08:15:02,6.755081018518519,4,28,17,45
2020-07-27 00:37:40,2.0225578703703704,1,1,1,2
2020-07-28 10:16:35,4.164594907407407,1,12,53,65
2020-07-24 09:44:22,0.27699074074074076,1,79,0,79
2020-08-03 12:16:44,11.660416666666666,3,4,4,8
2021-01-04 04:43:31,165.32833333333335,23,816,255,1071
2020-07-24 16:52:10,2.208553240740741,5,41,22,63
2020-09-13 13:06:54,53.16304398148148,70,975,559,1534
2020-07-22 16:18:36,0.4123263888888889,4,47,23,70
2020-11-26 03:16:36,129.4330787037037,36,395,251,646
2020-07-21 00:33:43,0.25072916666666667,1,5,1,6
2020-07-21 02:57:17,0.5955787037037037,4,20,7,27
2020-07-22 08:49:46,1.9052662037037038,4,107,5,112
2020-07-20 10:07:43,0.13868055555555556,1,14,2,16
2020-07-20 09:18:24,0.3247337962962963,1,32,1,33
2020-10-11 17:25:17,84.09662037037037,9,804,139,943
2020-07-18 21:23:49,0.001585648148148148,1,0,24,24
2020-07-28 17:02:42,9.868101851851852,1,6,11,17
2020-07-20 07:27:14,1.6699421296296297,1,105,367,472
2020-07-18 16:41:22,0.10037037037037037,1,6,98,104
2020-07-19 01:47:19,0.8293287037037037,1,1,1,2
2020-07-26 08:00:01,8.2825,1,3,3,6
2020-07-18 12:08:24,0.4402314814814815,1,2,1,3
2020-07-18 12:02:27,0.9137037037037037,2,91,89,180
2020-07-17 20:47:21,0.4174537037037037,1,9,9,18
2020-07-18 12:21:26,56.95423611111111,2,14,1,15
2020-07-17 05:33:09,0.1320023148148148,2,8,2,10
2020-07-17 16:15:26,0.7341550925925926,1,46,64,110
2020-11-01 17:27:26,107.91597222222222,1,211,64,275
2020-07-19 20:14:42,3.7914583333333334,8,366,42,408
2020-07-16 16:07:23,0.9780787037037038,3,10,24,34
2020-07-15 12:54:32,0.05430555555555556,1,1,1,2
2020-07-26 08:03:00,10.859837962962963,9,266,193,459
2020-12-03 21:49:08,142.33407407407407,20,45837,22475,68312
2020-07-17 22:33:08,4.3976851851851855,2,30,5,35
2020-07-17 03:57:32,2.7363773148148147,2,19,7,26
2020-07-16 16:09:06,3.0444097222222224,1,1,1,2
2020-08-04 16:27:19,22.78113425925926,4,186,138,324
2021-01-27 18:51:43,198.93383101851853,40,136963,22725,159688
2020-07-17 10:01:06,4.673067129629629,1,6,5,11
2020-07-12 08:32:09,0.34997685185185184,1,1,1,2
2020-07-12 15:22:14,0.9475231481481482,1,6,4,10
2020-07-10 23:20:43,0.024166666666666666,1,7,11,18
2020-07-11 05:29:46,0.296875,2,2,1,3
2020-07-10 22:43:26,0.20829861111111111,2,3,1,4
2020-07-15 22:29:07,2.9571064814814814,1,2,5,7
2020-07-10 08:37:00,0.24447916666666666,1,0,4,4
2020-07-10 08:38:35,0.27395833333333336,1,2,2,4
2020-07-10 13:15:59,0.4548726851851852,1,52,53,105
2020-08-27 00:14:44,48.931423611111114,23,31836,15145,46981
2020-07-09 22:10:40,2.246539351851852,1,108,104,212
2020-07-08 18:17:01,9.871412037037038,2,41,47,88
2020-07-07 08:35:29,0.2427314814814815,1,6,2,8
2020-07-05 21:30:04,0.1642361111111111,1,49,0,49
2020-07-06 23:09:20,1.642800925925926,1,54,1,55
2020-07-04 20:03:54,0.07770833333333334,1,2,0,2
2020-07-04 15:19:32,0.040358796296296295,1,1,0,1
2020-07-17 09:42:10,14.210451388888888,2,1655,993,2648
2020-08-03 23:12:11,32.02984953703704,6,1541,950,2491
2020-07-06 07:31:26,3.770949074074074,2,91,18,109
2020-07-19 14:00:15,18.034664351851852,5,323,159,482
2020-07-01 14:46:22,0.11790509259259259,1,4,3,7
2020-07-11 06:02:57,9.864768518518519,1,46,27,73
2020-09-13 14:52:31,74.48811342592593,4,21,4,25
2020-07-26 19:13:56,25.88204861111111,39,3672,2553,6225
2020-06-30 18:31:16,0.09454861111111111,1,9,2,11
2020-06-30 16:27:06,0.10143518518518518,1,4,3,7
2020-06-30 15:38:40,0.07493055555555556,1,15,15,30
2020-07-11 19:53:03,11.28025462962963,2,32,5,37
2020-07-01 19:09:09,1.7092476851851852,1,41,5,46
2020-07-20 08:58:13,21.264375,2,209,104,313
2020-07-10 18:54:11,12.024224537037037,3,21,7,28
2020-06-30 16:29:41,2.8144560185185186,1,4,0,4
2021-05-25 01:54:05,331.3253819444444,5,229,115,344
2020-07-18 12:34:44,20.979305555555555,1,17,4,21
2020-06-29 19:35:57,2.6116550925925925,2,5,2,7
2020-08-09 13:27:26,43.571354166666666,3,255,72,327
2020-07-18 11:58:32,5.985844907407407,5,7,263,270
2020-07-10 02:34:25,14.334583333333333,2,20,2,22
2020-06-25 13:25:14,0.07487268518518518,1,2,2,4
2020-06-25 09:09:39,0.815625,3,16,2,18
2020-07-18 12:23:43,24.49761574074074,1,24,0,24
2020-06-23 14:36:47,0.18444444444444444,1,2,2,4
2020-06-28 16:11:10,5.823784722222222,1,1,2,3
2020-07-02 12:54:24,9.854293981481481,1,1,1,2
2020-06-22 19:10:47,0.17502314814814815,1,2,0,2
2020-07-02 02:24:22,9.839930555555556,4,7,7,14
2020-07-07 02:36:16,15.262083333333333,6,99,24,123
2020-06-23 01:37:23,1.2580902777777778,1,14,2,16
2020-07-05 15:35:37,14.045023148148148,1,51,37,88
2020-07-02 18:07:56,11.338321759259259,1,82,2,84
2020-06-22 17:35:48,1.998935185185185,1,1,1,2
2020-06-23 14:57:01,3.8130787037037037,2,38,10,48
2020-07-21 12:31:05,32.0153125,5,2959,1429,4388
2020-07-07 19:08:19,18.69584490740741,4,92,81,173
2020-08-28 17:31:55,71.72964120370371,13,263,578,841
2020-06-19 02:34:51,0.3744675925925926,1,1,1,2
2020-06-17 18:47:32,0.08299768518518519,1,1,0,1
2020-07-06 22:28:32,19.252731481481483,1,157,140,297
2020-08-09 19:44:52,53.310462962962966,3,130,106,236
2020-08-29 23:47:02,74.11590277777778,4,458,151,609
2020-07-08 00:23:26,21.322488425925926,4,262,267,529
2020-06-23 14:09:12,10.066643518518518,4,115,14,129
2020-06-13 11:16:25,0.7883912037037037,1,1,1,2
2020-07-18 12:44:41,36.41587962962963,1,31,17,48
2020-06-20 16:51:09,8.69326388888889,1,2,7,9
2020-07-30 09:05:30,48.39144675925926,2,15218,12192,27410
2020-07-11 05:34:40,621.0318518518518,12,111419,56590,168009
2020-07-10 14:14:41,28.757164351851852,1,0,3,3
2020-06-14 13:42:44,16.518935185185185,1,15,15,30
2020-06-17 14:27:21,5.783240740740741,1,4,4,8
2020-06-12 11:43:09,0.9722916666666667,2,14,1,15
2020-06-12 02:16:25,0.2782291666666667,1,1,1,2
2020-06-11 18:52:53,0.18989583333333335,1,1,1,2
2020-06-12 00:15:03,0.9975115740740741,2,113,108,221
2020-07-09 22:34:04,29.09084490740741,2,41,4,45
2020-06-19 13:19:32,9.00318287037037,2,235,6,241
2020-06-15 23:51:09,5.475856481481482,6,131,43,174
2020-07-12 10:45:28,32.13994212962963,4,23,20,43
2020-06-28 16:15:23,18.877824074074073,1,23,0,23
2020-06-09 19:13:44,0.04501157407407407,1,1,1,2
2020-06-16 21:20:14,12.0709375,6,178,192,370
2020-06-15 23:49:56,7.424618055555555,4,70,23,93
2020-07-18 12:49:13,40.31061342592593,1,43,5,48
2020-06-22 19:50:01,14.744432870370371,4,402,14,416
2020-07-18 16:58:29,41.29989583333333,2,20,8,28
2020-06-07 20:52:14,1.0373842592592593,8,312859,297378,610237
2020-06-06 18:53:58,2.147835648148148,2,24,29,53
2020-06-06 21:20:47,1.1182175925925926,1,9,1,10
2020-06-04 02:05:58,0.0682175925925926,1,2,6,8
2020-06-06 20:02:22,4.037858796296296,2,32,18,50
2020-06-03 02:03:56,0.6819907407407407,1,4,2,6
2020-06-02 07:36:36,0.24200231481481482,4,34,32,66
2020-08-26 15:04:54,86.71106481481482,20,337,101,438
2020-06-20 14:27:34,20.49978009259259,12,630,522,1152
2020-06-02 07:45:17,1.7048611111111112,2,37,15,52
2020-06-06 20:13:39,6.385150462962963,5,458,286,744
2020-06-06 20:04:18,10.97337962962963,2,128,2340,2468
2020-06-07 23:29:24,8.063472222222222,1,4,9,13
2020-06-28 19:06:25,28.94559027777778,2,22,7,29
2020-06-01 14:55:46,1.8114930555555555,1,18,1,19
2020-06-01 09:44:01,1.8167824074074075,1,1,0,1
2020-05-30 14:02:21,0.8965277777777778,1,35,17,52
2020-07-18 22:22:41,37.588113425925926,2,53,10,63
2020-06-11 06:48:05,12.952013888888889,1,10,2,12
2020-06-17 14:31:12,19.516886574074075,1,22,2,24
2020-05-30 13:02:22,1.6516203703703705,1,3,46,49
2020-07-12 10:48:07,44.741458333333334,2,36,36,72
2020-11-11 19:19:31,167.17899305555557,2,7,3,10
2020-05-29 12:33:35,0.9460879629629629,2,5,4,9
2020-05-28 23:35:10,0.5009837962962963,1,5,439,444
2020-05-28 11:50:57,0.06606481481481481,1,31,30,61
2020-07-22 06:26:51,54.91483796296296,1,23,6,29
2020-06-01 22:41:58,4.756087962962963,1,214,65,279
2020-06-11 15:29:54,15.203645833333333,1,33,8,41
2020-07-16 16:28:25,50.16240740740741,2,62,54,116
2020-06-16 02:25:11,19.734872685185184,1,3,3,6
2020-05-27 21:48:26,0.7403125,1,3,3,6
2020-05-27 03:45:01,0.034409722222222223,1,108,3,111
2020-06-17 15:21:09,21.69814814814815,2,7,8,15
2020-05-26 23:39:13,0.17270833333333332,1,6,6,12
2020-05-28 11:43:23,1.9227777777777777,1,57,36,93
2020-05-26 19:27:48,0.4875231481481481,1,22,3,25
2020-05-27 03:38:33,1.2632407407407407,4,1061,40,1101
2020-05-28 23:28:17,3.718958333333333,3,102,32,134
2020-07-17 22:10:32,53.37524305555556,1,1,1,2
2020-05-25 09:05:56,0.5336805555555556,1,0,1,1
2020-05-28 21:34:10,6.849085648148148,7,57,25,82
2020-06-09 02:36:25,15.631736111111111,2,16,6,22
2020-07-18 14:37:20,55.250659722222224,5,75,36,111
2020-05-25 18:08:12,1.6970601851851852,2,92,5,97
2020-06-16 15:29:59,24.087743055555556,19,6248,4705,10953
2020-05-27 16:29:30,4.287488425925926,1,86,9,95
2020-05-27 15:59:42,4.3864930555555555,1,1,1,2
2021-08-27 07:12:22,461.2239699074074,29,200501,40217,240718
2020-05-26 17:54:01,4.0240277777777775,4,122,156,278
2020-06-13 22:41:21,22.456921296296297,1,21,37,58
2020-07-18 17:24:26,58.01711805555556,1,42,35,77
2020-05-22 02:00:32,0.3884606481481481,1,11,8,19
2020-05-21 12:27:27,0.008148148148148147,1,4,1,5
2020-05-21 21:50:47,0.4306597222222222,1,6,9,15
2020-05-25 21:47:13,3.939722222222222,2,58,14,72
2020-06-04 20:51:30,14.842199074074074,1,5,5,10
2020-05-20 18:36:54,1.8788773148148148,1,76,12,88
2020-05-26 19:43:46,287.88731481481483,3,700,140,840
2020-05-20 09:45:06,0.30332175925925925,1,1,1,2
2020-07-30 19:59:24,71.76636574074074,37,12596,7755,20351
2020-05-20 10:13:51,0.5469907407407407,1,14,2,16
2020-05-19 00:03:48,0.1632523148148148,3,5,5,10
2020-05-20 09:47:11,1.708449074074074,3,108,60,168
2020-07-10 21:26:11,60.17578703703704,14,7430,4577,12007
2020-07-18 23:39:02,61.421782407407406,2,9,2,11
2020-05-18 12:53:16,0.02017361111111111,1,1,1,2
2021-08-29 05:33:25,467.9409837962963,4,222723,48024,270747
2020-09-08 11:59:14,116.61300925925926,15,42187,24678,66865
2020-05-17 17:21:03,0.21738425925925925,5,245,141,386
2020-05-18 18:37:56,1.3570717592592592,1,6,2,8
2020-06-04 11:19:12,18.230243055555555,1,24,5,29
2020-05-19 01:01:11,1.911701388888889,2,12,2,14
2020-05-17 05:15:57,0.18318287037037037,1,8,16,24
2020-05-20 17:11:35,199.9229398148148,5,363,115,478
2020-05-17 05:25:05,0.8227199074074074,1,12,16,28
2020-05-16 15:18:46,0.3935763888888889,9,102,48,150
2020-05-16 03:26:25,0.043784722222222225,1,0,8,8
2020-05-28 11:46:19,13.349456018518518,1,11,4,15
2020-05-16 08:31:36,6.214988425925926,1,7,22,29
2020-05-16 08:32:53,0.6548263888888889,1,2,2,4
2020-05-15 20:45:33,1.1655787037037038,2,2,1,3
2020-06-06 11:40:22,23.142476851851853,1,9,10,19
2020-05-20 17:11:53,6.558449074074074,11,373,48,421
2020-05-14 05:54:25,0.13703703703703704,2,3,3,6
2020-05-20 02:08:09,6.108229166666667,2,28,16,44
2020-05-21 02:44:54,0.37136574074074075,1,96,40,136
2020-05-13 05:48:34,0.12729166666666666,1,21,30,51
2020-05-13 16:55:38,2.1411226851851852,6,198,59,257
2020-10-01 17:49:00,142.7954861111111,41,57101,29867,86968
2020-05-11 17:23:22,0.1748611111111111,1,4,4,8
2020-05-18 00:53:03,7.059872685185185,2,43,17,60
2020-05-11 09:20:15,65.96077546296296,1,6,19,25
2020-05-16 23:32:45,6.088506944444444,1,19,4,23
2020-05-12 10:35:47,141.48591435185185,2,294,191,485
2020-05-12 10:21:23,141.47591435185186,1,134,75,209
2020-05-20 10:15:49,149.52341435185184,1,29,29,58
2020-05-10 14:22:26,0.01980324074074074,1,19,6,25
2020-05-27 18:22:51,17.294849537037038,1,3,6,9
2020-07-18 20:32:44,208.94311342592593,1,42,46,88
2020-05-10 10:14:55,0.04984953703703704,1,7,1,8
2020-05-11 15:12:15,1.4249768518518517,4,1769,1195,2964
2020-05-29 20:07:04,19.65888888888889,1,4,15,19
2020-05-10 08:18:20,0.18506944444444445,1,0,5,5
2020-05-17 05:05:47,7.15105324074074,1,6,1,7
2020-05-29 04:32:08,19.153564814814814,2,48,17,65
2020-05-09 18:29:44,0.20737268518518517,2,7,4,11
2020-05-09 08:28:50,0.32741898148148146,1,3,29,32
2020-11-25 01:24:23,199.93711805555554,6,257,102,359
2020-05-09 21:09:56,1.0214814814814814,5,37,17,54
2020-05-29 07:24:08,23.885127314814813,1,4,43,47
2020-05-08 05:05:28,0.274837962962963,1,4,4,8
2020-06-09 14:22:19,32.74560185185185,6,52,16,68
2020-05-08 05:17:26,2.4149884259259258,1,12,3,15
2020-05-07 18:58:30,0.043611111111111114,1,1,0,1
2020-05-09 20:22:47,2.1264351851851853,12,665,466,1131
2020-05-10 10:24:32,2.862303240740741,10,38,23,61
2020-05-07 20:49:23,0.34068287037037037,1,6,0,6
2020-05-09 13:50:10,2.4609027777777777,2,23,15,38
2020-05-08 05:26:16,2.4666550925925925,1,0,2,2
2020-05-07 08:41:04,1.5564004629629629,1,1,1,2
2020-05-06 20:02:20,0.18815972222222221,1,14,3,17
2020-11-15 11:57:26,193.58020833333333,92,167311,47469,214780
2020-05-09 20:08:47,3.644710648148148,2,42,1,43
2020-05-06 05:27:32,0.08702546296296296,1,30,43,73
2020-05-10 12:17:45,4.417291666666666,2,8,4,12
2020-05-06 01:40:20,0.04650462962962963,1,3,0,3
2020-05-05 22:35:46,0.0003125,1,30,85814,85844
2020-05-09 20:28:34,138.95730324074074,2,716,588,1304
2020-05-05 17:49:43,0.029594907407407407,1,1,1,2
2020-05-08 05:33:56,2.819189814814815,1,2,5,7
2020-05-05 10:54:16,0.24784722222222222,1,26,0,26
2020-05-04 21:40:04,0.09707175925925926,2,3,3,6
2020-05-08 02:12:28,3.582523148148148,3,9,115,124
2020-05-08 07:07:57,4.196666666666666,2,5,5,10
2020-05-04 21:16:54,0.8246180555555556,1,3,22,25
2020-05-10 10:16:58,6.394502314814815,6,2365,1424,3789
2020-05-04 10:33:58,144.57085648148148,1,15,5,20
2020-05-04 10:37:37,133.50109953703705,2,75,18,93
2020-05-17 17:09:56,14.074953703703704,5,119,104,223
2020-05-03 14:04:39,0.01005787037037037,2,31,5,36
2020-05-07 20:48:51,5.331134259259259,5,60,55,115
2020-05-03 14:07:58,0.5402546296296297,8,41,15,56
2020-05-09 09:47:16,6.562905092592593,2,16,6,22
2020-05-02 18:38:31,0.5198958333333333,1,1,1,2
2020-05-02 05:09:46,0.06534722222222222,1,7,21,28
2020-05-05 18:17:44,3.696134259259259,7,40,15,55
2020-05-02 00:38:35,0.10582175925925925,1,0,4,4
2020-05-01 21:43:24,0.1486111111111111,1,21,1,22
2020-05-26 00:20:12,27.844236111111112,16,279,156,435
2020-05-04 10:32:08,3.2202314814814814,3,97,11,108
2020-05-01 09:32:43,0.3791087962962963,2,28,4,32
2020-05-02 22:22:30,2.0719328703703703,4,25,13,38
2020-05-04 11:06:21,3.9240856481481483,1,15,0,15
2020-05-08 01:42:07,7.6039814814814815,3,46,3,49
2020-04-30 15:23:07,0.1886574074074074,1,3,0,3
2020-05-04 14:56:36,4.765208333333334,1,5,4,9
2020-05-02 16:19:16,3.246724537037037,4,23,17,40
2020-05-06 21:28:53,7.476574074074074,7,72,32,104
2020-04-29 07:46:43,0.21332175925925925,1,0,5,5
2020-04-29 08:20:09,0.3524189814814815,1,1,1,2
2020-05-03 14:05:43,4.596215277777778,2,209,210,419
2020-05-02 19:50:45,3.8639004629629627,1,9,105,114
2020-04-29 04:15:02,0.370625,1,9,9,18
2020-04-28 20:41:44,0.10342592592592592,1,58,216,274
2021-12-01 18:44:22,582.9110300925926,9,1860,2125,3985
2020-04-27 17:26:42,0.13832175925925927,2,13,10,23
2020-04-28 15:22:34,1.1435185185185186,1,19,21,40
2020-04-27 20:58:52,0.8817476851851852,1,1,0,1
2020-04-26 23:17:17,0.11100694444444445,1,20,1,21
2020-04-26 21:44:49,0.06421296296296296,1,1,1,2
2020-05-03 14:08:15,26.857939814814817,2,162,2,164
2020-04-26 09:48:27,0.12043981481481482,5,41,5,46
2020-04-26 19:41:38,0.5631597222222222,2,385,47,432
2020-04-26 08:45:26,-0.8355671296296296,1,2,2,4
2020-04-30 00:48:20,4.043148148148148,2,20,1,21
2020-04-26 06:47:55,0.384537037037037,2,13,5,18
2020-04-25 15:34:22,0.0821412037037037,1,17,1,18
2020-04-26 09:45:28,1.1126041666666666,1,66,6,72
2020-04-26 15:27:50,3.080162037037037,4,1229,140,1369
2020-04-23 22:58:12,0.04158564814814815,1,3,1,4
2020-04-24 10:49:09,0.5479398148148148,1,4,2,6
2020-04-28 08:29:45,4.558877314814815,5,48,17,65
2020-04-22 21:22:04,0.35944444444444446,3,78362,42493,120855
2020-04-26 16:20:48,4.222210648148148,3,35,35,70
2020-04-25 13:44:39,3.6507638888888887,2,23,20,43
2021-04-14 16:46:55,357.9616550925926,43,190950,39889,230839
2020-04-26 09:42:10,5.017673611111111,2,11,3,14
2020-04-21 12:48:18,0.21988425925925925,1,2,2,4
2020-04-24 15:01:01,3.8533449074074073,2,62,5,67
2020-04-26 09:57:54,3.479699074074074,2,5,3,8
2020-04-21 00:57:45,0.9263194444444445,3,17,4,21
2020-04-29 20:23:14,9.991956018518518,7,17,13,30
2020-05-22 15:54:25,32.93974537037037,1,215,5,220
2020-04-26 09:13:17,6.9432175925925925,1,86,10,96
2020-05-23 22:55:58,35.07050925925926,3,325,73,398
2020-04-19 12:07:36,1.0094675925925927,5,67,30,97
2020-04-18 10:41:10,0.31425925925925924,1,30,0,30
2020-04-18 10:06:38,0.35050925925925924,1,66,67,133
2020-04-21 06:01:20,3.4069791666666664,2,69,6,75
2020-04-26 09:18:36,8.587222222222222,4,19,7,26
2020-04-18 00:17:05,0.24559027777777778,1,1,1,2
2020-04-18 10:50:10,0.8627546296296297,4,26,7,33
2020-04-17 10:36:15,0.036585648148148145,1,4,2,6
2020-04-21 00:02:30,4.289479166666666,1,89,11,100
2020-04-26 09:30:04,9.228703703703705,1,4,3,7
2020-04-17 02:15:54,0.129375,1,1,1,2
2020-04-17 00:20:41,0.0707175925925926,1,41,0,41
2020-05-02 19:25:56,16.333541666666665,7,74,37,111
2020-04-16 23:14:17,0.8072453703703704,1,15,25,40
2020-04-15 20:05:04,0.09788194444444444,1,12,6,18
2020-04-15 15:24:15,0.023541666666666666,1,2,2,4
2020-04-14 18:28:48,0.10280092592592592,1,1,1,2
2020-04-14 01:52:20,0.08736111111111111,1,0,54,54
2020-04-19 00:49:12,5.967164351851852,7,102,53,155
2020-04-20 01:15:31,8.437152777777778,40,1297,730,2027
2020-04-16 12:33:02,5.714189814814815,2,13,13,26
2020-04-13 03:05:57,2.4780787037037038,3,106,24,130
2020-04-11 00:44:36,0.4045949074074074,1,24,6,30
2020-04-13 21:50:50,3.3680208333333335,1,14,0,14
2020-04-17 13:02:39,7.048206018518519,5,961,540,1501
2020-04-13 18:24:19,3.483738425925926,3,18,37,55
2020-04-10 11:43:20,0.9098611111111111,1,1,1,2
2020-04-10 20:21:48,1.2967824074074075,2,4,4,8
2020-04-12 10:01:39,2.8731597222222223,3,30,3,33
2020-04-09 18:04:53,0.32003472222222223,2,16,6,22
2020-04-08 19:13:05,0.3285532407407407,2,18,0,18
2020-04-14 00:28:21,5.875613425925926,1,84,0,84
2020-04-09 00:30:38,1.243460648148148,3,34,18,52
2020-04-09 10:46:30,1.9112731481481482,2,9,0,9
2020-04-06 18:39:06,0.006516203703703704,1,1,1,2
2020-04-09 08:16:31,2.5862037037037036,5,5,5,10
2020-04-06 13:57:42,0.04861111111111111,3,15,5,20
2020-04-25 15:37:14,19.115023148148147,3,1421,615,2036
2020-04-21 00:46:28,15.194398148148148,10,2606,988,3594
2020-05-09 20:43:51,34.167627314814816,4,80,8,88
2020-04-12 16:33:20,7.019699074074074,1,22,24,46
2020-05-21 00:24:49,45.47020833333333,5,107,39,146
2020-04-14 06:51:37,9.007523148148149,3,60,56,116
2020-04-06 00:22:26,0.977025462962963,1,5,0,5
2020-04-04 18:01:40,0.06105324074074074,1,15,0,15
2020-04-26 10:02:28,21.762905092592593,1,124,0,124
2020-04-04 09:35:26,0.3677314814814815,1,1,2,3
2020-04-09 09:19:57,5.613252314814815,2,70,23,93
2020-05-26 12:53:34,53.08232638888889,2,8,2,10
2020-04-18 20:42:01,16.97908564814815,8,1725,709,2434
2020-03-31 09:41:30,0.3719675925925926,2,2,2,4
2020-03-31 02:19:38,0.08577546296296296,1,4,1,5
2020-04-05 12:08:46,5.521215277777777,1,5,5,10
2020-04-27 19:56:57,28.04454861111111,1,23,18,41
2020-04-28 08:11:08,28.54769675925926,1,1,63,64
2020-05-05 22:35:08,35.72283564814815,98,829435,572993,1402428
2020-05-23 22:45:58,54.396516203703705,12,9038,3795,12833
2020-03-30 12:20:04,0.05273148148148148,1,33,33,66
2021-12-06 00:24:47,615.7599884259259,9,324871,139725,464596
2020-04-18 20:28:29,19.711689814814815,3,28,11,39
2020-04-04 10:38:09,5.378287037037037,5,46,30,76
2020-04-27 10:18:14,0.4516898148148148,1,13,4,17
2020-03-30 00:38:41,0.030081018518518517,1,3,3,6
2020-03-29 10:32:51,0.20032407407407407,1,39,16,55
2020-03-31 09:47:18,3.132650462962963,2,0,48,48
2020-03-29 11:35:06,0.40456018518518516,1,9,4,13
2020-04-02 15:22:37,4.639004629629629,6,59,46,105
2020-04-13 21:59:37,16.018935185185185,1,0,268,268
2020-03-28 19:36:10,4.665868055555555,1,6,4,10
2020-05-06 21:13:28,39.31571759259259,2,39,32,71
2020-04-26 16:23:41,29.186261574074074,27,4372,1471,5843
2020-03-28 22:09:50,0.5741087962962963,1,26,1,27
2020-03-28 14:20:25,0.37863425925925925,1,1,1,2
2020-03-27 14:12:06,0.06851851851851852,1,1,1,2
2020-03-27 12:06:25,0.033368055555555554,1,3,3,6
2020-04-13 03:19:47,17.387650462962963,2,49,3,52
2020-04-01 23:42:16,7.412013888888889,4,80,27,107
2020-03-27 10:51:21,2.338923611111111,1,19,23,42
2020-03-25 09:38:45,0.30931712962962965,1,1,6,7
2020-03-27 12:08:16,3.9487615740740742,1,29,13,42
2020-03-25 10:23:58,1.927824074074074,1,12,0,12
2020-05-25 21:38:50,64.31253472222222,15,1009,612,1621
2020-03-27 12:16:40,5.552731481481482,2,65,14,79
2020-04-03 03:43:06,12.207060185185185,2,30,20,50
2020-04-13 22:11:17,23.143333333333334,1,1,1,2
2020-03-21 19:43:05,0.2959837962962963,1,5,5,10
2020-03-21 20:57:42,0.7604861111111111,1,47,62,109
2020-03-21 11:33:05,0.5543518518518519,1,2,2,4
2021-01-27 06:54:09,314.09747685185187,20,160523,33345,193868
2020-03-21 19:51:03,1.6310416666666667,4,13,6,19
2020-03-20 16:47:38,0.5304513888888889,2,10,14,24
2020-07-07 18:47:14,130.96070601851852,29,4022,2898,6920
2020-03-19 17:06:41,0.06996527777777778,1,6,6,12
2020-03-19 10:48:58,0.3291898148148148,1,163,1,164
2020-03-19 09:38:05,0.2738541666666667,1,19,19,38
2020-04-05 03:23:54,17.17015046296296,6,68,24,92
2020-03-21 22:04:12,2.975671296296296,2,13,0,13
2020-04-26 17:45:37,39.386805555555554,9,192,50,242
2020-03-24 11:21:25,6.121932870370371,1,57,0,57
2020-03-18 19:40:25,0.6387037037037037,1,483,0,483
2020-04-17 04:22:25,79.29734953703704,12,405,177,582
2020-03-17 15:00:53,0.003449074074074074,1,0,1,1
2020-03-17 14:48:37,0.04387731481481481,1,3,3,6
2020-03-20 15:50:54,4.933622685185185,4,21,11,32
2020-03-15 17:36:47,0.053321759259259256,1,5,0,5
2020-04-14 06:47:01,79.05289351851852,18,665,392,1057
2020-03-29 04:55:00,15.162210648148148,6,46,14,60
2020-04-12 07:59:48,62.13037037037037,20,2974,1051,4025
2020-04-20 13:51:55,69.33783564814814,38,11546,6351,17897
2020-03-13 00:01:53,85.66081018518518,25,11646,9130,20776
2020-03-28 14:45:02,18.27664351851852,1,3,56,59
2020-03-15 11:44:50,6.253935185185185,5,92,83,175
2020-03-09 08:08:40,0.3971875,1,2,1,3
2020-03-12 20:28:17,4.449988425925926,2,20,5,25
2020-03-10 16:18:27,6.343252314814815,1,0,1072,1072
2020-04-11 12:54:44,34.2893287037037,5,34,32,66
2020-03-08 07:32:21,0.21114583333333334,1,1,1,2
2020-03-18 19:44:23,10.818483796296297,1,0,4,4
2020-03-11 16:37:13,3.8816319444444445,1,29,11,40
2020-04-19 10:00:46,43.65939814814815,1,15,2,17
2020-05-10 12:19:36,65.08532407407408,1,6,19,25
2020-03-07 09:03:08,1.1322453703703703,1,1,1,2
2020-03-07 21:48:39,2.3125115740740743,1,12,1,13
2020-03-05 11:37:14,0.2903472222222222,1,3,8,11
2020-04-14 02:18:29,39.96440972222222,7,40,29,69
2020-03-10 04:18:59,5.887615740740741,1,3,47,50
2020-03-08 00:50:12,3.698634259259259,1,0,112,112
2020-03-04 15:16:26,0.3441782407407407,1,6,36,42
2020-03-07 22:36:48,3.649988425925926,1,4,44,48
2020-03-08 17:46:14,5.812835648148148,3,71,38,109
2020-04-26 18:03:44,55.74717592592592,2,4,4,8
2020-04-08 03:57:07,39.002175925925926,2,34,29,63
2020-03-16 04:22:10,17.35996527777778,18,495,514,1009
2020-03-03 21:24:51,6.810613425925926,1,1,258,259
2020-03-04 09:34:54,34.927141203703705,1,26,39,65
2020-04-13 22:08:02,48.24180555555556,1,2,2,4
2020-02-25 20:32:43,0.6471759259259259,3,54,25,79
2020-03-07 22:43:22,12.200451388888888,1,292,14,306
2020-04-26 18:19:52,62.112685185185185,1,1,1,2
2020-02-23 23:48:13,1.4750925925925926,6,167,175,342
2020-02-23 14:36:14,0.43765046296296295,1,7,3,10
2020-02-23 14:32:34,0.5372337962962963,2,77,82,159
2020-12-05 22:14:21,290.1429513888889,9,161922,35808,197730
2020-02-21 03:13:36,0.3776388888888889,1,0,1,1
2020-02-25 23:55:32,7.8272916666666665,1,72,72,144
2020-02-20 03:39:45,2.012951388888889,1,16,24,40
2020-02-20 19:37:03,2.6994328703703703,3,13,18,31
2020-02-18 06:51:35,0.1926388888888889,1,26,61,87
2020-02-18 07:35:48,0.23539351851851853,1,3,9,12
2020-02-18 07:34:59,0.24002314814814815,1,3,5,8
2020-02-18 05:51:26,0.23465277777777777,1,16,26,42
2020-02-18 07:36:32,0.3503935185185185,1,0,1,1
2020-02-19 01:52:57,1.1235185185185186,1,11,17,28
2020-02-18 00:31:48,0.0849074074074074,1,0,2,2
2020-03-04 05:39:26,15.30804398148148,2,26,37,63
2020-02-19 04:02:40,1.2604861111111112,3,11,17,28
2020-02-17 23:32:47,0.1291087962962963,1,7,9,16
2020-02-17 22:59:58,0.09324074074074074,1,4,2,6
2020-02-24 03:42:55,6.420925925925926,2,35,3,38
2020-02-17 22:58:40,0.8930671296296296,2,84,132,216
2020-02-23 14:40:08,6.600625,2,14,18,32
2020-02-17 23:56:45,0.9165277777777778,1,2,2,4
2020-02-17 16:50:53,0.6984953703703703,1,2,6,8
2020-02-28 06:04:57,12.731215277777778,5,28,13,41
2020-03-25 21:28:01,39.42459490740741,1,24,15,39
2020-03-12 00:09:44,28.127766203703704,6,1370,704,2074
2020-02-15 19:15:42,1.5536458333333334,1,13,0,13
2020-02-14 02:03:20,0.12891203703703705,1,2,2,4
2020-02-28 20:40:26,15.421354166666667,1,63,28,91
2020-02-13 21:02:24,0.615462962962963,1,13,0,13
2020-02-13 03:53:46,0.2260648148148148,1,1,1,2
2020-02-13 05:31:08,0.34174768518518517,1,1,0,1
2020-02-23 20:10:16,11.013842592592592,4,18,5,23
2020-02-12 21:00:47,0.059895833333333336,1,1,2,3
2020-02-14 14:38:02,1.8844907407407407,1,62,21,83
2020-02-12 16:51:03,0.0062037037037037035,1,1,1,2
2020-02-14 12:50:07,2.5843402777777778,6,47,22,69
2020-02-12 18:16:30,0.8649074074074075,1,5,1,6
2020-05-02 23:02:33,81.76409722222222,1,71,60,131
2020-02-09 16:02:05,0.04402777777777778,1,1,1,2
2020-02-10 04:46:14,0.7329745370370371,1,9,1,10
2020-03-27 14:17:22,47.13842592592592,1,6,6,12
2020-02-16 12:15:15,7.184652777777778,3,14,6,20
2020-02-12 17:34:46,3.469375,1,16,1,17
2020-03-25 13:02:41,45.97020833333333,3,14,8,22
2020-05-08 05:23:39,90.72348379629629,5,33,11,44
2020-02-07 16:26:04,0.4549074074074074,1,8,0,8
2020-02-11 22:01:31,5.3416550925925925,1,86,95,181
2020-12-20 19:38:16,317.99322916666665,10,166267,37444,203711
2020-02-09 01:21:25,2.253159722222222,1,5,4,9
2020-02-04 23:07:22,0.045856481481481484,1,1,1,2
2020-02-13 06:42:14,8.583506944444444,2,20,9,29
2020-04-06 11:15:40,62.67936342592593,8,85,57,142
2020-02-03 02:40:19,0.10670138888888889,2,5,5,10
2020-02-27 03:12:50,24.34872685185185,1,43,24,67
2020-02-16 19:11:16,14.608865740740741,26,151,28,179
2020-02-11 21:16:02,9.82324074074074,1,83,42,125
2020-02-02 10:59:57,0.6207870370370371,1,2,3,5
2020-05-26 19:32:54,115.10894675925925,11,102,56,158
2020-01-30 06:17:53,0.0271875,1,9,13,22
2020-01-30 00:40:50,0.3000462962962963,1,0,1,1
2020-04-06 04:04:07,67.40601851851852,4,59,46,105
2020-01-30 00:08:24,0.4079861111111111,1,1,1,2
2020-02-17 16:47:31,19.301909722222224,1,12,57,69
2020-02-06 09:12:57,8.000659722222222,1,1,2,3
2020-02-13 06:45:37,14.951724537037038,2,43,55,98
2020-01-29 23:12:32,0.6033912037037037,1,9,9,18
2020-01-29 09:38:17,0.061793981481481484,1,3,3,6
2020-05-25 03:33:42,116.9871875,3,261,73,334
2020-01-29 00:10:16,0.8313078703703703,1,6,0,6
2020-02-13 08:09:43,16.598333333333333,3,35,18,53
2020-05-09 08:33:26,106.08423611111111,3,108,15,123
2020-01-28 00:34:41,3.0712847222222224,2,3,2,5
2020-02-15 08:54:06,66.83805555555556,15,8588,6771,15359
2020-01-24 09:50:22,0.2275462962962963,4,34,8,42
2020-01-24 20:00:22,1.063564814814815,5,264,91,355
2020-01-22 21:19:17,0.030381944444444444,1,1,1,2
2020-02-08 10:43:21,16.644837962962963,3,16,10,26
2020-02-11 20:48:50,20.811979166666667,3,165,99,264
2020-01-21 19:30:10,0.005532407407407408,1,65,0,65
2020-02-18 02:08:27,27.75724537037037,7,174,118,292
2020-01-26 06:04:07,4.933761574074074,3,14,14,28
2020-01-21 23:08:00,1.034675925925926,2,2,2,4
2020-05-08 07:16:47,110.5195486111111,8,300,283,583
2020-04-19 17:46:51,90.00707175925926,2,491,202,693
2020-02-12 15:24:57,23.229166666666668,4,27,16,43
2020-05-22 23:34:45,125.61975694444445,2,120,12,132
2020-01-17 23:09:47,0.04883101851851852,1,3,4,7
2020-01-17 17:07:59,0.28653935185185186,1,44,79,123
2020-05-11 04:52:07,115.04130787037037,6,30,14,44
2020-04-26 18:52:16,101.08502314814815,1,32,8,40
2020-01-16 17:40:06,0.40552083333333333,1,1,2,3
2020-02-23 05:57:51,70.89002314814815,12,199,26,225
2020-01-16 07:39:06,0.005520833333333333,1,1,12,13
2020-03-11 21:10:24,96.45930555555556,27,6823,3676,10499
2020-01-16 14:37:13,0.7131018518518518,2,40,5,45
2020-01-22 17:32:03,6.85400462962963,4,39,14,53
2020-01-15 04:34:40,0.23835648148148147,1,3,2,5
2020-01-15 00:26:50,0.09923611111111111,1,78,124,202
2020-01-16 15:41:09,2.902604166666667,1,23,17,40
2020-01-15 21:32:55,3.0647569444444445,17,89,424,513
2020-12-13 02:11:45,335.3463194444444,6,283,21,304
2020-01-12 06:22:05,0.003321759259259259,1,1,1,2
2020-01-12 11:35:02,0.26439814814814816,1,50,76,126
2020-01-13 22:05:54,1.8616319444444445,1,64,6,70
2020-11-09 03:21:03,302.1987037037037,17,73050,37755,110805
2020-05-20 17:41:58,130.8180324074074,2,29,16,45
2020-01-11 13:24:01,0.6360532407407408,2,18,17,35
2020-01-12 04:47:53,1.3584837962962963,1,172,212,384
2020-01-10 18:38:23,0.4530787037037037,1,0,6,6
2020-01-10 12:47:49,0.22333333333333333,1,1,1,2
2020-01-19 13:12:31,9.870393518518519,1,2,2,4
2020-01-14 04:25:47,5.008078703703704,1,28,1,29
2020-01-19 14:58:34,11.033287037037036,1,333,519,852
2020-01-14 00:08:11,6.331597222222222,3,13,5,18
2020-01-05 13:56:51,0.10353009259259259,2,3,1,4
2020-01-05 03:18:20,0.15449074074074073,1,12,0,12
2020-01-05 03:23:27,0.33239583333333333,1,11,11,22
2020-01-05 12:10:39,0.6353472222222222,1,96,58,154
2021-02-06 19:03:47,400.01084490740743,52,78721,41855,120576
2020-01-03 16:25:23,0.044224537037037034,1,1,1,2
2020-01-05 14:04:11,1.9844675925925925,1,15,11,26
2020-01-09 08:02:45,5.8125,1,5,14,19
2020-01-03 11:21:48,0.00866898148148148,1,5,5,10
2020-01-03 18:32:27,0.9436805555555555,1,4,4,8
2020-02-11 21:19:55,47.26482638888889,21,2254,1509,3763
2020-01-01 18:38:00,0.021354166666666667,1,1,1,2
2020-04-27 21:11:09,142.09008101851853,6,478,120,598
2020-01-01 16:50:25,0.12289351851851851,1,5,5,10
2020-01-04 10:57:35,2.977222222222222,2,661,627,1288
2020-01-01 17:13:38,0.8853472222222222,1,111,28,139
2020-01-01 18:40:55,0.9693981481481482,1,190,21,211
2019-12-30 22:47:59,0.008356481481481482,1,1,1,2
2019-12-31 21:51:39,0.9740856481481481,1,251,16,267
2019-12-30 05:51:13,1.3856481481481482,4,42,192,234
2019-12-29 17:01:04,0.05056712962962963,1,14,21,35
2019-12-29 21:06:23,0.3885416666666667,2,6,5,11
2019-12-29 10:37:12,0.13322916666666668,2,19,0,19
2019-12-29 15:47:02,0.3697800925925926,2,6,4,10
2019-12-30 00:35:02,0.7957638888888889,1,185,19,204
2020-02-01 21:41:31,35.27322916666667,5,85,24,109
2019-12-28 20:33:32,0.30716435185185187,5,5,5,10
2019-12-28 05:20:52,0.4815509259259259,1,64,318,382
2019-12-28 05:07:25,0.49247685185185186,2,12,43,55
2019-12-28 20:03:03,1.2818981481481482,4,47,55,102
2019-12-28 05:15:51,3.451261574074074,2,2,2,4
2019-12-27 06:24:10,3.061400462962963,2,11,2,13
2019-12-27 06:39:02,3.5680787037037036,2,54,7,61
2020-02-12 14:12:54,51.975266203703704,7,108,47,155
2021-11-10 22:48:27,688.9113773148148,3,79,18,97
2019-12-27 06:07:07,7.473414351851852,3,9,7,16
2020-01-14 05:09:12,26.979849537037037,8,87,46,133
2019-12-27 22:00:21,7.908414351851852,3,60,14,74
2019-12-27 06:29:21,7.353506944444445,1,10,7,17
2019-12-19 21:09:08,0.18246527777777777,1,28,0,28
2020-11-14 22:33:56,331.3743865740741,12,78420,41295,119715
2020-01-02 19:24:54,31.498391203703704,5,32,15,47
2019-12-27 05:53:24,7.868761574074074,2,121,951,1072
2020-02-23 05:08:46,66.47131944444445,10,224,219,443
2019-12-17 22:06:25,0.08160879629629629,1,4,4,8
2019-12-22 03:01:18,4.44193287037037,1,3,0,3
2019-12-17 06:39:28,0.2465277777777778,1,32,16,48
2019-12-27 05:56:53,10.667488425925926,2,9,8,17
2019-12-27 06:00:16,11.017962962962963,2,3,1,4
2020-01-15 19:53:19,3.0906018518518517,1,11,3,14
2020-01-06 07:33:56,21.46954861111111,11,180,118,298
2019-12-15 20:32:56,0.0793287037037037,1,3,2,5
2019-12-15 19:29:55,2.0660648148148146,1,18,2,20
2019-12-13 18:02:30,0.7413888888888889,1,1,0,1
2019-12-12 20:16:02,0.4873263888888889,2,9,0,9
2020-05-21 23:38:24,162.88778935185186,11,50,19,69
2019-12-15 17:10:20,5.0181712962962965,1,54,9,63
2019-12-23 10:15:41,13.251226851851852,1,127,8,135
2019-12-17 10:27:54,8.269293981481482,4,41,9,50
2020-02-28 03:58:20,82.3079861111111,2,155,67,222
2020-03-01 22:19:16,85.19175925925926,15,21987,15657,37644
2019-12-15 01:22:23,8.637719907407407,1,2,1,3
2019-12-10 06:48:05,2.6866898148148146,2,9,14,23
2019-12-08 20:17:18,2.5341319444444443,3,24,15,39
2019-12-08 20:18:42,3.589212962962963,1,46,0,46
2019-12-05 15:20:58,0.7816666666666666,1,5,132,137
2019-12-06 00:16:29,1.4805324074074073,2,5,2,7
2019-12-04 04:08:44,0.5271990740740741,1,0,1,1
2019-12-04 00:58:28,0.8360300925925926,3,89,20,109
2020-01-19 15:22:20,48.14157407407407,4,55,18,73
2019-12-02 16:26:51,0.4330787037037037,1,84,84,168
2020-04-26 23:08:37,147.23782407407407,1,12,1,13
2019-12-02 20:07:51,1.1164351851851853,3,4,4,8
2019-12-02 01:55:58,14.1640625,10,3918,3932,7850
2020-01-05 12:17:51,35.0084837962963,1,21,0,21
2019-12-01 10:11:52,0.024502314814814814,2,4,2,6
2019-12-04 03:58:31,3.185,10,60,34,94
2019-12-04 20:46:36,4.022349537037037,1,145,11,156
2019-12-28 19:09:01,28.987453703703704,1,2,1,3
2019-11-28 18:16:50,0.31277777777777777,1,6,40,46
2019-11-29 05:40:46,11.32017361111111,7,2547,2556,5103
2019-12-04 21:02:32,7.046886574074074,1,14,0,14
2020-04-02 03:14:31,127.60351851851851,4,18048,12829,30877
2019-12-01 22:49:18,6.028657407407407,4,25,17,42
2019-11-29 06:07:17,3.371215277777778,2,11,1,12
2019-11-29 05:42:32,3.3692939814814813,2,11,7,18
2020-09-24 21:47:12,305.2563425925926,9,68615,36425,105040
2019-11-24 00:20:53,0.06707175925925926,1,33,0,33
2019-11-30 07:33:24,6.4293402777777775,1,144,12,156
2019-12-04 20:59:46,11.036111111111111,1,31,1,32
2019-11-25 22:23:37,2.1635648148148148,1,19,1,20
2019-12-09 02:47:12,19.68170138888889,4,276,134,410
2019-12-28 19:15:22,38.214120370370374,1,10,1,11
2019-11-29 16:44:41,9.697592592592592,2,5,3,8
2019-11-20 17:09:08,0.8525810185185185,1,18,3,21
2019-11-21 03:33:23,2.2217708333333333,1,3,3,6
2019-11-26 22:04:01,8.107349537037036,10,263,142,405
2019-11-18 01:08:17,0.13094907407407408,4,1285,1289,2574
2019-11-17 19:10:02,0.023206018518518518,1,12,12,24
2019-11-17 05:09:21,0.17753472222222222,1,108,3,111
2019-11-18 20:24:37,1.8598379629629629,3,32,3,35
2019-11-16 23:43:42,0.2839814814814815,1,7,7,14
2019-11-18 05:06:30,1.2774768518518518,2,23,2,25
2020-06-16 22:28:50,213.05618055555556,22,4527,1683,6210
2019-11-17 02:38:12,64.53079861111111,5,82,82,164
2019-11-16 21:14:41,0.33652777777777776,1,27,2,29
2019-11-16 20:43:36,0.42266203703703703,1,20,32,52
2019-12-28 19:01:53,43.14699074074074,1,4,2,6
2019-11-17 05:02:02,2.0375925925925924,1,896,10,906
2019-11-13 21:22:27,0.20082175925925927,1,1,0,1
2019-11-17 02:30:56,4.651099537037037,8,77,74,151
2019-11-12 14:44:35,0.39892361111111113,1,11,3,14
2019-11-12 04:56:42,0.008078703703703704,1,1,1,2
2019-11-11 18:26:28,0.32354166666666667,1,5,5,10
2019-11-11 23:30:07,0.5733101851851852,1,5,6,11
2019-11-11 04:24:25,0.2560300925925926,1,395,134,529
2019-11-10 18:54:00,0.002939814814814815,1,1,1,2
2019-12-30 19:37:18,53.6665625,2,224,99,323
2019-11-12 14:52:36,2.0673958333333333,2,12,6,18
2019-11-10 09:49:51,0.2811342592592593,1,3,1,4
2019-11-09 23:50:59,0.03085648148148148,1,71,0,71
2019-11-10 14:05:04,0.6551736111111112,1,18,7,25
2019-11-10 14:07:41,0.6661111111111111,1,55,4,59
2019-11-11 04:37:06,1.3798148148148148,1,81,20,101
2019-11-11 16:29:48,1.9951736111111111,2,161,114,275
2019-11-14 20:10:49,5.6496875,32,282,217,499
2020-05-25 05:20:16,199.8212384259259,1,3,1,4
2019-11-05 16:57:30,0.08517361111111112,1,3,0,3
2019-11-08 14:31:17,3.061238425925926,17,63,63,126
2019-11-08 03:39:55,2.945821759259259,1,34,9,43
2019-11-12 15:39:40,9.7696875,17,438,341,779
2019-11-04 20:04:57,0.9874074074074074,1,28,9,37
2019-11-15 15:49:54,11.919872685185185,3,33,2,35
2019-11-09 21:26:53,15.200659722222222,5,117,47,164
2019-11-10 17:36:32,8.066608796296297,5,485,320,805
2019-11-05 00:04:05,5.976435185185185,16,354,160,514
2019-11-01 10:23:19,1.8046064814814815,2,42,84,126
2019-11-05 18:19:25,6.168969907407408,2,6,5,11
2019-11-10 05:12:26,10.739328703703704,1,8,137,145
2019-11-08 12:40:50,9.135208333333333,1,3,8,11
2019-11-06 18:43:06,7.7905092592592595,9,90,46,136
2019-10-30 14:10:42,0.7094328703703704,1,117,122,239
2019-11-09 20:12:00,13.866840277777778,3,62,35,97
2019-11-01 15:04:02,5.837372685185185,10,256,246,502
2019-11-10 15:53:25,15.225694444444445,3,15,5,20
2019-10-28 01:00:28,1.9962037037037037,1,3,3,6
2019-10-31 13:41:33,5.698333333333333,1,2,2,4
2019-10-24 14:38:37,0.04583333333333333,1,18,4,22
2019-10-28 09:40:29,4.270717592592592,1,3,3,6
2019-10-22 15:51:56,0.6322222222222222,2,29,10,39
2019-10-24 14:29:42,3.0766550925925924,6,145,59,204
2019-10-21 09:59:21,0.48734953703703704,1,11,1,12
2019-10-26 05:09:42,5.302881944444445,8,121,96,217
2019-10-20 22:47:24,0.09984953703703704,1,39,36,75
2019-10-22 14:44:46,1.8285416666666667,1,12,0,12
2019-10-21 11:32:45,0.8831712962962963,1,2,2,4
2019-10-21 05:05:17,1.2060763888888888,2,4,2,6
2019-10-20 10:52:49,0.6771296296296296,1,37,7,44
2019-10-21 11:34:22,2.5118287037037037,2,24,2,26
2019-10-18 15:11:59,0.08399305555555556,1,5,5,10
2020-01-19 22:24:02,93.7322337962963,2,130,13,143
2019-10-23 12:47:30,5.720474537037037,8,68,50,118
2019-10-17 18:50:10,2.3886805555555557,1,4,2,6
2019-10-18 08:14:10,1.0664467592592592,6,25,10,35
2019-10-21 09:56:09,2.949351851851852,1,30,24,54
2019-10-16 12:05:07,0.03788194444444445,1,1,1,2
2019-10-20 10:54:00,4.780543981481482,6,49,33,82
2019-10-18 08:10:57,2.92837962962963,3,47,4,51
2019-10-14 22:11:33,1.7819328703703703,3,24,2,26
2019-10-15 16:52:35,3.28005787037037,2,16,11,27
2019-11-10 05:04:53,28.77875,16,474,94,568
2019-10-11 19:03:43,0.05689814814814815,1,1,1,2
2019-10-11 17:49:31,0.028622685185185185,1,2,1,3
2019-10-13 09:27:00,3.1277314814814816,1,8,3,11
2019-10-10 19:21:37,3.2291319444444446,3,41,27,68
2019-10-08 12:56:00,1.7386689814814815,1,12,1,13
2019-11-16 20:23:14,42.35292824074074,12,449,184,633
2019-10-15 20:02:53,10.691226851851852,1,2,10,12
2019-11-12 04:55:30,39.31170138888889,6,65,45,110
2019-10-03 05:58:22,0.045856481481481484,1,1,1,2
2019-10-06 09:52:39,4.941377314814815,3,50,30,80
2019-09-30 15:29:25,0.5622337962962963,6,29,11,40
2019-10-20 10:46:52,20.57087962962963,4,167,56,223
2019-10-06 09:45:19,6.566516203703704,1,2,1,3
2019-10-20 10:59:51,20.843078703703704,2,34,19,53
2019-09-27 06:58:33,0.07149305555555556,1,1,1,2
2019-11-09 14:49:57,43.892800925925926,18,147,14,161
2019-11-14 15:46:47,57.97443287037037,9,43,21,64
2019-10-22 17:31:54,27.749039351851852,2,735,77,812
2019-09-26 00:02:27,1.3663425925925925,1,4,0,4
2019-10-20 20:22:46,0.5328935185185185,1,80,0,80
2019-10-06 10:05:31,12.638645833333333,2,118,67,185
2019-10-21 11:29:38,11.95837962962963,11,466,354,820
2019-10-12 15:22:19,3.0849305555555557,1,125,62,187
2019-10-28 09:37:14,35.61144675925926,1,50,6,56
2019-09-22 11:09:17,0.08094907407407408,1,0,1,1
2019-09-22 23:59:42,0.6857060185185185,1,73,0,73
2019-09-24 02:20:50,2.157696759259259,2,6,6,12
2019-10-03 19:11:01,12.720381944444444,2,148,17,165
2019-11-12 04:59:39,52.511435185185185,1,8,8,16
2019-09-21 01:02:39,0.5552777777777778,1,0,10,10
2019-09-21 11:49:37,762.4647685185186,8,26,17,43
2021-01-30 15:25:15,499.15407407407406,86,16504,9075,25579
2019-09-29 21:32:37,10.634664351851852,3,56,22,78
2019-09-23 13:06:02,1.6552893518518519,1,202,2,204
2019-09-18 15:51:19,1.027974537037037,1,18,6,24
2019-11-10 18:59:48,55.85526620370371,28,4975,2221,7196
2019-10-06 10:07:48,21.21494212962963,1,0,2,2
2019-10-06 10:10:54,22.274583333333332,1,111,81,192
2020-05-09 18:49:01,239.2254861111111,5,143,74,217
2019-10-19 21:27:16,36.314872685185186,6,1047,973,2020
2019-09-12 22:40:07,0.11990740740740741,1,7,2,9
2019-09-14 23:31:27,2.8086689814814814,2,53,14,67
2019-09-14 21:06:19,2.743634259259259,1,75,20,95
2019-10-28 17:51:57,46.64505787037037,52,208,161,369
2019-09-14 16:39:47,2.8231712962962963,1,2,12,14
2019-09-11 19:43:24,0.07379629629629629,1,1,3,4
2019-09-18 16:00:19,7.043043981481482,3,132,15,147
2019-09-12 18:45:27,1.9846180555555555,6,72,41,113
2019-09-11 03:42:38,0.13523148148148148,1,1,1,2
2019-09-10 21:15:19,0.36194444444444446,1,1,2,3
2019-09-13 00:55:23,2.607349537037037,14,240,244,484
2019-09-10 16:47:15,0.5403125,2,70,10,80
2019-09-09 14:15:01,0.33611111111111114,1,1,0,1
2019-11-25 18:48:30,77.8550462962963,8,112,34,146
2020-05-25 20:45:43,260.0751041666667,7,872,460,1332
2019-09-08 21:05:54,0.9785995370370371,2,82,7,89
2019-09-09 10:41:33,0.8655439814814815,1,0,8,8
2019-09-08 10:27:49,0.42622685185185183,1,40,3,43
2019-09-08 09:58:35,0.4242708333333333,3,149,22,171
2019-09-07 21:46:44,1.0003935185185184,2,26,28,54
2019-10-20 11:03:09,43.85050925925926,3,40,7,47
2019-12-03 07:08:06,87.75186342592593,5,19442,8200,27642
2019-09-06 16:05:12,0.6017824074074074,2,24,5,29
2019-10-18 21:03:12,0.4515046296296296,1,103,18,121
2019-09-05 17:28:46,0.04791666666666667,2,8,1,9
2019-10-20 12:06:22,45.76844907407408,1,21,4,25
2019-09-04 23:51:30,1.0820949074074073,1,1,1,2
2019-10-20 11:09:11,46.58322916666667,3,20,17,37
2020-01-13 13:12:48,231.7995486111111,10,247,95,342
2020-04-23 02:55:37,162.70988425925927,5,226,53,279
2019-10-20 12:05:21,48.924988425925925,7,143,21,164
2019-09-01 18:07:29,0.14296296296296296,1,47,0,47
2019-08-31 10:48:57,26.661099537037035,1,160,268,428
2019-09-01 19:20:20,1.9736574074074074,1,28,1,29
2019-09-07 10:26:12,7.845300925925926,2,3,3,6
2019-08-29 22:49:50,0.1598263888888889,1,1,1,2
2019-08-30 15:19:50,0.9790509259259259,2,18,18,36
2019-09-07 20:35:37,9.593969907407407,6,262,46,308
2019-08-31 10:51:43,2.251585648148148,1,99,54,153
2019-09-17 18:48:28,15.945717592592592,3,248,74,322
2019-10-20 11:54:36,52.72318287037037,3,35,8,43
2019-08-28 22:51:34,1.6946296296296297,3,14,13,27
2019-08-27 17:16:40,0.8632060185185185,1,17,16,33
2019-08-27 17:15:18,0.8884375,1,1,1,2
2019-08-28 23:01:23,2.7842592592592594,1,16,18,34
2019-08-27 17:10:32,1.9836111111111112,8,1506,1282,2788
2019-08-26 20:23:04,1.185474537037037,2,12,1,13
2019-08-25 23:26:16,1.108298611111111,1,6,5,11
2019-08-25 17:14:42,914.4239351851852,11,159599,104720,264319
2019-08-24 18:24:24,0.2936574074074074,2,14,26,40
2019-08-25 11:56:41,1.4929513888888888,1,29,27,56
2019-08-23 23:20:11,0.056469907407407406,1,1,0,1
2019-08-24 12:50:54,0.685162037037037,8,49,9,58
2019-10-20 11:52:03,57.94524305555556,18,1261,1070,2331
2019-09-11 03:34:39,18.96673611111111,4,35424,22621,58045
2019-08-23 03:30:08,0.037627314814814815,1,26,1,27
2019-08-22 19:10:57,0.03880787037037037,1,1,0,1
2019-08-22 12:35:03,0.3150925925925926,1,10,0,10
2019-08-22 12:31:13,0.34600694444444446,1,2,1,3
2019-08-22 19:13:19,0.9302430555555555,1,10,11,21
2019-08-22 22:11:48,1.2988078703703703,3,11,3,14
2019-08-22 01:06:17,0.7965972222222222,1,0,2,2
2019-08-27 16:57:33,6.486666666666666,2,60,9,69
2019-08-22 19:29:50,2.744826388888889,1,39,1,40
2019-08-30 08:55:27,10.349699074074074,5,99,11,110
2019-11-11 17:48:40,0.29894675925925923,1,107,49,156
2019-08-22 19:33:40,3.6482638888888888,2,204,33,237
2019-08-22 19:23:22,3.741574074074074,1,29,4,33
2019-08-18 21:36:12,0.05505787037037037,1,1,0,1
2019-09-02 21:42:18,15.873738425925925,8,2738,1796,4534
2019-08-18 15:41:34,0.08238425925925925,2,6,6,12
2019-08-18 15:39:38,0.5755555555555556,1,1,1,2
2019-08-20 05:46:55,2.4120138888888887,2,83,19,102
2019-08-18 01:41:15,0.1691550925925926,1,1,1,2
2019-08-20 05:47:13,15.370949074074074,2,60,5,65
2019-08-16 21:47:20,0.09908564814814814,1,6,0,6
2019-08-16 16:23:00,0.47484953703703703,1,8,4,12
2020-01-11 12:11:28,148.5097800925926,14,22221,9782,32003
2019-09-11 08:07:30,26.795347222222222,1,76,5,81
2019-08-18 15:48:29,2.9098611111111112,1,24,4,28
2019-08-22 19:35:58,7.209583333333334,1,6,3,9
2019-08-24 01:19:18,9.046585648148149,7,457,768,1225
2019-08-15 14:44:59,0.2260300925925926,1,1,1,2
2019-08-16 07:37:15,1.115150462962963,2,87,13,100
2019-10-26 20:11:47,72.68912037037038,2,24,11,35
2019-08-23 12:42:26,8.723912037037037,4,72,124,196
2019-08-14 13:35:19,0.029861111111111113,1,1,1,2
2019-09-02 03:42:13,18.987256944444443,2,39,5,44
2019-08-13 18:03:14,0.049560185185185186,1,1,1,2
2019-11-05 18:25:35,88.90841435185185,11,315,157,472
2019-08-13 14:13:27,0.6144212962962963,1,2,2,4
2019-08-12 18:21:16,0.03995370370370371,1,1,1,2
2019-08-16 03:08:29,3.5627662037037036,2,41,22,63
2019-10-20 11:56:46,69.20033564814815,4,22,11,33
2019-11-13 00:00:47,93.10828703703703,20,502,255,757
2019-12-03 08:54:38,313.26984953703703,5,26680,13003,39683
2019-08-17 08:26:42,5.8754282407407405,1,21,19,40
2019-08-18 15:38:53,7.626111111111111,6,214,68,282
2019-08-13 07:02:55,8.383819444444445,6,223,16,239
2019-08-10 19:24:19,0.31653935185185184,1,13,0,13
2019-08-11 02:57:20,0.6373611111111112,2,11,1,12
2019-08-10 08:22:29,0.03851851851851852,1,1,1,2
2019-08-10 23:28:33,0.7161342592592592,1,1,1,2
2019-08-10 11:31:43,0.3143287037037037,1,29,6,35
2019-08-09 20:30:21,0.09266203703703704,1,10,1,11
2019-08-09 15:33:46,0.04445601851851852,1,2,2,4
2019-08-09 08:06:49,0.1612037037037037,1,72,0,72
2019-08-20 03:50:17,11.094502314814815,12,5291,7440,12731
2019-08-10 07:49:06,1.480625,3,9,7,16
2019-09-12 07:12:29,6.358564814814815,1,333,0,333
2019-11-10 15:47:28,93.82519675925926,2,21,23,44
2019-08-08 19:19:46,0.09350694444444445,1,6,185,191
2019-09-05 14:33:52,28.063368055555557,15,1491,931,2422
2019-08-14 23:26:34,7.47150462962963,5,74,21,95
2019-08-07 22:33:29,0.04030092592592593,1,2,2,4
2019-08-07 21:06:49,375.09770833333334,3,46,18,64
2019-08-08 14:30:41,1.3863425925925925,2,166,166,332
2019-08-06 04:51:43,0.09447916666666667,1,0,3854,3854
2019-12-14 10:24:44,130.4976736111111,29,14632,7096,21728
2019-08-05 22:09:39,0.0012731481481481483,1,0,18,18
2019-08-06 14:37:23,0.7482291666666666,1,20,0,20
2019-08-06 20:16:40,1.029224537037037,1,61,1,62
2019-08-05 18:12:55,0.30321759259259257,3,48,35,83
2019-08-09 21:08:10,4.557685185185186,4,35,12,47
2019-08-04 17:16:27,0.17556712962962964,1,3,3,6
2019-08-05 16:24:40,1.2934722222222221,4,54,36,90
2019-08-16 15:39:45,12.679166666666667,2,54,7,61
2019-08-04 17:48:35,0.9747222222222223,2,88,41,129
2019-08-04 09:59:45,4.712476851851852,3,855,984,1839
2019-08-04 10:46:28,1.087800925925926,1,0,2,2
2019-08-08 18:58:33,3.7656134259259257,1,52,0,52
2019-08-01 23:00:52,0.2051273148148148,1,22,15,37
2019-08-04 03:46:17,2.511701388888889,3,58,29,87
2019-08-03 08:17:28,1.7299074074074074,1,5,4,9
2019-08-02 14:21:56,1.0144212962962964,7,366,524,890
2019-08-01 16:33:18,0.49592592592592594,1,8,4,12
2019-07-31 23:35:52,0.128125,2,19,10,29
2019-11-11 02:18:39,102.49491898148148,18,628,64,692
2019-07-31 20:08:20,0.10844907407407407,2,52,1,53
2019-08-03 08:03:52,2.6464814814814814,1,2,1,3
2019-08-04 10:20:35,3.7994444444444446,1,15,3,18
2019-07-31 16:20:20,0.8027893518518519,1,24,67,91
2019-07-31 18:22:28,0.93125,4,22,3,25
2019-08-04 16:55:49,5.060138888888889,3,19,4,23
2019-08-04 10:21:39,5.177534722222222,1,84,109,193
2019-10-28 15:08:16,90.83431712962962,11,402,105,507
2019-08-08 16:23:22,10.017106481481482,3,12,4,16
2019-07-31 16:57:31,2.1975462962962964,1,2,0,2
2019-08-03 23:58:34,6.117951388888889,1,2,2,4
2019-08-07 13:11:10,9.788622685185185,14,234,128,362
2019-07-30 03:22:48,1.3797222222222223,2,5,33,38
2019-07-28 16:01:02,0.08636574074074074,1,2,2,4
2019-07-28 20:14:18,0.34091435185185187,4,30,30,60
2019-08-03 08:19:09,5.993217592592592,1,0,4,4
2019-08-10 10:55:03,20.161273148148148,21,8283,29295,37578
2019-08-02 09:40:38,5.433587962962963,4,9,2,11
2019-08-02 05:30:12,6.3147569444444445,5,102,51,153
2019-08-01 23:41:08,5.354467592592592,4,290,144,434
2019-07-28 12:24:33,0.7140393518518519,1,17,0,17
2019-07-26 18:24:48,0.008287037037037037,1,2,0,2
2019-07-26 19:43:46,0.14118055555555556,1,40,40,80
2019-07-26 17:21:01,0.15653935185185186,1,1,1,2
2019-07-26 08:40:31,0.07439814814814814,2,6,3,9
2019-11-16 20:38:12,127.1590162037037,117,57046,43250,100296
2019-07-27 17:36:36,1.8993287037037037,2,16315,5498,21813
2019-07-30 21:11:11,5.1996875,3,26855,14519,41374
2019-08-01 19:34:13,8.4578125,7,117,228,345
2019-08-01 14:47:37,7.774490740740741,2,26,9,35
2019-07-26 03:54:10,1.0606944444444444,2,95,42,137
2019-07-26 17:16:51,2.8621180555555554,2,14,1,15
2019-07-26 17:16:13,2.8741319444444446,1,1,1,2
2019-07-29 20:15:14,6.458136574074074,8,940,8880,9820
2019-08-03 08:23:47,10.53224537037037,1,1,1,2
2019-07-29 23:58:18,6.5051041666666665,1,46,13,59
2019-07-28 20:42:18,2141.189548611111,5,90,47,137
2019-08-04 10:48:42,13.500289351851851,2,2,2,4
2019-09-01 12:45:50,43.351018518518515,25,8629,16926,25555
2019-08-19 19:21:12,0.6783564814814815,1,95,172,267
2019-07-22 17:34:05,3.104201388888889,5,1649,105,1754
2019-07-19 17:09:34,0.13144675925925925,1,22,8,30
2019-07-19 17:49:26,0.8178819444444444,1,49,43,92
2019-07-18 17:15:02,0.14877314814814815,1,30,30,60
2019-07-18 13:04:07,0.028310185185185185,1,1,1,2
2019-11-16 21:53:15,121.79199074074074,3,93,4,97
2019-08-04 11:30:05,17.79494212962963,1,93,33,126
2019-07-19 15:38:29,1.5365046296296296,1,10,15,25
2019-07-18 10:15:52,1.198425925925926,2,6,4,10
2019-07-21 16:30:25,4.467361111111111,3,48,27,75
2019-07-16 17:39:47,0.005115740740740741,1,2,0,2
2019-07-17 12:03:50,0.9187847222222222,8,815,84,899
2019-07-19 03:26:33,3.1913310185185186,4,175,170,345
2019-07-17 03:55:08,1.3885300925925925,3,4,4,8
2019-07-15 16:47:00,0.2175925925925926,1,2,1,3
2019-07-15 08:19:23,0.17636574074074074,1,2,2,4
2019-11-11 16:01:04,119.6998263888889,11,132,120,252
2019-07-18 13:15:55,4.015752314814815,3,27,6,33
2019-07-18 08:00:38,3.9418171296296296,3,49,41,90
2019-07-18 18:07:21,0.03644675925925926,1,57,9,66
2019-07-14 15:13:12,0.6503587962962963,1,33,2,35
2019-07-13 22:14:28,0.04240740740740741,1,5,1,6
2019-07-15 08:19:51,1.511099537037037,2,70,6,76
2019-07-15 09:58:04,2.7747916666666668,3,28,14,42
2019-07-12 15:29:16,0.04621527777777778,1,1,1,2
2019-07-16 11:43:32,4.4202662037037035,3,5,1,6
2019-07-14 20:01:39,3.6651967592592594,1,65,54,119
2019-08-22 19:28:03,43.22244212962963,5,23252,22272,45524
2019-11-12 22:33:50,125.65461805555556,11,47275,15291,62566
2019-07-14 20:02:59,4.561365740740741,2,29,14,43
2019-07-14 21:22:58,5.182789351851852,2,2,6,8
2019-07-09 16:36:14,0.0525462962962963,1,6,3,9
2019-07-08 21:47:41,0.10033564814814815,3,16,10,26
2019-07-09 16:55:44,4.011990740740741,4,481,18,499
2019-07-09 18:33:22,1.002650462962963,5,40,16,56
2019-07-08 18:48:52,0.15224537037037036,4,68,60,128
2019-07-08 08:57:42,0.19402777777777777,1,56,61,117
2019-07-07 16:35:06,0.037280092592592594,2,2,2,4
2019-07-08 14:38:33,0.9655787037037037,5,7550,2983,10533
2019-07-07 15:07:03,0.00400462962962963,1,1,1,2
2019-07-14 21:24:27,7.2822453703703705,4,47,15,62
2019-07-07 13:57:44,0.07949074074074074,2,2,2,4
2019-07-07 12:40:21,0.027430555555555555,1,2,1,3
2019-07-07 15:34:09,0.17431712962962964,1,4,3,7
2019-07-08 09:16:18,2.9163310185185187,3,14,2,16
2019-07-05 12:32:19,0.24269675925925926,1,9,2,11
2019-07-05 05:49:30,0.0673263888888889,1,1,12,13
2019-07-08 13:13:54,4.760104166666666,2,1137,1317,2454
2019-07-16 21:53:05,12.455578703703704,4,62,21,83
2019-07-02 16:17:41,0.21268518518518517,1,14,1,15
2019-07-17 03:40:48,36.41597222222222,30,3472,742,4214
2019-07-01 07:59:49,0.2985069444444444,1,241,18,259
2020-03-20 22:21:20,296.9555324074074,14,938,303,1241
2019-06-30 17:04:33,0.12386574074074073,1,22,7,29
2019-07-01 21:07:24,1.5018981481481481,1,12,0,12
2019-06-30 14:40:43,0.44224537037037037,3,18,17,35
2019-06-28 18:37:28,0.027511574074074074,1,3,3,6
2019-07-02 11:23:54,3.768587962962963,4,21,16,37
2019-07-22 16:22:55,26.07326388888889,1,112,136,248
2019-06-26 15:07:02,0.08020833333333334,1,4,23,27
2019-06-25 19:32:50,0.021342592592592594,1,1,1,2
2019-07-02 11:25:42,7.181087962962963,4,17,3,20
2019-07-08 21:24:26,61.725960648148146,1,16,5,21
2019-06-25 17:22:13,0.7872916666666666,1,19,15,34
2019-06-24 18:26:50,0.055405092592592596,1,11,5,16
2019-07-02 00:25:19,10.375590277777778,10,357,75,432
2019-06-25 19:47:40,2.047384259259259,2,4,4,8
2019-07-08 21:28:32,16.452719907407406,2,111,10,121
2019-06-22 11:53:52,808.175625,3,13,14,27
2019-06-21 08:30:14,0.07130787037037037,1,250,250,500
2019-07-08 09:21:20,17.65890046296296,4,46,16,62
2019-06-20 12:06:38,0.2566435185185185,1,7,317,324
2019-07-02 05:01:05,514.5369444444444,1,30,5,35
2019-06-19 06:15:32,0.04167824074074074,2,16,16,32
2019-06-18 22:28:59,0.02738425925925926,1,2,2,4
2019-06-18 06:58:34,0.07472222222222222,1,1,1,2
2019-06-18 16:54:53,0.947962962962963,1,1,1,2
2019-06-29 15:41:34,40.01429398148148,9,853,479,1332
2019-06-20 18:31:17,4.039710648148148,3,24,4,28
2019-06-15 19:37:34,0.041840277777777775,1,1,1,2
2019-06-18 17:07:06,3.0034722222222223,1,13,1,14
2019-06-30 21:17:37,15.495069444444445,5,34,13,47
2019-07-08 09:28:26,23.463148148148147,3,20,5,25
2019-06-14 20:22:33,0.08215277777777778,2,2,1,3
2019-06-13 20:41:03,0.8007638888888889,3,4,2,6
2019-07-02 11:59:16,19.526180555555555,4,41,4,45
2019-07-18 05:04:35,37.5321412037037,21,15737,2443,18180
2019-07-31 16:41:54,49.21075231481481,2,101,99,200
2019-06-10 16:03:55,0.04583333333333333,1,3,6,9
2019-10-26 20:59:11,138.28456018518517,7,167,53,220
2019-07-02 03:40:11,34.54695601851852,40,3211,1072,4283
2019-06-30 17:36:20,20.817939814814814,5,45,15,60
2019-06-09 22:50:41,0.6295601851851852,2,3,3,6
2019-06-15 07:36:49,6.451608796296297,1,4,1,5
2019-06-12 02:35:53,3.9935185185185187,1,4,4,8
2019-06-07 17:34:29,0.03796296296296296,1,41,0,41
2019-06-07 16:03:53,0.03922453703703704,1,5,6,11
2019-06-12 13:58:06,0.6050925925925926,1,20,6,26
2019-06-06 20:27:27,0.0349537037037037,1,3,1,4
2019-06-10 19:56:34,4.904953703703704,1,1,1,2
2019-06-10 19:52:51,4.908900462962963,1,1,1,2
2019-07-02 12:19:50,28.39758101851852,1,9,9,18
2019-06-02 16:46:55,0.03315972222222222,1,2,0,2
2019-06-02 16:53:57,0.08013888888888888,1,6,17,23
2019-06-02 11:44:47,0.09670138888888889,1,24,24,48
2019-06-02 06:26:33,0.016898148148148148,1,1,1,2
2019-05-31 20:42:22,2.4339583333333334,1,193,5,198
2019-06-24 15:31:31,27.18023148148148,44,12666,5905,18571
2019-05-31 13:52:56,1.7170370370370371,1,192,164,356
2019-07-08 09:23:19,40.21803240740741,1,13,4,17
2019-07-08 21:42:57,41.94524305555556,2,38,1,39
2019-05-25 16:22:25,0.07909722222222222,2,9,2,11
2019-05-23 20:43:01,0.29246527777777775,2,13,1,14
2019-06-17 19:48:03,25.580949074074073,4,42,21,63
2019-05-22 22:27:46,0.20215277777777776,1,11,11,22
2019-06-10 23:12:54,19.25920138888889,1,3,1,4
2019-05-22 19:39:38,0.23193287037037036,1,4,2,6
2019-06-15 07:44:14,23.863425925925927,1,74,64,138
2019-05-25 07:29:17,4.5632523148148145,1,7,6,13
2019-06-18 23:49:21,29.592569444444443,1,17,14,31
2019-05-19 07:41:05,0.07020833333333333,1,17,0,17
2019-05-18 23:53:23,0.5345486111111111,1,2,4,6
2019-05-18 09:28:06,0.41324074074074074,1,11,2,13
2019-05-16 06:58:16,0.5758101851851852,1,6,14,20
2019-05-15 13:12:23,0.0965162037037037,1,1,1,2
2019-05-14 21:39:48,1.0693171296296295,1,9,3,12
2019-05-16 07:00:24,2.7530555555555556,1,1,1,2
2019-08-15 05:51:30,96.87793981481481,20,668,231,899
2019-05-15 10:50:00,3.0465393518518518,1,23,2,25
2021-03-21 18:24:49,681.3110069444444,2,488,8,496
2019-05-19 21:01:26,7.836863425925926,3,18,2,20
2019-05-11 12:09:59,0.042743055555555555,1,3,1,4
2019-05-11 12:34:49,0.5234606481481482,2,3,3,6
2019-05-19 07:05:15,8.590034722222223,1,19,2,21
2019-07-08 21:33:53,60.052199074074075,1,84,17,101
2019-05-19 07:26:41,11.580671296296297,2,42,10,52
2019-05-08 14:49:18,0.007141203703703703,1,1,1,2
2019-05-19 07:34:51,10.721238425925925,2,33,9,42
2019-05-08 14:51:03,0.00974537037037037,1,1,1,2
2019-05-08 14:51:49,0.01136574074074074,1,1,1,2
2019-05-08 14:52:19,0.013657407407407408,1,1,1,2
2019-05-08 14:53:02,0.015532407407407408,1,1,1,2
2019-06-05 05:11:44,28.830011574074074,4,90,68,158
2019-05-19 08:22:36,12.200208333333334,2,4,3,7
2019-07-03 13:48:15,58.01581018518519,4,11,6,17
2019-05-06 08:51:24,0.24709490740740742,2,143,49,192
2019-05-06 19:08:15,0.9506134259259259,1,13,0,13
2019-05-08 16:54:03,3.885625,6,45,16,61
2019-05-08 08:25:05,3.8457175925925924,3,37,25,62
2019-05-04 07:58:17,0.2040625,1,8,0,8
2019-05-04 07:59:50,0.25275462962962963,1,6,6,12
2019-05-06 00:59:47,2.469212962962963,1,2,2,4
2019-05-19 07:38:55,44.7053125,1,1,1,2
2019-05-19 07:42:10,17.57753472222222,1,4,1,5
2019-10-13 23:04:00,165.35246527777778,2,44,20,64
2019-05-08 17:51:10,7.3461689814814815,1,1,1,2
2019-04-30 21:52:57,0.06450231481481482,1,13,0,13
2019-05-04 15:33:38,4.095509259259259,2,10,3,13
2019-05-01 12:22:45,1.362673611111111,1,14,4,18
2019-04-30 08:38:47,0.30626157407407406,1,1,1,2
2019-05-19 07:57:34,20.06013888888889,2,4,3,7
2019-05-10 09:11:12,11.261354166666667,1,2,1,3
2019-05-19 07:48:05,20.924733796296298,1,6,6,12
2019-11-11 15:45:51,197.5416550925926,7,40195,28821,69016
2019-04-26 17:41:16,0.033854166666666664,1,99,3,102
2019-04-27 01:52:19,0.8021643518518519,1,12,0,12
2019-05-03 17:32:43,7.6326736111111115,2,178,43,221
2019-04-26 16:35:51,0.8901967592592592,1,572,16,588
2019-04-25 10:56:17,3.2162152777777777,5,289,270,559
2019-04-25 09:46:50,0.0008564814814814815,1,105,124,229
2019-04-24 21:47:48,44.61429398148148,2,83,14,97
2019-04-24 13:44:42,0.6213541666666667,1,1,1,2
2019-04-25 22:48:22,2.3014699074074074,4,47,14,61
2019-04-22 19:06:58,0.22569444444444445,1,0,74,74
2019-04-25 04:01:55,2.9284606481481483,5,289,270,559
2019-04-22 08:48:34,0.41366898148148146,1,1,1,2
2019-04-22 06:15:42,0.4555787037037037,1,7,4,11
2019-04-21 07:02:35,0.3944675925925926,2,2,2,4
2019-04-21 12:50:10,0.9968402777777777,1,55,0,55
2019-04-21 12:41:15,1.6444907407407408,2,293,183,476
2019-04-19 06:45:04,1.9297337962962964,1,80,5,85
2019-05-11 12:40:20,24.40837962962963,2,375428,303777,679205
2019-04-25 13:15:37,9.254571759259258,7,75,40,115
2019-04-16 17:40:40,0.7942476851851852,1,22,5,27
2019-04-16 08:57:58,0.589224537037037,1,4,3,7
2019-04-16 16:57:47,2.010474537037037,3,4,10,14
2019-04-15 14:32:44,1.9321180555555555,1,7,1,8
2019-04-13 13:16:24,0.9626967592592592,1,1,1,2
2019-04-14 09:00:18,1.395949074074074,2,26,4,30
2019-04-27 17:20:13,14.739467592592593,13,89,46,135
2019-04-13 19:19:23,1.1633796296296297,2,20,7,27
2019-04-12 11:00:59,0.10560185185185185,2,78,174,252
2019-04-20 00:20:18,7.719942129629629,4,41,17,58
2019-04-12 11:01:50,0.41461805555555553,1,5,0,5
2019-04-11 13:15:16,0.06777777777777778,2,3,3,6
2019-04-10 20:22:13,0.08440972222222222,1,5,2,7
2019-04-10 17:04:02,0.3193402777777778,1,94,86,180
2019-04-10 06:23:48,0.1790972222222222,1,1,1,2
2019-04-12 21:39:03,3.0977083333333333,1,45,9,54
2019-04-08 18:36:21,5.377604166666667,11,160,128,288
2019-04-09 09:26:19,1.1436226851851852,2,22,32,54
2019-04-20 12:53:05,12.234861111111112,20,286,251,537
2019-04-12 21:41:24,4.901284722222222,1,9,4,13
2019-04-08 08:14:42,0.5793055555555555,1,4,1,5
2019-04-07 15:40:44,0.01462962962962963,1,1,1,2
2019-04-19 17:12:33,14.760891203703704,13,218,117,335
2019-04-06 08:23:24,0.4083449074074074,1,4,0,4
2019-04-05 07:30:50,0.5442592592592592,1,8,9,17
2019-04-07 09:45:29,2.543946759259259,1,3,0,3
2019-04-04 11:12:26,0.009155092592592593,1,1,1,2
2019-04-21 20:12:13,19.006493055555556,3,66,12,78
2019-04-15 14:26:59,1.9636111111111112,3,13,6,19
2019-04-14 16:46:44,13.337395833333334,1,1,1,2
2019-05-19 22:15:05,48.85476851851852,20,1058,157,1215
2019-04-03 14:06:11,2.767650462962963,1,4,4,8
2019-08-04 13:51:04,126.09900462962963,2,6,11,17
2019-04-03 20:02:35,4.100289351851852,2,30,5,35
2019-03-31 16:05:16,1.1311805555555556,1,1,1,2
2019-04-05 18:55:03,7.158530092592593,1,43,30,73
2019-03-29 15:37:16,0.04341435185185185,1,2,2,4
2019-03-30 04:59:28,0.8786921296296296,2,14,4,18
2019-04-18 22:52:40,20.940243055555555,7,151,96,247
2019-03-28 22:02:33,0.037662037037037036,1,2,2,4
2019-03-26 18:20:37,0.16145833333333334,2,10,3,13
2019-03-26 16:03:13,0.21940972222222221,1,9,8,17
2019-03-22 19:02:54,1.3706597222222223,1,11,7,18
2019-03-24 04:24:03,3.1033564814814816,1,4,3,7
2019-03-26 13:33:59,6.765509259259259,2,22,2,24
2019-03-28 20:32:50,10.776493055555555,2,738,298,1036
2019-03-19 02:58:05,1.1735300925925927,2,31,5,36
2019-03-17 00:13:38,0.36505787037037035,1,6,0,6
2019-03-27 10:31:58,12.286678240740741,3,36,24,60
2019-03-13 18:33:14,0.8561689814814815,1,0,20,20
2019-03-26 13:51:08,17.757175925925925,1,35,2,37
2019-03-11 20:25:07,0.1079050925925926,3,137,166,303
2019-03-11 18:45:20,0.0528125,2,31,15,46
2019-03-12 21:39:00,1.2213425925925927,1,6,5,11
2019-03-12 22:47:23,2.137210648148148,3,58,7,65
2019-03-11 14:06:07,2.3222222222222224,6,37,14,51
2019-03-11 00:09:46,2.4196643518518517,1,14,2,16
2019-03-08 19:45:51,0.4367361111111111,2,2,2,4
2019-04-18 07:36:32,41.5378125,6,1382,1937,3319
2019-03-07 23:28:24,0.17991898148148147,1,1,1,2
2019-03-07 17:31:27,0.10545138888888889,1,2,2,4
2019-03-07 17:04:50,0.09072916666666667,1,5,5,10
2019-03-09 06:59:54,3.514710648148148,5,11,14,25
2019-04-23 11:34:43,49.34104166666667,9,402,148,550
2019-03-05 01:06:57,0.4446527777777778,3,23,12,35
2019-03-03 16:04:28,0.6120949074074075,2,2,2,4
2019-03-28 14:44:30,25.615659722222222,2,43,22,65
2019-03-13 00:52:43,10.082766203703704,11,97,40,137
2019-03-01 17:11:00,0.23460648148148147,2,62,63,125
2019-03-07 19:30:46,7.508761574074074,13,628,236,864
2019-02-28 00:03:38,0.039837962962962964,1,2,2,4
2019-03-08 10:59:49,2.4084606481481483,1,2,1,3
2019-07-22 18:16:54,1314.6705787037038,4,347,259,606
2019-02-25 20:01:34,0.0052199074074074075,1,3,3,6
2019-02-21 19:56:29,0.07020833333333333,1,0,22,22
2019-03-27 23:01:08,35.02251157407407,17,216,138,354
2019-04-21 23:09:07,72.46172453703704,2,539,291,830
2019-02-18 19:10:04,0.05929398148148148,2,10,11,21
2019-04-21 12:54:02,61.88393518518519,6,65,17,82
2019-02-20 19:08:08,2.730451388888889,3,9,4,13
2019-04-25 22:45:10,67.09961805555555,8,679,60,739
2019-03-03 18:07:47,13.995879629629629,11,762,340,1102
2019-02-15 18:53:35,0.040601851851851854,1,0,2,2
2019-02-15 17:16:30,0.03185185185185185,2,3,2,5
2019-02-21 16:09:03,7.276782407407407,1,63,4,67
2019-02-28 03:02:23,15.434930555555555,4,1095,385,1480
2019-02-28 00:43:14,14.664918981481481,1,16,15,31
2019-03-02 06:29:03,17.14503472222222,4,237,33,270
2019-02-13 11:19:26,1.3021875,2,19,6,25
2019-03-11 07:14:39,28.436631944444443,7,241,115,356
2019-02-11 19:23:50,0.037141203703703704,1,46,0,46
2019-02-11 04:16:04,1.1520601851851853,3,4,2,6
2019-03-02 07:22:46,20.62943287037037,5,60,35,95
2019-02-28 03:06:52,19.129641203703702,1,2,2,4
2019-03-08 20:23:04,28.330416666666668,2,21,4,25
2019-02-28 23:20:22,20.49076388888889,2,17,2,19
2019-02-08 22:41:32,0.5661574074074074,7,64,70,134
2019-03-01 02:27:33,20.285740740740742,2,4,14,18
2019-02-08 08:22:17,0.46528935185185183,1,2,3,5
2019-02-27 04:09:10,19.793564814814815,1,41,28,69
2019-02-08 13:18:12,1.2367824074074074,1,14,5,19
2019-02-28 23:25:20,21.93962962962963,3,11,12,23
2019-03-15 21:53:51,0.13868055555555556,1,20,10,30
2019-02-25 14:41:09,19.710787037037036,11,186,24,210
2019-02-06 20:23:59,0.8737847222222223,2,17,6,23
2019-04-07 09:50:54,61.3621412037037,2,35,25,60
2019-02-21 06:34:09,15.590752314814814,3,314,272,586
2019-02-06 05:55:00,0.6414583333333334,2,3,3,6
2019-02-06 04:38:47,0.7076388888888889,1,48,1,49
2019-02-06 04:17:02,0.6773958333333333,2,49,4,53
2019-02-21 22:39:46,17.038680555555555,2,92,31,123
2019-02-05 12:22:39,1.0212037037037036,1,25,0,25
2019-02-05 12:27:25,1.0392939814814814,1,35,0,35
2019-02-05 12:18:17,1.601863425925926,1,10,0,10
2019-04-25 17:12:36,80.548125,12,644,191,835
2019-02-21 07:42:24,17.933645833333333,2,14,7,21
2019-02-01 22:57:56,0.31710648148148146,1,16,1,17
2019-02-01 17:26:10,0.9571296296296297,1,2,2,4
2019-02-21 06:31:50,22.220775462962962,1,2,2,4
2019-02-03 04:53:05,4.155034722222222,1,1,1,2
2019-02-02 15:41:14,3.872210648148148,5,64,6,70
2019-02-02 09:42:25,4.502997685185186,2,13,10,23
2019-01-28 18:02:15,0.5849305555555555,1,1,1,2
2019-01-28 07:43:08,0.4088888888888889,1,4,1,5
2019-03-23 18:07:57,55.17828703703704,8,286,86,372
2019-01-28 23:00:19,1.492337962962963,1,27,2,29
2020-02-25 07:41:11,411.0915277777778,18,1434,520,1954
2019-02-17 19:34:06,25.6034375,2,30,1,31
2019-01-22 18:40:34,0.5395023148148148,1,3,3,6
2019-01-21 23:44:41,0.05571759259259259,1,1,1,2
2019-04-19 01:15:07,87.61793981481482,1,3,5,8
2019-01-19 04:40:10,0.1282175925925926,1,28,12,40
2019-02-08 11:28:19,21.676909722222224,5,34,29,63
2019-01-21 16:30:41,4.944085648148148,2,58,33,91
2019-01-16 21:52:21,1.528287037037037,2,28,11,39
2019-10-21 12:05:46,59.538969907407406,2,69,26,95
2019-01-14 17:34:49,0.096875,1,9,6,15
2019-08-26 00:12:51,223.47043981481482,3,45,15,60
2019-01-28 03:18:42,15.012962962962963,6,31,13,44
2019-01-18 09:46:33,5.501481481481481,4,53,41,94
2019-01-14 19:09:53,2.7543402777777777,1,14,15,29
2019-01-30 01:37:04,18.542453703703703,7,42,25,67
2019-01-19 04:45:22,9.318368055555556,2,24,11,35
2019-03-13 17:29:37,64.79119212962964,7,663,370,1033
2019-01-09 16:14:10,2.2233912037037036,1,2,3,5
2019-01-23 21:51:07,16.553912037037037,1,7,7,14
2019-03-02 15:46:37,55.942708333333336,13,115,66,181
2019-01-18 20:58:25,14.268125,2,340,274,614
2019-02-05 04:24:58,32.52549768518519,4,240,172,412
2019-03-02 01:11:47,58.481631944444445,3,6,1,7
2019-02-03 05:19:16,31.688159722222224,1,29,23,52
2019-05-20 21:09:57,152.34349537037036,6,925,192,1117
2019-01-01 11:11:10,0.001712962962962963,1,1,1,2
2019-02-21 06:17:07,54.11983796296296,4,262,105,367
2018-12-31 20:36:20,3.914652777777778,1,1,1,2
2018-12-27 01:45:21,0.5040856481481482,3,35,3,38
2019-03-02 03:32:53,66.3109375,2,3,3,6
2019-01-19 10:08:07,28.530300925925925,26,976,682,1658
2019-01-28 17:14:57,37.96474537037037,2,19,0,19
2018-12-22 11:27:52,1.5529282407407408,3,20,4,24
2019-03-07 14:17:48,75.9856712962963,3,20,28,48
2018-12-21 14:48:49,13.244247685185185,1,9,9,18
2018-12-28 20:57:54,7.667372685185185,1,3,3,6
2018-12-21 04:50:11,1.570138888888889,3,15,11,26
2019-01-14 17:55:41,26.378541666666667,4,874,433,1307
2018-12-28 20:52:57,9.962141203703704,1,41,12,53
2018-12-19 02:30:35,0.33577546296296296,1,72,58,130
2018-12-21 01:25:54,3.238414351851852,6,183,77,260
2018-12-16 17:55:48,0.5515856481481481,1,2,3,5
2018-12-15 19:26:30,0.29053240740740743,1,1,1,2
2018-12-15 19:13:46,0.5907523148148148,1,2,2,4
2018-12-15 04:32:06,0.2639930555555556,1,0,8,8
2018-12-14 20:05:44,0.13287037037037036,1,3,0,3
2018-12-15 19:23:20,1.4386342592592594,3,23,19,42
2018-12-14 20:13:03,1.1098726851851852,1,24,0,24
2018-12-13 04:30:03,0.11530092592592593,1,1,1,2
2018-12-19 02:43:21,11.846203703703704,5,37,381,418
2018-12-08 07:23:06,0.7807407407407407,2,28,14,42
2018-12-07 13:10:18,0.3019907407407407,1,1,1,2
2019-01-02 19:36:40,96.75520833333333,21,28939,12107,41046
2018-12-05 05:47:24,0.4966087962962963,1,1,1,2
2019-04-23 21:25:09,140.73797453703705,3,60,25,85
2018-12-15 06:04:18,11.96050925925926,2,16,7,23
2019-04-18 02:34:07,135.94429398148148,1,285,48,333
2018-12-03 18:48:10,1.7247916666666667,2,145,141,286
2019-04-19 00:06:54,137.74180555555554,1,205,11,216
2018-11-30 19:57:17,0.09972222222222223,1,1,1,2
2018-11-30 13:06:54,0.28153935185185186,1,3,0,3
2018-11-29 18:03:10,1.367210648148148,2,2,10,12
2018-11-30 06:35:31,1.9291550925925927,3,46,45,91
2018-12-07 17:41:04,10.556921296296297,1,110,0,110
2018-11-27 17:32:45,0.6480902777777777,1,2,2,4
2019-03-13 21:39:18,107.0559837962963,3,208,17,225
2018-11-26 04:58:26,4.212465277777778,2,55,55,110
2019-01-01 22:47:38,36.91247685185185,5,538,397,935
2018-12-15 06:06:40,20.30435185185185,9,112,207,319
2018-11-24 18:23:20,0.030532407407407407,1,1,0,1
2018-11-24 18:35:17,1.3811458333333333,1,15,2,17
2020-04-19 21:12:17,513.7045717592592,5,60,25,85
2021-12-18 19:31:26,971.2463194444445,67,462777,203041,665818
2019-03-10 01:04:11,110.29846064814815,4,379,179,558
2018-11-23 07:02:51,0.7307291666666667,1,3,0,3
2018-11-23 07:05:42,1.281875,1,5,0,5
2018-11-21 22:27:50,0.9673726851851852,1,0,744,744
2018-11-21 22:25:55,1.4744444444444444,2,13,2,15
2018-11-20 10:03:05,0.5327662037037038,2,66,51,117
2018-12-18 06:56:56,28.72366898148148,5,32,13,45
2018-11-19 04:08:33,0.06576388888888889,1,62,62,124
2018-11-19 04:48:59,0.4286921296296296,1,11,9,20
2018-11-19 14:48:39,1.0476967592592592,1,3,3,6
2019-04-21 19:04:44,154.88096064814815,9,477,202,679
2018-11-18 17:51:57,0.8416782407407407,1,67,67,134
2019-02-28 23:34:12,103.24302083333333,2,43,15,58
2018-11-20 06:24:34,3.2695949074074075,1,4,0,4
2018-11-19 04:44:13,2.2516550925925927,1,1,1,2
2018-11-17 14:41:17,1.444386574074074,1,15,1,16
2018-11-24 19:11:59,8.530092592592593,3,80,77,157
2018-12-05 02:25:36,18.900983796296295,12,459,539,998
2018-11-21 07:08:21,5.186319444444444,1,4,24,28
2018-11-23 07:38:34,8.04224537037037,1,43,156,199
2018-11-15 13:32:56,0.5455439814814815,4,43,17,60
2018-11-15 06:48:44,0.2762962962962963,3,58,33,91
2018-11-15 05:16:44,0.2942939814814815,1,1,1,2
2018-11-18 14:32:22,5.026574074074074,1,1,1,2
2019-03-28 08:51:41,137.54552083333334,1,160,121,281
2018-11-09 20:41:54,0.16162037037037036,1,58,3,61
2018-11-09 16:24:07,0.7513888888888889,1,661,17,678
2018-11-08 07:05:36,0.07954861111111111,1,1,1,2
2018-12-26 21:06:58,48.90743055555556,4,108,49,157
2018-11-07 04:51:51,0.04644675925925926,1,1,0,1
2018-11-07 03:29:01,378.3158449074074,1,2,0,2
2018-11-07 03:50:45,0.3775925925925926,1,2,0,2
2018-11-06 22:25:18,0.2015625,1,4,0,4
2018-11-06 08:11:49,0.38078703703703703,2,21,1,22
2018-11-06 17:45:20,0.8087037037037037,1,9,7,16
2018-11-05 22:42:46,0.02074074074074074,1,1,1,2
2019-02-28 23:49:26,114.23013888888889,1,4,2,6
2018-11-05 11:09:13,1.7124537037037038,3,19,5,24
2018-11-07 06:18:54,5.687280092592593,1,22,4,26
2018-12-03 05:49:46,32.374155092592595,2,97,35,132
2018-10-31 23:55:30,0.09038194444444445,1,7,2,9
2019-03-01 06:11:33,121.0585763888889,2,28,27,55
2018-11-05 22:02:45,5.569178240740741,4,38,14,52
2018-11-02 13:54:37,2.3014236111111113,2,58,3,61
2018-10-31 14:23:17,0.6004398148148148,3,227,210,437
2018-10-28 08:59:31,0.7685532407407407,1,4,5,9
2018-10-26 06:38:18,0.33935185185185185,2,6,7,13
2018-10-24 18:57:05,0.5542476851851852,1,2,2,4
2018-10-23 15:54:56,0.12372685185185185,1,20,20,40
2018-11-04 09:14:42,16.261956018518518,8,32,12,44
2018-10-18 07:44:02,0.653449074074074,1,1,1,2
2018-10-25 19:45:20,8.46568287037037,4,132,103,235
2018-10-15 13:58:09,0.25743055555555555,6,9,9,18
2018-10-15 09:38:11,1.3711458333333333,1,32,0,32
2018-10-13 00:10:48,0.017465277777777777,1,2,2,4
2018-10-20 21:20:24,8.583645833333334,2,2,1,3
2018-10-12 04:06:29,0.22217592592592592,1,3,3,6
2018-10-11 04:40:51,0.14700231481481482,1,1,1,2
2018-10-30 22:25:30,21.448067129629628,15,144,68,212
2018-10-23 15:57:13,14.7240625,2,362,183,545
2018-10-15 05:23:47,7.789699074074074,4,243,167,410
2020-07-31 12:26:09,850.838275462963,21,146790,73524,220314
2018-10-06 14:08:25,1.2371180555555557,1,1,1,2
2018-10-10 05:33:58,35.438159722222224,4,88,29,117
2018-11-05 18:05:31,32.27133101851852,15,104,56,160
2018-10-06 14:06:59,2.1511805555555554,1,10,2,12
2018-10-06 14:13:45,2.519016203703704,2,26,12,38
2018-10-03 13:52:51,0.14175925925925925,2,4,4,8
2018-11-01 08:19:52,29.202662037037037,1,34,0,34
2018-10-06 14:18:16,3.662511574074074,2,16,16,32
2018-10-02 18:31:42,0.002650462962962963,1,1,1,2
2018-10-02 19:04:13,446.60405092592595,1,4,4,8
2019-03-01 02:30:42,150.25376157407408,2,11,5,16
2018-10-06 14:28:05,5.218171296296297,2,26,7,33
2018-10-02 13:27:53,1.493414351851852,4,17,10,27
2018-11-20 06:53:39,50.883344907407405,2,5,1304,1309
2018-10-10 05:19:51,11.880416666666667,1,5,1,6
2018-10-06 14:34:51,9.004143518518518,2,90,11,101
2019-08-04 14:32:50,311.9107986111111,6,125,31,156
2018-10-31 17:30:12,35.70707175925926,21,225,145,370
2018-10-30 05:33:28,36.33025462962963,23,4164,1028,5192
2018-11-05 14:17:32,42.537905092592595,20,5424,1296,6720
2018-09-24 14:58:11,0.5665277777777777,1,6,6,12
2018-10-01 07:49:17,7.541365740740741,3,40,79,119
2018-09-22 17:48:31,0.10104166666666667,1,0,3,3
2018-09-23 15:06:24,1.084375,3,12,3,15
2018-09-22 08:01:35,0.5397453703703704,1,15,1,16
2018-09-23 15:10:28,2.188599537037037,2,8,4,12
2018-10-21 12:48:43,30.53357638888889,1,1,1,2
2018-09-20 16:55:52,0.08898148148148148,1,1,1,2
2018-09-19 20:59:18,0.09607638888888889,1,52,52,104
2018-09-19 21:01:59,2.281400462962963,1,33,11,44
2018-10-02 21:01:59,15.406759259259259,4,43,6,49
2018-10-29 06:23:57,42.42800925925926,2,34,5,39
2018-09-17 13:39:53,0.8917592592592593,1,0,2,2
2018-09-16 16:41:55,0.24072916666666666,1,29,27,56
2018-09-16 16:43:29,0.2388888888888889,1,2,1,3
2018-09-30 05:41:55,15.065972222222221,14,2122,638,2760
2018-10-14 17:40:11,30.726990740740742,4,80,31,111
2018-09-16 11:11:11,3.583530092592593,3,22,30,52
2019-01-13 02:06:03,124.90439814814815,36,10042,8819,18861
2018-09-13 05:24:47,0.1653587962962963,1,4,4,8
2018-09-13 05:28:22,0.8956712962962963,1,6,4,10
2018-09-11 16:01:55,0.9844444444444445,1,7,6,13
2018-09-12 14:22:59,3.7727314814814816,7,76,26,102
2018-09-19 10:05:25,9.919155092592593,1,117,54,171
2018-09-16 07:38:39,7.335636574074074,2,2,2,4
2018-09-17 03:07:33,8.551400462962963,1,77,5,82
2018-09-07 19:38:47,0.026782407407407408,1,1,1,2
2018-09-07 18:46:08,0.14686342592592594,3,23,22,45
2018-09-07 05:33:55,0.36592592592592593,10,131,36,167
2018-09-06 22:18:56,0.08491898148148148,2,10,7,17
2018-09-08 14:43:39,1.841238425925926,2,34,22,56
2018-09-07 18:13:53,1.5723726851851851,1,1,1,2
2019-03-01 06:55:51,176.84248842592592,2,42,35,77
2018-09-04 20:34:29,0.03418981481481481,1,1,1,2
2018-09-10 16:07:58,0.07023148148148148,2,22,27,49
2018-09-04 20:39:38,0.49212962962962964,1,24,12,36
2019-05-20 21:26:59,233.26413194444444,1,111,8,119
2018-09-12 15:32:00,9.519189814814816,4,69,26,95
2018-09-03 02:23:40,0.20319444444444446,2,75,41,116
2018-09-02 21:56:00,0.05122685185185185,1,4,1,5
2018-09-02 20:08:57,0.33413194444444444,1,4,0,4
2018-09-25 16:24:46,23.63480324074074,6,270,127,397
2018-09-01 21:30:07,0.07456018518518519,1,5,5,10
2018-09-01 23:23:33,0.28619212962962964,1,49,9,58
2018-09-06 22:24:54,5.1795023148148145,10,38,22,60
2018-08-31 13:03:39,1.6229050925925925,2,47,41,88
2018-09-09 12:26:38,2.2543865740740743,2,1221,545,1766
2018-08-31 13:00:43,1.6105902777777779,1,1,1,2
2018-09-06 20:12:35,8.930902777777778,3,94,77,171
2018-08-26 15:54:07,0.7608449074074074,1,14,0,14
2018-08-25 21:56:04,11.762384259259258,1,1,0,1
2018-08-24 23:05:13,0.08498842592592593,2,55,22,77
2018-08-23 20:52:05,0.004872685185185185,1,8,9,17
2018-08-23 09:51:44,0.3649074074074074,3,3,3,6
2018-08-23 19:46:48,2.0021412037037036,4,14,8,22
2018-08-25 16:22:16,3.8809375,2,136,122,258
2018-08-21 15:23:56,0.7883564814814815,2,2,3,5
2018-08-21 14:33:55,0.9862152777777777,1,4,3,7
2018-08-23 19:55:25,6.975879629629629,3,17,0,17
2018-09-11 17:50:11,28.39025462962963,20,4096,3952,8048
2018-08-16 17:20:01,1.7631944444444445,1,3,3,6
2018-08-14 15:23:49,0.058368055555555555,1,2,2,4
2018-08-13 19:39:19,0.08784722222222222,2,2,2,4
2018-08-13 10:07:10,0.02144675925925926,1,2,2,4
2018-08-31 13:07:25,18.253275462962964,10,56,41,97
2018-08-23 19:31:59,11.022881944444444,7,119,189,308
2018-08-16 20:31:07,4.837696759259259,1,13,6,19
2018-08-12 11:27:45,3.3947453703703703,1,1,1,2
2018-08-11 22:40:47,1.7471412037037037,1,25,25,50
2018-08-12 14:23:39,2.721203703703704,2,2,2,4
2018-09-04 19:07:14,26.121319444444445,7,362,233,595
2018-08-09 18:52:18,0.6314351851851852,1,22,2,24
2018-09-01 13:57:14,24.31888888888889,1,5,4,9
2018-08-07 18:09:05,0.028194444444444446,1,5,0,5
2018-08-25 00:11:17,20.66425925925926,15,621,182,803
2018-08-15 04:28:28,11.525277777777777,2,4,3,7
2018-08-03 18:49:54,2.1802083333333333,2,9,1,10
2018-08-25 16:35:14,30.778020833333333,5,308,89,397
2018-08-09 16:08:24,9.509305555555555,8,140,73,213
2018-08-02 21:45:58,3.030763888888889,2,89,53,142
2018-07-30 07:05:18,0.035902777777777777,2,6,4,10
2018-08-10 13:42:00,40.74106481481481,6,17,5,22
2018-08-23 19:45:44,27.07701388888889,3,36,19,55
2018-07-29 06:05:36,2.9903703703703703,6,239,120,359
2018-08-24 22:48:25,29.21875,2,53,34,87
2018-07-28 16:38:50,3.9474305555555556,1,5,1,6
2018-07-26 17:18:02,4.124143518518519,2,8,6,14
2019-08-16 22:45:44,391.40627314814816,10,150,80,230
2018-07-24 01:18:17,3.254537037037037,2,37,30,67
2018-07-24 18:56:11,4.615462962962963,1,2,1195,1197
2018-07-21 17:02:14,1.7164351851851851,1,1,0,1
2018-08-24 22:50:07,37.13636574074074,2,4,2,6
2018-10-20 21:22:24,95.00819444444444,6,125,30,155
2018-08-24 22:54:33,37.93394675925926,1,4,2,6
2018-11-07 06:11:50,112.49333333333334,5,37,26,63
2018-08-24 22:58:04,38.30962962962963,2,24,19,43
2018-11-06 17:58:37,112.21603009259259,4,58,11,69
2018-07-16 13:35:19,0.22758101851851853,1,10,0,10
2018-11-06 17:24:15,1462.1752199074074,8,118,51,169
2018-07-18 06:25:46,584.0849189814815,10,492,42,534
2018-07-16 21:39:17,2.113020833333333,1,6,7,13
2018-07-12 14:58:39,0.820775462962963,1,29,22,51
2018-07-17 15:29:30,6.079641203703703,4,36,15,51
2018-07-13 04:22:07,2.355601851851852,1,0,9,9
2018-08-31 13:16:47,52.24197916666667,2,17,7,24
2018-07-11 03:49:58,1.2608680555555556,2,20,3,23
2018-08-31 13:20:07,52.75398148148148,5,12,4,16
2018-07-07 04:33:51,0.24636574074074075,1,1,1,2
2018-08-03 09:12:42,31.09201388888889,9,235,73,308
2018-07-02 16:45:51,0.3277777777777778,1,24,24,48
2018-07-07 09:58:03,5.175856481481482,4,273,32,305
2018-07-20 09:19:01,18.167094907407407,4,86,29,115
2018-11-08 15:19:12,129.76605324074075,22,23396,7786,31182
2018-09-02 20:03:24,63.03800925925926,2,55,52,107
2018-07-02 17:31:49,1.3032175925925926,1,5,6,11
2018-08-28 05:27:55,57.91671296296296,3,26,16,42
2018-08-20 18:16:59,382.9738541666667,2,48,13,61
2018-08-06 18:45:26,37.6243287037037,2,87,10,97
2018-07-02 02:22:22,2.2758680555555557,1,16,0,16
2018-07-01 17:31:51,2.5336805555555557,3,31,15,46
2018-06-28 07:51:51,0.01980324074074074,1,1,1,2
2018-06-27 09:29:57,0.7494907407407407,4,54,37,91
2018-06-28 08:00:01,2.0219097222222224,1,43,43,86
2018-07-07 15:36:48,12.006875,1,2,2,4
2018-07-09 15:27:01,14.198263888888889,8,101,31,132
2018-06-28 08:01:35,3.0604976851851853,2,95,71,166
2018-07-23 13:32:15,32.14174768518519,11,842,48,890
2018-06-25 15:56:42,2.0982175925925928,1,5,2,7
2018-06-24 00:24:33,0.4779861111111111,1,13,1,14
2018-06-28 05:30:27,5.671770833333333,6,896,171,1067
2018-06-24 10:41:31,2.4448842592592595,1,10,1,11
2018-06-21 20:41:39,0.4947685185185185,1,400,397,797
2018-06-28 08:18:18,7.4999768518518515,5,46,10,56
2018-06-30 21:21:15,53.20122685185185,105,3435,1153,4588
2018-06-25 05:48:43,5.498472222222222,4,57,45,102
2018-06-19 12:29:07,0.12856481481481483,1,1,1,2
2018-06-18 08:58:09,0.10587962962962963,1,1,1,2
2018-06-18 18:41:46,0.9101388888888889,1,1,1,2
2018-06-29 13:17:12,12.205555555555556,6,155,57,212
2018-06-19 16:59:46,3.235324074074074,3,13,13,26
2018-06-20 07:55:15,4.674467592592593,4,24,3,27
2018-06-13 03:05:16,0.1186574074074074,1,2,76,78
2018-06-15 00:14:48,3.031898148148148,1,9,57,66
2018-06-21 09:02:34,10.3871875,1,10,2,12
2018-06-10 18:34:30,0.23547453703703702,1,43,16,59
2018-06-13 15:57:16,3.1124537037037037,1,1,0,1
2018-06-10 04:20:57,2.311990740740741,1,2,2,4
2018-06-09 18:39:54,2.9867708333333334,21,478,28,506
2018-06-21 23:00:00,15.769293981481482,5,163,113,276
2018-11-06 17:33:22,153.76888888888888,3,47,4,51
2018-06-14 04:30:50,8.860752314814814,12,69,32,101
2018-06-18 18:45:11,14.060775462962964,4,4092,4308,8400
2018-07-06 12:18:43,32.85381944444445,13,10066,5280,15346
2018-06-01 21:16:56,0.019479166666666665,1,3,0,3
2018-11-01 04:33:27,154.26792824074073,13,908,221,1129
2018-06-05 15:48:18,6.140416666666667,3,181,116,297
2018-05-31 20:37:30,1.6631944444444444,2,12,2,14
2018-05-29 22:41:29,0.08930555555555555,1,2,0,2
2018-06-05 15:51:33,6.901875,3,42,2,44
2018-07-13 04:07:50,44.54991898148148,3,42,10,52
2018-09-20 20:20:28,115.95405092592593,10,1730,452,2182
2018-06-05 18:05:32,8.929814814814815,2,38,28,66
2018-06-28 09:03:17,104.95699074074074,3,176,32,208
2018-05-27 14:30:23,0.2650462962962963,2,28,16,44
2018-07-13 21:29:09,48.742349537037036,1,275,36,311
2018-05-26 19:23:57,1.3283796296296295,3,10,8,18
2018-06-07 15:22:45,13.739756944444444,4,96,90,186
2018-06-04 03:59:58,13.682511574074073,3,4,4,8
2018-05-21 15:24:20,1.0693402777777778,1,1,1,2
2018-06-10 03:58:45,21.926018518518518,1,45,4,49
2018-05-18 07:45:23,0.23310185185185187,1,13,5,18
2018-05-24 20:10:41,7.209513888888889,3,136,125,261
2018-05-24 20:12:02,8.163773148148149,2,19,22,41
2018-05-27 13:55:37,12.615752314814815,4,73,21,94
2018-05-14 21:01:40,2.9535069444444444,1,58,5,63
2018-05-11 17:55:06,0.29486111111111113,1,1,1,2
2018-05-14 21:03:26,4.5694791666666665,1,32,5,37
2018-05-14 05:49:30,4.326805555555556,4,42,18,60
2018-05-14 05:51:43,5.397118055555556,2,77,57,134
2018-05-15 19:30:52,21.402337962962964,2,2,2,4
2018-05-24 20:13:54,17.722800925925927,4,8,8,16
2018-05-05 16:48:58,0.19430555555555556,1,25,2,27
2018-06-28 09:04:35,53.89570601851852,4,36,45,81
2018-05-15 19:34:43,11.076574074074074,5,198,120,318
2018-05-08 18:19:28,4.0454282407407405,2,134,132,266
2018-05-03 15:06:17,13.087152777777778,1,6,3,9
2018-06-04 04:06:28,34.49831018518518,1,4,4,8
2018-04-29 16:51:50,0.1670486111111111,1,20,20,40
2018-04-29 14:54:13,0.33761574074074074,1,1,0,1
2018-05-04 16:05:59,5.999016203703704,2,68,9,77
2018-04-30 13:22:01,6.809270833333334,1,45,51,96
2020-11-08 22:20:53,926.3095717592593,3,249,275,524
2018-04-26 18:21:52,0.09393518518518519,1,3,3,6
2018-04-26 20:12:39,3.041215277777778,1,59,0,59
2018-06-10 05:26:54,49.589560185185185,4,66,10,76
2018-05-31 14:01:18,39.96962962962963,30,1313,174,1487
2018-05-08 09:09:01,16.807962962962964,5,138,23,161
2018-04-25 09:19:14,4.613391203703704,2,47,21,68
2018-04-19 16:36:18,1.5753587962962963,1,6,6,12
2018-04-17 23:32:28,0.05534722222222222,1,1,1,2
2018-04-18 00:15:31,0.14699074074074073,1,4,3,7
2018-04-21 17:51:44,3.965173611111111,1,16,7,23
2018-04-16 23:26:51,0.14528935185185185,1,3,2,5
2019-03-01 07:45:53,318.88305555555553,2,96,37,133
2019-03-01 08:22:24,318.9111111111111,2,22,17,39
2018-04-21 17:47:29,5.13275462962963,1,17,2,19
2018-05-05 22:45:58,21.580046296296295,6,306,149,455
2018-04-17 07:23:42,1.180601851851852,2,59,35,94
2018-10-30 05:11:54,197.12984953703705,10,2388,923,3311
2018-04-15 18:59:05,0.01545138888888889,1,6,3,9
2018-04-16 02:21:52,0.6154976851851852,1,0,10,10
2018-04-15 09:21:24,0.05136574074074074,1,23,26,49
2018-04-17 14:46:57,2.502974537037037,1,7,9,16
2018-04-16 09:33:59,1.3620486111111112,2,15,1,16
2018-04-14 21:12:45,0.004039351851851852,1,116,38,154
2018-04-24 23:55:21,10.145844907407408,1,40,0,40
2018-05-08 18:31:17,24.10787037037037,2,23,1,24
2018-06-05 07:25:00,51.69368055555555,3,22,24,46
2018-04-14 18:12:46,0.13733796296296297,1,4,4,8
2018-04-13 21:33:16,0.10255787037037037,4,11,14,25
2018-04-12 19:21:50,0.10170138888888888,1,11,3,14
2018-04-12 17:01:45,0.6647569444444444,2,4,4,8
2018-04-12 07:21:28,0.3964814814814815,2,58,6,64
2018-04-12 07:24:59,1.3930902777777778,3,13,7,20
2018-04-12 18:34:23,3.906759259259259,2,48,30,78
2018-04-11 06:54:22,0.4794212962962963,1,1,1,2
2018-04-12 18:39:18,3.8025231481481483,1,16,9,25
2018-04-08 21:10:38,0.009456018518518518,1,1,1,2
2018-04-08 21:12:51,0.18520833333333334,1,52,31,83
2018-04-09 12:38:53,52.3990625,1,68,6,74
2018-04-08 12:58:14,0.6169328703703704,1,4,17,21
2018-04-08 13:01:57,0.6613078703703704,1,11,3,14
2018-04-08 13:37:44,0.7605787037037037,2,7,8,15
2018-04-07 20:22:55,0.05814814814814815,1,13,14,27
2018-04-07 18:09:24,0.027997685185185184,1,1,1,2
2018-04-07 17:32:21,1.0417824074074074,2,36,6,42
2018-04-19 16:41:13,14.111145833333333,11,47,45,92
2019-11-04 16:50:25,610.8587037037037,3,493,84,577
2018-04-12 18:40:31,8.090520833333333,3,68,27,95
2018-04-04 07:53:16,0.2904513888888889,1,15,3,18
2018-04-07 18:38:23,3.8649074074074075,1,22,3,25
2018-04-07 17:35:52,3.877013888888889,1,23,5,28
2018-04-03 21:38:46,0.08534722222222223,1,7,5,12
2018-06-01 22:35:59,810.6856828703703,23,2129,2691,4820
2018-04-07 17:37:00,4.11212962962963,2,2,2,4
2018-04-07 17:38:22,4.50056712962963,1,18,2,20
2018-04-03 21:39:42,0.8390393518518519,1,2,0,2
2018-04-07 18:45:16,5.101550925925926,1,25,14,39
2018-04-02 19:01:44,0.21208333333333335,2,22,27,49
2018-04-03 13:35:48,0.9846412037037037,1,7,0,7
2018-04-08 16:53:41,6.253483796296297,2,17,2,19
2018-04-02 13:34:49,0.0825462962962963,1,2,2,4
2018-04-02 13:32:27,0.20921296296296296,2,14,14,28
2018-04-02 13:37:01,0.7160416666666667,1,2,2,4
2018-04-02 06:07:57,0.30486111111111114,1,10,0,10
2018-04-02 15:27:24,0.9824189814814814,1,2,0,2
2018-04-02 14:33:45,0.9743981481481482,1,20,12,32
2018-04-02 14:24:39,1.518136574074074,1,18,0,18
2018-04-07 17:43:28,6.76917824074074,1,14,3,17
2018-04-01 17:44:17,0.8499652777777778,2,83,98,181
2018-04-01 17:50:12,0.9137037037037037,5,33,30,63
2018-03-31 19:53:12,0.4874074074074074,13,77,54,131
2018-03-31 21:15:01,0.25047453703703704,1,12,5,17
2018-03-31 20:30:39,0.7693634259259259,1,6,15,21
2018-03-31 08:08:43,0.27934027777777776,2,2,1,3
2018-04-01 00:02:10,0.9376736111111111,1,20,3,23
2018-03-31 17:39:09,0.7054398148148148,1,7,7,14
2018-04-09 19:37:12,9.996400462962963,2,18,20,38
2018-03-30 23:26:16,0.818599537037037,1,1,0,1
2018-04-02 14:42:01,6.046956018518519,7,165,54,219
2018-03-27 18:53:42,0.973599537037037,1,14,39,53
2018-04-02 14:45:13,6.9472453703703705,3,18,13,31
2018-04-01 17:59:08,6.23525462962963,1,2,1,3
2018-03-26 13:46:40,0.4004861111111111,1,46,45,91
2018-03-26 14:34:18,0.5961342592592592,1,4,4,8
2018-06-23 07:27:40,89.55778935185185,5,301,71,372
2018-03-25 19:15:16,0.07383101851851852,1,1,1,2
2018-03-30 21:53:37,1.5483449074074074,1,83,1,84
2018-03-25 23:51:13,2.8265162037037035,1,71,0,71
2018-03-31 00:35:46,6.191701388888889,1,4,3,7
2018-03-31 04:40:43,6.376828703703704,3,40,20,60
2018-03-25 13:42:11,0.9380902777777778,1,43,59,102
2018-03-23 14:05:14,0.3365046296296296,2,9,12,21
2018-03-23 07:33:40,0.08657407407407407,1,12,0,12
2018-04-08 13:04:43,14.361145833333333,12,129,93,222
2018-04-11 15:39:36,19.816863425925927,4,298,175,473
2018-03-23 01:29:59,0.37353009259259257,1,7,0,7
2018-03-22 02:05:30,0.1926388888888889,1,1,8,9
2018-04-07 17:58:16,17.546423611111113,2,35,6,41
2018-03-26 01:23:35,5.053287037037037,1,3,3,6
2018-03-28 02:34:51,7.374837962962963,4,55,22,77
2018-03-24 03:07:45,3.552048611111111,2,14,4,18
2018-03-20 00:42:12,0.2551388888888889,1,1,1,2
2018-04-08 14:15:12,20.40386574074074,5,23,11,34
2018-04-06 07:49:13,19.43681712962963,1,84,14,98
2018-03-21 18:44:27,5.014050925925926,2,6,5,11
2018-04-08 17:00:27,23.08560185185185,3,30,3,33
2018-03-16 15:27:57,0.15505787037037036,1,1,1,2
2018-03-17 13:10:23,1.3544791666666667,1,1,2,3
2018-03-17 13:09:18,1.4401273148148148,1,3,3,6
2018-06-29 01:36:33,105.23072916666666,3,118,47,165
2018-03-15 19:22:27,0.009918981481481482,1,1,1,2
2018-10-31 01:06:37,229.2960185185185,2,38,10,48
2018-03-16 03:21:01,0.5722222222222222,1,1,1,2
2018-03-26 14:45:31,11.375578703703704,2,6,6,12
2018-04-01 18:10:38,18.401747685185185,1,177,0,177
2018-04-02 14:52:08,18.99802083333333,1,3,0,3
2018-04-07 19:58:31,24.923020833333332,5,1795,530,2325
2018-03-22 16:13:21,9.120324074074073,4,263,63,326
2018-03-13 20:48:17,1.6872337962962962,1,3,0,3
2018-03-17 23:47:49,6.085902777777778,5,26,10,36
2018-03-17 13:57:15,5.747349537037037,6,87,43,130
2018-03-13 21:38:53,18.837256944444444,2,9,16,25
2018-04-02 13:56:09,23.159988425925928,1,258,150,408
2018-04-02 15:00:27,23.723425925925927,1,84,5,89
2018-03-10 14:41:05,1.4456481481481482,2,2,1,3
2018-11-01 04:29:34,237.28342592592594,2,231,206,437
2018-03-16 18:40:32,13.987337962962963,1,130,53,183
2018-03-08 04:00:42,0.2710648148148148,1,1,1,2
2018-03-09 05:32:23,2.076226851851852,1,1,1,2
2018-03-07 07:34:29,0.33140046296296294,3,274,303,577
2018-03-08 16:11:01,40.762881944444445,13,376,60,436
2018-03-26 14:27:03,20.83417824074074,1,86,82,168
2018-04-02 15:07:53,189.54422453703702,1,6,19,25
2018-03-17 23:51:40,12.990335648148148,1,39,43,82
2018-04-07 18:07:27,34.50327546296296,4,161,46,207
2018-03-08 20:48:25,5.003738425925926,4,50,24,74
2018-03-03 20:43:27,0.12229166666666667,1,3,4,7
2018-03-08 05:48:09,7.415856481481481,4,447,143,590
2018-03-03 14:30:17,1.5512847222222221,1,2,2,4
2018-03-02 08:51:48,0.45292824074074073,1,16,4,20
2018-03-03 13:27:47,2.498171296296296,1,87,41,128
2018-03-31 01:47:59,33.089120370370374,1,41,0,41
2018-02-28 21:33:32,0.2434837962962963,2,26,16,42
2018-03-01 03:19:48,0.7003125,1,12,0,12
2018-03-03 14:40:59,3.4615046296296295,1,13,8,21
2018-03-17 13:14:10,15.668819444444445,1,5,5,10
2018-02-27 07:06:31,0.1827314814814815,1,1,1,2
2018-03-10 02:29:24,11.054641203703703,11,85,73,158
2018-03-04 15:08:30,11.780300925925927,2,78,82,160
2018-02-27 00:18:14,1.0464814814814816,1,4,1,5
2018-03-20 15:44:48,22.77230324074074,1,25,14,39
2018-02-26 04:20:10,0.33216435185185184,1,12,16,28
2018-03-07 13:34:47,9.828715277777778,4,13,3,16
2018-02-25 21:26:10,0.17737268518518517,2,19,10,29
2018-02-25 17:33:11,0.5773611111111111,1,27,2,29
2018-02-25 14:06:19,0.5588773148148148,1,24,4,28
2018-02-25 16:19:37,0.6197106481481481,1,5,254,259
2018-02-25 13:58:22,0.57625,2,46,40,86
2018-02-25 15:44:14,1.2578819444444445,3,30,3,33
2018-02-24 10:04:34,0.5843518518518519,4,27,4,31
2018-02-23 04:50:19,0.07116898148148149,1,2,2,4
2018-02-25 16:53:09,2.663009259259259,3,191,60,251
2018-03-02 00:30:17,7.03943287037037,1,36,3,39
2018-03-05 05:49:28,11.251469907407408,3,110,124,234
2018-04-02 15:15:48,39.685520833333335,1,1386,297,1683
2018-02-26 17:48:28,5.180486111111111,5,1678,1721,3399
2018-02-20 05:08:22,0.14724537037037036,1,1,1,2
2018-02-25 13:25:21,5.75519675925926,4,27,15,42
2018-02-20 15:01:32,1.0589930555555556,5,25,16,41
2018-03-09 05:12:27,19.156828703703702,1,230,291,521
2018-04-07 19:21:26,48.88652777777778,1,72,6,78
2018-02-19 18:45:47,2.1027893518518517,4,26,14,40
2018-04-02 15:56:06,44.725960648148146,2,24,8,32
2018-02-16 18:28:24,0.14340277777777777,1,2,2,4
2018-02-16 18:28:01,0.253912037037037,5,33,13,46
2018-02-16 06:35:17,0.058611111111111114,1,1,0,1
2018-02-17 16:16:44,1.4687152777777779,1,1,166,167
2019-04-09 08:15:10,428.07434027777776,101,7880,6974,14854
2018-02-15 23:12:40,0.09672453703703704,1,1,1,2
2018-02-16 04:49:06,0.5570023148148148,1,6,9,15
2018-04-08 17:10:31,52.83425925925926,13,158,116,274
2018-02-14 23:54:29,0.18877314814814813,1,0,290,290
2018-02-17 16:18:02,2.866527777777778,1,1,1,2
2018-02-14 19:10:36,0.024699074074074075,1,1,1,2
2018-03-05 15:12:23,98.93640046296296,9,149,56,205
2018-02-17 16:19:35,4.4948958333333335,2,15,406,421
2018-02-13 01:26:20,0.8842361111111111,1,134,70,204
2018-02-11 20:07:41,0.10587962962962963,2,3,1,4
2018-03-28 03:08:11,45.20217592592593,1,32,7,39
2018-02-12 01:22:51,1.0986458333333333,1,0,354,354
2018-02-11 06:13:13,0.2946064814814815,1,6,11,17
2018-03-26 16:04:00,43.985034722222224,11,604,338,942
2018-07-28 16:36:55,153.8562962962963,23,1141,389,1530
2018-02-10 16:28:00,0.5726157407407407,2,13,137,150
2018-02-09 20:47:21,0.03553240740740741,1,13,13,26
2018-02-26 12:48:25,16.906412037037036,2,23,20,43
2018-02-25 16:26:54,16.000694444444445,4,1566,450,2016
2018-02-09 14:11:20,0.00866898148148148,1,3,3,6
2018-02-09 19:36:36,0.6655555555555556,1,0,481,481
2018-02-10 14:54:29,1.965775462962963,3,5,5,10
2018-02-09 19:37:37,1.2132175925925925,1,2,7,9
2018-02-08 21:11:52,0.647962962962963,1,4,10,14
2018-02-08 02:50:21,0.25353009259259257,2,12,5,17
2018-02-07 21:39:33,0.49413194444444447,2,33,10,43
2018-02-17 16:23:38,15.57925925925926,3,210,22,232
2018-06-25 01:21:30,142.70450231481482,57,32620,13182,45802
2018-04-08 14:21:29,65.30706018518518,1,1,1,2
2018-02-07 14:14:17,7.0921412037037035,3,137,10,147
2018-02-03 17:51:03,3.830023148148148,3,41,19,60
2018-02-08 02:57:07,11.124502314814816,5,114,47,161
2018-01-30 03:32:05,2.2091782407407408,1,41,1,42
2018-01-27 19:04:08,0.18292824074074074,1,2,2,4
2018-02-13 09:50:13,17.405520833333334,2,52,87,139
2018-01-31 18:38:19,4.8651736111111115,3,9,5,14
2018-01-27 14:50:17,0.7641550925925926,1,3,6,9
2018-02-06 14:30:24,10.777777777777779,1,34,7,41
2018-04-01 02:37:30,243.3329050925926,19,12015,4986,17001
2018-01-27 14:29:28,4.265717592592592,2,46,14,60
2018-01-26 07:58:18,3.445428240740741,1,6,6,12
2018-03-31 01:50:45,68.65447916666666,3,127,96,223
2018-01-20 20:16:58,0.020763888888888887,1,1,1,2
2018-01-23 19:28:01,3.186747685185185,1,27,2,29
2018-01-27 19:57:09,7.986400462962963,1,65,0,65
2018-01-19 11:07:24,0.08141203703703703,1,2,1,3
2020-12-30 14:45:46,45.29071759259259,3,123,45,168
2018-01-17 00:33:34,0.3035763888888889,1,1,1,2
2018-01-19 23:00:50,3.4864930555555556,1,1,1,2
2018-01-16 21:10:06,0.42493055555555553,1,35,35,70
2018-01-19 05:59:30,3.0607060185185184,1,43,43,86
2018-01-16 12:25:41,1.6334490740740741,1,17,0,17
2018-01-17 15:07:42,2.925601851851852,3,9,3,12
2018-11-06 18:24:38,297.206412037037,12,250,65,315
2018-06-23 07:21:33,161.00202546296296,1,62,18,80
2018-11-07 03:53:57,297.5942939814815,26,832,551,1383
2018-01-13 17:42:48,0.11603009259259259,2,6,2,8
2018-01-13 09:29:43,0.16892361111111112,1,14,14,28
2018-01-13 04:04:52,0.5225694444444444,1,189,191,380
2018-01-12 01:04:22,0.015231481481481481,1,2,2,4
2018-01-13 03:51:47,2.007627314814815,2,6,6,12
2018-01-13 17:47:43,2.9700231481481483,1,3,0,3
2018-02-23 13:51:21,44.16790509259259,4,150,151,301
2018-02-28 09:55:23,49.73309027777778,3,50,14,64
2018-01-11 19:43:59,2.997152777777778,3,24,15,39
2018-01-11 11:03:33,3.900625,1,100,100,200
2018-01-04 17:24:20,0.13642361111111112,1,4,4,8
2018-01-03 09:43:11,0.47379629629629627,1,1,1,2
2018-03-05 15:09:00,24.080694444444443,9,1370,269,1639
2018-01-08 18:01:00,6.83,2,13,2,15
2018-01-02 06:20:09,0.5564930555555555,1,2,2,4
2018-10-10 14:57:03,282.68196759259257,4,511,181,692
2018-01-02 01:54:38,3.914270833333333,1,6,0,6
2017-12-29 09:42:12,2.8236805555555557,1,1,1,2
2017-12-22 22:05:59,0.0821412037037037,1,9,0,9
2017-12-21 22:35:04,0.6037731481481482,1,10,5,15
2017-12-28 07:02:28,7.85505787037037,1,4,1,5
2018-02-08 21:19:12,50.93537037037037,3,46,13,59
2017-12-20 03:34:56,0.1258912037037037,4,8,5,13
2018-04-07 17:41:41,109.13655092592593,2,2,7,9
2017-12-19 13:18:07,0.7421527777777778,3,2,13,15
2018-01-01 20:22:55,15.051238425925925,2,28,10,38
2018-01-26 20:23:42,41.911377314814814,6,133,34,167
2018-01-20 05:40:47,35.42125,2,8,5,13
2018-02-03 14:27:38,51.84741898148148,2,47,7,54
2017-12-22 14:41:21,9.263993055555556,2,4,2,6
2017-12-11 10:04:17,0.3836805555555556,1,30,15,45
2018-04-02 16:19:10,116.11615740740741,3,65,28,93
2017-12-12 03:42:04,7.627002314814815,1,35,35,70
2018-01-17 20:15:13,44.78263888888889,4,456,144,600
2017-12-10 06:08:59,6.746944444444445,1,30,3,33
2017-12-03 15:11:24,0.6009027777777778,3,9,8,17
2018-01-22 03:15:58,50.14221064814815,1,16,2,18
2017-12-02 19:12:22,1.9610532407407408,1,1,1,2
2018-02-04 20:21:25,47.43435185185185,3,71,42,113
2017-11-22 21:26:49,0.18540509259259258,2,10,3,13
2017-12-07 23:09:02,13.750694444444445,1,25,2,27
2017-11-23 06:45:09,2.1202083333333333,1,5,2,7
2017-11-22 20:21:40,1.9953472222222222,2,20,8,28
2017-11-23 11:32:27,2.7701736111111113,2,9,8,17
2017-11-20 21:14:19,0.47759259259259257,1,2,3,5
2017-12-12 03:43:30,22.261319444444446,1,24,5,29
2018-02-17 16:30:07,93.85337962962963,10,1886,789,2675
2017-12-11 10:09:05,23.32982638888889,3,149,48,197
2017-11-21 10:52:36,4.831736111111111,1,7,1,8
2017-11-23 00:17:39,7.805023148148148,2,15,6,21
2017-11-15 18:55:34,1.2704861111111112,1,0,3,3
2017-11-15 18:58:04,1.9333564814814814,1,13,3,16
2017-11-17 20:46:27,4.958726851851852,11,120,49,169
2017-12-12 03:46:23,29.538969907407406,2,28,10,38
2018-02-10 16:09:05,90.06482638888889,2,5,3,8
2017-11-12 10:35:56,0.0004050925925925926,1,11,0,11
2018-02-02 18:00:59,51.55542824074074,3,201,32,233
2017-11-12 10:20:23,1.5375810185185186,1,3,3,6
2017-11-10 20:56:09,0.2789814814814815,1,0,64,64
2017-11-09 20:05:05,0.7207060185185186,1,1,1,2
2017-11-10 20:54:12,3.838275462962963,4,122,68,190
2017-11-07 09:58:36,0.5044212962962963,1,2,2,4
2017-11-08 17:01:25,2.070636574074074,4,29,15,44
2017-11-07 10:35:28,0.8334143518518519,1,1,1,2
2017-11-06 12:11:57,0.009432870370370371,1,11,7,18
2017-11-04 14:26:20,0.06174768518518518,3,11,11,22
2017-11-06 14:12:09,2.3361342592592593,1,18,62,80
2017-11-02 09:33:18,0.037696759259259256,2,9,1,10
2017-11-07 10:00:01,5.5605671296296295,4,1336,718,2054
2017-11-07 09:52:39,5.653113425925926,2,55,60,115
2017-10-31 21:49:48,0.16934027777777777,1,2,2,4
2017-10-31 01:21:55,0.15672453703703704,1,5,10,15
2017-10-31 00:38:54,0.17282407407407407,1,33,2,35
2018-04-08 14:28:39,160.04686342592592,3,6,1,7
2017-10-29 18:05:08,0.04760416666666667,1,3,1,4
2018-11-07 05:50:57,374.4438425925926,81,85707,35620,121327
2018-02-07 20:15:24,104.24023148148149,2,140,79,219
2017-11-07 00:36:58,9.704583333333334,4,58,11,69
2017-10-28 05:17:22,0.28315972222222224,1,224,224,448
2017-11-10 20:57:44,14.786458333333334,1,73,7,80
2018-04-02 16:22:43,158.0321412037037,2,7,3,10
2017-10-26 12:34:16,0.1655787037037037,1,1,1,2
2017-10-26 04:10:57,0.40109953703703705,1,1,0,1
2017-10-28 15:07:28,2.996747685185185,2,12,10,22
2017-10-25 20:54:44,0.8546180555555556,1,2,1,3
2017-10-25 21:15:20,0.945324074074074,1,8,0,8
2017-10-25 21:16:25,0.9561689814814814,1,8,0,8
2017-10-24 03:04:34,0.15416666666666667,4,14,14,28
2018-02-07 20:04:20,107.71369212962964,3,382,467,849
2017-10-22 14:23:51,14.530659722222222,1,123,81,204
2017-10-22 13:38:08,3.724409722222222,3,12,6,18
2017-11-28 06:20:44,43.10042824074074,5,52,34,86
2017-10-19 15:21:10,1.8501041666666667,4,25,16,41
2017-11-07 11:05:39,21.56537037037037,1,14,3,17
2017-10-22 13:34:22,5.7240162037037035,1,19,18,37
2017-11-07 14:51:12,21.819189814814816,1,9,2,11
2017-10-16 18:28:24,0.7288541666666667,2,33,29,62
2017-10-15 17:03:05,0.07103009259259259,1,13,51,64
2017-10-16 00:46:06,0.43105324074074075,1,28,2,30
2017-10-14 19:52:15,1.0091319444444444,5,25,7,32
2017-10-25 21:33:45,12.8684375,4,223,100,323
2017-10-20 21:55:33,7.83375,2,6,1,7
2017-10-15 12:10:57,2.8014004629629627,3,12,12,24
2017-10-12 19:40:36,0.2920949074074074,1,2,2,4
2017-10-12 18:55:19,0.6660532407407408,2,6,6,12
2017-10-12 19:21:06,1.0139120370370371,1,64,9,73
2017-10-12 19:00:01,1.2694560185185184,1,1,1,2
2018-04-08 16:10:56,179.5054513888889,2,9,5,14
2017-10-12 18:54:38,1.8988425925925927,14,20,40,60
2017-10-11 13:36:07,0.6548958333333333,1,1,0,1
2017-10-12 19:01:38,1.9703356481481482,2,18,4,22
2017-10-11 18:04:37,0.9375694444444445,2,10,6,16
2017-10-12 19:37:06,2.7775925925925926,8,162,146,308
2017-10-09 23:37:30,0.8226967592592592,1,274,272,546
2017-10-09 21:52:59,0.1660648148148148,13,127,147,274
2017-10-09 21:25:16,0.7513310185185185,2,6,8,14
2017-10-09 21:47:04,13.452789351851852,2,15,0,15
2017-10-15 12:14:16,6.874467592592593,2,20,12,32
2017-10-09 23:23:39,1.8722916666666667,1,9,1,10
2017-10-22 13:53:22,15.020949074074075,3,162,31,193
2017-10-07 13:30:34,0.025844907407407407,1,3,3,6
2017-10-07 13:39:25,0.9263773148148148,1,81,0,81
2017-10-06 19:12:00,0.24846064814814814,1,23,13,36
2017-10-06 18:57:21,0.3091319444444444,2,16,14,30
2018-04-07 19:17:07,183.83711805555555,1,27,5,32
2017-10-12 21:43:35,7.0747685185185185,29,243,204,447
2017-10-07 14:39:46,0.9445370370370371,2,39,29,68
2017-10-05 17:27:33,1.0135532407407408,1,49,17,66
2017-10-12 19:47:36,8.746793981481481,3,8,6,14
2017-10-03 19:57:01,0.18631944444444445,1,1,1,2
2017-10-09 22:57:04,6.790069444444445,4,83,45,128
2017-10-06 19:23:00,3.932164351851852,1,21,1,22
2017-10-24 09:32:36,65.36600694444445,8,572,188,760
2017-10-03 16:34:11,0.8176736111111111,2,18,11,29
2017-10-06 19:29:13,3.975011574074074,1,19,46,65
2017-10-01 18:42:37,0.15046296296296297,1,61,61,122
2017-10-15 13:11:43,43.41798611111111,6,83,63,146
2017-10-07 22:16:14,8.679386574074075,1,37,76,113
2017-09-30 22:05:13,2.549722222222222,1,14,7,21
2017-10-15 12:23:01,17.174791666666668,4,66,41,107
2017-10-12 03:21:16,1134.4989814814815,24,462,314,776
2017-10-15 12:27:31,18.794664351851853,5,573,73,646
2017-09-26 20:06:13,0.5170833333333333,2,21,4,25
2017-09-27 10:00:16,1.2455439814814815,1,6,2,8
2017-09-26 05:07:34,0.057337962962962966,1,1,1,2
2017-09-26 10:58:00,0.3504398148148148,1,1,1,2
2017-09-25 20:55:46,0.36694444444444446,2,64,64,128
2017-10-01 12:29:06,6.112743055555556,1,107,0,107
2017-09-25 17:19:04,0.7878935185185185,1,1,1,2
2017-09-25 00:47:21,0.12796296296296297,1,16,2,18
2017-09-24 23:29:06,0.10416666666666667,1,2,2,4
2017-09-25 01:12:04,0.27760416666666665,2,43,36,79
2017-09-26 06:48:39,2.308599537037037,1,17,1,18
2017-09-23 22:52:26,0.0009837962962962962,1,2,1,3
2017-09-23 20:54:55,0.18862268518518518,1,13,1,14
2017-09-22 23:09:15,0.2245949074074074,1,1,1,2
2018-03-05 14:34:11,225.30642361111111,9,54,27,81
2017-09-23 17:59:33,1.668599537037037,1,31,7,38
2017-09-22 09:35:52,0.6479976851851852,1,5,5,10
2017-09-22 21:43:42,4.442835648148148,3,79,25,104
2017-09-25 16:01:13,4.886516203703704,1,146,34,180
2017-09-23 09:03:59,3.548414351851852,2,236,118,354
2017-09-22 10:19:35,4.552280092592593,1,103,65,168
2017-09-19 09:51:39,0.6463888888888889,1,26,15,41
2017-09-18 17:53:08,0.03747685185185185,2,3,3,6
2017-09-17 09:48:11,0.015833333333333335,1,7,1,8
2017-09-17 07:59:34,0.07594907407407407,1,10,4,14
2017-09-17 08:23:47,0.13314814814814815,1,1,1,2
2017-09-17 04:47:38,0.002013888888888889,1,10,9,19
2017-10-01 12:31:49,14.791840277777778,5,51,32,83
2017-09-17 07:59:59,0.957037037037037,8,101,1880,1981
2017-09-17 07:58:36,1.0451736111111112,4,204,108,312
2017-09-17 09:51:34,3.0294675925925927,3,562,25,587
2017-09-16 04:20:45,0.02224537037037037,1,27,33,60
2017-09-16 04:22:53,0.3488425925925926,1,87,82,169
2017-09-28 05:21:44,12.621446759259259,1,64,56,120
2017-10-01 12:25:47,15.709780092592593,5,21,6,27
2017-09-16 01:25:11,0.2600925925925926,1,94,27,121
2017-09-15 18:31:15,0.0927662037037037,1,2,0,2
2017-09-15 09:29:22,0.3008101851851852,1,4,1,5
2017-09-15 09:33:17,0.45185185185185184,1,18,11,29
2017-09-15 10:00:11,0.8946875,2,226,119,345
2017-09-23 23:09:01,9.600543981481481,1,17,0,17
2017-09-14 07:35:40,0.1670023148148148,1,1,1,2
2017-09-17 08:12:59,3.49443287037037,5,435,123,558
2017-09-13 20:28:05,4.331539351851852,1,62,0,62
2017-09-17 02:38:11,8.616238425925927,11,1625,799,2424
2017-09-09 05:32:17,0.17561342592592594,1,38,35,73
2017-09-09 08:40:12,59.16013888888889,3,386,124,510
2017-09-16 22:25:55,183.0842939814815,2,30,13,43
2018-01-29 06:07:18,145.43971064814815,12,14885,7360,22245
2017-09-09 02:16:55,3.9390162037037038,1,44,0,44
2018-12-18 07:15:53,518.2005439814815,9,3021,4119,7140
2017-09-03 12:00:49,0.2273263888888889,1,2,2,4
2017-09-03 06:23:59,0.06557870370370371,1,4,4,8
2017-10-20 19:32:05,48.03357638888889,2,9,4,13
2017-09-03 06:24:35,7.123078703703704,2,55,29,84
2017-09-15 14:30:22,24.600497685185186,1,197,141,338
2017-08-30 08:37:10,0.20516203703703703,1,7,6,13
2017-09-17 07:54:01,18.532650462962962,5,662,157,819
2017-09-14 08:50:31,16.614178240740742,22,367,135,502
2017-08-29 09:26:51,0.04052083333333333,1,34,1,35
2017-08-29 16:08:25,0.7318634259259259,3,19,12,31
2017-10-01 12:36:59,33.66238425925926,1,242,31,273
2017-10-15 12:50:49,107.48722222222223,1,359,6,365
2017-08-26 23:49:27,1.6035300925925926,1,17,1,18
2017-08-26 23:54:19,2.424537037037037,2,5,4,9
2017-08-24 14:06:38,0.06766203703703703,2,19,5,24
2017-08-26 05:45:50,3.6321412037037035,1,4,2,6
2017-08-24 09:21:05,1.8167708333333332,4,94,32589,32683
2017-08-22 15:41:18,0.07774305555555555,1,7,2,9
2017-09-03 06:28:27,12.687129629629629,19,344,100,444
2017-08-22 14:31:43,0.9820138888888889,22,353,305,658
2017-08-20 21:12:11,0.14331018518518518,1,10,10,20
2017-08-20 17:52:21,0.007222222222222222,1,5,5,10
2017-08-20 17:13:32,0.03443287037037037,2,7,7,14
2017-08-20 17:14:19,0.12248842592592593,1,2,2,4
2017-08-23 23:36:12,3.5249074074074076,2,22,0,22
2017-08-20 12:25:22,0.12699074074074074,1,26,30,56
2017-08-20 12:33:55,0.26849537037037036,1,53,1,54
2017-08-20 12:38:17,0.32622685185185185,1,146,79,225
2017-08-20 03:30:40,0.14837962962962964,1,2,2,4
2017-08-20 12:34:25,0.5284837962962963,1,39,0,39
2017-08-19 23:04:32,0.03995370370370371,1,6,6,12
2017-08-19 23:05:11,0.6796412037037037,1,0,165,165
2017-09-16 03:11:04,27.854421296296298,1,773,452,1225
2017-08-19 05:16:12,0.0006481481481481481,1,3,0,3
2017-08-22 09:52:39,124.81251157407408,8,338,122,460
2017-08-18 18:29:20,0.04825231481481482,1,1,0,1
2017-08-18 15:43:03,0.0032407407407407406,1,1,1,2
2017-08-18 16:47:37,0.05503472222222222,1,4,2,6
2017-08-17 17:58:14,0.09157407407407407,2,8,8,16
2017-08-18 20:23:55,1.275949074074074,1,2,1,3
2017-08-18 14:02:18,1.686412037037037,3,12,3,15
2017-08-17 12:09:59,0.6811226851851852,4,112,5,117
2017-09-17 08:04:09,32.473622685185184,8,400,259,659
2017-08-16 16:45:26,0.9933333333333333,1,18,18,36
2017-08-18 15:17:37,2.960300925925926,16,49,23,72
2017-09-10 03:41:16,25.983854166666667,1,124,18,142
2017-08-14 18:17:36,0.004756944444444445,1,3,0,3
2017-08-14 17:56:01,0.9333333333333333,1,1,1,2
2017-08-13 13:19:05,0.05571759259259259,1,6,4,10
2017-08-16 09:42:12,2.986851851851852,4,418,350,768
2017-08-10 12:38:37,0.25453703703703706,2,14,4,18
2017-08-18 16:54:02,8.432939814814814,1,28,4,32
2017-08-10 12:34:56,0.30613425925925924,1,8,0,8
2017-08-18 17:02:20,9.648136574074075,1,5,2,7
2017-08-09 07:57:16,0.4321990740740741,2,3,32,35
2017-08-08 00:23:10,0.31405092592592593,1,13,13,26
2017-08-09 21:27:19,2.2716666666666665,1,1,1,2
2017-08-08 00:37:53,0.34273148148148147,1,4,4,8
2017-08-12 22:47:43,5.3240625,1,22,6,28
2017-08-07 19:15:34,2.236863425925926,1,20,17,37
2017-08-03 21:36:08,0.8484375,1,12,3,15
2017-08-05 13:06:30,2.6348611111111113,1,19,12,31
2017-08-02 20:56:40,0.048171296296296295,2,365,30,395
2017-08-19 03:33:36,17.442083333333333,4,79,49,128
2017-08-01 19:26:18,0.3227199074074074,1,1,1,2
2017-08-20 03:47:57,19.052210648148147,2,2,2,4
2017-07-31 20:31:40,0.13722222222222222,2,7,3,10
2017-08-02 19:09:56,2.9071875,2,17,7,24
2017-08-19 03:35:25,111.6673263888889,5,66,55,121
2017-07-30 19:17:03,0.1203587962962963,1,4,4,8
2017-07-30 20:39:39,0.20521990740740742,1,8,5,13
2017-07-30 20:07:13,0.1972800925925926,1,4,35,39
2017-07-30 13:22:58,0.07571759259259259,1,17,14,31
2017-07-30 18:04:07,0.8953009259259259,4,62,22,84
2017-07-29 17:13:41,0.09318287037037037,2,103,40,143
2017-07-29 14:07:08,0.055879629629629626,1,1,0,1
2017-07-29 14:17:12,0.07177083333333334,1,4,0,4
2017-07-29 15:21:55,160.8949074074074,2,14,3,17
2017-07-28 23:46:40,0.028391203703703703,1,1,1,2
2017-07-29 17:08:29,0.7824074074074074,1,2,18,20
2017-07-28 20:58:00,0.10545138888888889,3,13,3,16
2017-08-13 00:36:07,16.10869212962963,14,173,175,348
2017-07-28 18:07:00,6.138703703703704,1,11,0,11
2017-07-27 20:42:21,0.040983796296296296,1,1,1,2
2017-07-27 19:03:43,0.03319444444444444,1,19,14,33
2017-08-02 19:17:17,6.8109375,3,61,24,85
2017-07-27 04:43:34,0.1583101851851852,2,2,2,4
2017-07-27 07:02:48,1.5142939814814815,5,85,84,169
2017-07-26 20:01:29,0.09422453703703704,1,15,13,28
2017-07-26 18:29:51,0.09578703703703703,1,1,1,2
2017-07-25 18:52:34,0.01505787037037037,1,5,5,10
2017-07-28 18:10:16,3.581238425925926,3,167,141,308
2017-07-26 18:57:07,1.9189351851851852,3,243,10,253
2017-07-26 19:08:15,2.0543981481481484,1,37,0,37
2017-07-27 19:19:29,3.2467939814814817,4,40,15,55
2017-07-27 19:28:37,5.2407407407407405,1,28,9,37
2017-07-23 20:05:06,124.35799768518518,2,35,11,46
2017-07-27 07:35:03,7.3303819444444445,2,32,6,38
2017-07-19 20:30:49,0.040185185185185185,2,31,28,59
2017-07-26 20:59:00,7.176423611111111,4,129,103,232
2017-09-14 09:21:07,48.897453703703704,3,730,436,1166
2017-09-13 11:28:46,48.69456018518518,2,349,228,577
2017-07-25 20:49:02,7.0534027777777775,1,567,894,1461
2017-07-30 19:46:03,11.995648148148149,2,17,16,33
2017-08-02 19:08:13,15.035844907407407,3,161,41,202
2017-07-18 20:44:14,0.7960416666666666,1,2,6,8
2017-07-31 19:38:03,14.149756944444444,3,21,5,26
2017-07-25 13:37:49,8.180069444444445,24,125,69,194
2017-07-18 14:02:49,1.9119907407407408,1,26,21,47
2017-08-12 21:17:45,5.798576388888889,10,392,137,529
2017-07-30 20:23:05,13.999976851851851,2,3754,3579,7333
2017-07-17 20:42:50,0.031967592592592596,1,4,4,8
2017-07-21 09:20:14,4.14755787037037,2,26,12,38
2017-07-26 14:52:37,10.977719907407407,18,948,1119,2067
2017-07-15 22:46:50,0.12611111111111112,1,1,1,2
2017-08-15 10:53:52,30.641886574074075,3,5,5,10
2017-07-18 13:34:00,2.998009259259259,1,78,31,109
2017-07-27 19:15:14,12.632152777777778,3,83,30,113
2017-07-21 06:05:16,7.214502314814815,4,36,12,48
2017-07-15 00:12:57,0.06418981481481481,1,0,20,20
2017-07-15 00:04:43,0.37244212962962964,1,1,1,2
2017-07-14 12:51:00,0.10667824074074074,1,14,10,24
2017-07-15 01:09:13,0.8744675925925925,2,51,496,547
2017-07-13 18:36:17,0.31668981481481484,4,10,5,15
2017-10-15 12:57:16,95.03675925925926,11,53,22,75
2017-07-17 11:08:10,5.968703703703704,17,190,32,222
2017-07-11 12:01:00,0.02684027777777778,1,3,1,4
2017-07-13 19:57:21,2.8642824074074076,1,2,2,4
2017-07-11 00:52:44,0.07925925925925927,1,6,6,12
2017-07-10 20:51:42,1.0344097222222222,2,335,285,620
2017-07-10 04:03:15,0.2361111111111111,1,1,408,409
2017-07-11 03:33:51,1.5331944444444445,2,270,17,287
2017-07-10 09:10:27,1.38375,2,252,265,517
2017-07-11 13:30:03,2.6813425925925927,1,52,156,208
2017-07-23 17:59:30,17.85724537037037,21,1016,1352,2368
2017-07-08 10:12:34,2.532037037037037,8,890,894,1784
2017-07-10 04:08:01,2.299421296296296,7,157,229,386
2017-07-08 10:12:59,2.532326388888889,5,258,241,499
2017-07-09 01:18:08,2.825625,2,481,221,702
2018-04-08 16:41:24,276.7434259259259,11,40141,50733,90874
2017-08-22 10:03:05,47.815,13,653,145,798
2017-07-11 07:52:12,6.279282407407408,1,22,1,23
2017-07-04 08:29:01,0.4650578703703704,1,2,2,4
2017-07-03 09:01:10,0.5006481481481482,1,11,11,22
2017-07-11 08:05:25,8.78380787037037,3,2718,256,2974
2017-07-10 09:34:27,8.607094907407408,2,121,133,254
2017-07-01 21:35:25,0.43297453703703703,2,149,148,297
2017-07-14 10:30:31,13.142824074074074,1,4,0,4
2017-07-01 00:26:22,0.09318287037037037,1,231,188,419
2017-07-01 00:19:51,0.11771990740740741,1,348,388,736
2017-06-30 21:32:32,0.07387731481481481,1,148,117,265
2017-06-30 21:09:09,0.09974537037037037,1,94,79,173
2017-06-30 12:30:44,0.6950578703703704,2,363,285,648
2017-06-29 09:42:05,2.424027777777778,3,744,645,1389
2017-06-26 07:46:53,0.07033564814814815,1,21,41,62
2017-06-25 23:37:46,0.0937037037037037,1,22,26,48
2017-06-26 11:37:59,0.8434259259259259,1,38,54,92
2017-07-10 09:37:59,14.76417824074074,1,8,8,16
2017-06-27 09:56:32,1.881585648148148,9,757,646,1403
2017-07-27 19:31:47,33.21157407407407,2,24,3,27
2017-06-27 13:21:09,3.0617939814814816,1,96,116,212
2017-06-23 15:34:52,0.0014814814814814814,1,53,0,53
2017-06-23 13:14:48,1.1794907407407407,1,3,27,30
2017-06-25 04:26:50,3.3178703703703705,1,15,7,22
2017-06-27 06:09:55,5.677569444444444,4,865,585,1450
2017-06-21 17:28:15,0.9239583333333333,4,17,21,38
2017-06-23 02:12:45,2.6653587962962964,1,1,0,1
2017-06-20 13:00:26,0.9946875,1,20,3,23
2017-06-19 09:33:59,0.3480787037037037,1,8,1,9
2017-06-20 12:04:56,1.7096875,1,1,1,2
2017-07-30 15:33:58,43.684317129629626,6,28846,28226,57072
2017-06-16 15:16:19,0.27001157407407406,1,2,2,4
2017-07-14 07:51:51,28.206481481481482,3,144,11,155
2017-06-16 21:34:53,1.4736689814814814,3,12,20,32
2017-06-21 13:49:33,9.540011574074073,4,596,549,1145
2017-06-27 06:06:58,470.40375,2,50,55,105
2017-06-20 12:09:16,8.543391203703704,1,8,19,27
2018-04-08 16:05:37,1066.7780439814815,7,339,51,390
2017-06-18 09:20:14,6.655671296296297,3,17,379,396
2017-06-26 07:57:17,15.859756944444445,1,5,4,9
2017-07-28 22:24:51,49.31293981481482,5,268,26,294
2017-06-18 09:21:08,20.25957175925926,1,1,0,1
2017-06-09 00:45:17,0.09773148148148147,1,1,4,5
2017-06-20 12:10:42,13.57795138888889,1,1,1,2
2017-06-06 11:22:52,0.034131944444444444,1,1,1,2
2017-06-07 18:44:35,2.4406712962962964,2,92,82,174
2017-06-04 21:59:31,1.7546412037037038,1,40,40,80
2017-06-27 12:07:41,22.88712962962963,4,102,32,134
2017-06-04 09:49:42,0.21261574074074074,1,1,1,2
2017-06-04 09:53:36,1.5055555555555555,1,1,1,2
2017-06-02 14:04:15,0.3518865740740741,1,2,2,4
2017-06-13 14:24:01,13.181666666666667,10,67,52,119
2017-05-30 22:09:37,0.24913194444444445,1,11,0,11
2017-06-06 10:09:02,23.078877314814815,1,113,63,176
2017-05-30 22:12:59,8.086493055555556,1,2,4,6
2017-08-19 07:13:40,89.96045138888888,1,11,21,32
2017-05-22 19:59:45,1.934224537037037,1,46,0,46
2017-06-06 10:43:28,16.886064814814816,1,14,1,15
2017-05-20 14:47:24,0.8187615740740741,2,85,23,108
2017-06-06 10:52:19,19.798877314814813,1,5,4,9
2017-06-06 10:55:19,19.806238425925926,1,2,2,4
2017-05-18 13:51:53,0.9335763888888889,1,2,2,4
2017-05-26 12:29:05,8.084548611111112,1,6,2,8
2017-05-22 20:03:57,8.391261574074074,4,166,27,193
2017-05-14 10:47:23,0.7778587962962963,2,14,3,17
2017-05-12 08:46:47,0.1835763888888889,1,4,4,8
2017-05-12 20:23:13,2.632199074074074,1,135,74,209
2017-05-12 09:21:52,2.7725578703703704,1,14,8,22
2017-05-09 16:11:35,0.10563657407407408,2,10,2,12
2017-05-07 13:35:08,0.7566087962962963,3,36,20,56
2017-05-07 13:36:49,1.1534490740740742,1,71,40,111
2017-05-07 13:37:55,1.5226273148148148,1,2,4,6
2017-05-07 13:44:22,2.7183217592592595,1,15,15,30
2017-05-30 22:05:25,30.311574074074073,5,24,53,77
2018-06-16 23:49:10,409.06516203703706,35,115105,114682,229787
2018-11-06 03:31:21,551.9345717592593,6,93151,70682,163833
2017-05-02 23:34:37,0.0013310185185185185,1,1,1,2
2017-05-03 15:04:38,0.7055671296296296,1,28,0,28
2017-05-07 20:49:39,4.993622685185185,1,20,12,32
2017-05-02 20:04:27,0.03225694444444444,1,23,11,34
2017-05-02 19:37:39,0.029444444444444443,1,30,17,47
2017-05-02 19:41:29,0.12053240740740741,1,2,2,4
2017-05-02 19:42:05,0.22436342592592592,1,10,4,14
2017-05-02 06:46:24,1.5912037037037037,2,3,3,6
2017-04-30 13:43:55,0.049895833333333334,1,41,1,42
2017-04-30 13:44:38,0.22934027777777777,1,1,1,2
2017-05-01 15:31:01,1.6768287037037037,1,3,1,4
2017-04-29 23:13:48,0.029548611111111112,1,1,1,2
2017-05-12 20:26:07,21.080856481481483,8,228,80,308
2018-04-12 22:03:34,348.4570949074074,9,569,80,649
2017-05-02 19:44:03,4.505821759259259,1,1,1,2
2017-08-23 04:40:20,216.24922453703704,6,473,100,573
2017-06-19 12:54:46,55.59180555555555,2,44,19,63
2017-04-30 14:41:20,6.918993055555555,1,18,0,18
2017-05-02 20:55:20,12.199085648148149,1,8,8,16
2017-04-22 06:29:46,2.4352199074074075,3,60,12,72
2017-04-22 06:21:29,3.5296296296296297,1,12,2,14
2017-04-18 13:43:34,0.22576388888888888,1,3,2,5
2017-04-18 01:38:12,0.0687037037037037,1,3,3,6
2017-07-14 08:25:49,87.74413194444445,2,10,1,11
2017-06-29 10:19:24,73.72703703703704,5,57,66,123
2017-04-17 13:20:33,1.877372685185185,1,3,3,6
2017-05-07 14:09:09,22.192962962962962,1,2,1,3
2017-04-14 18:47:26,0.3275578703703704,2,2,2,4
2017-07-09 01:26:08,85.6291550925926,8,116,42,158
2017-04-19 13:37:19,5.649016203703703,3,105,1,106
2017-04-19 08:35:56,5.699814814814815,2,31,3,34
2017-04-19 20:21:41,7.511747685185185,1,7,5,12
2017-08-28 10:43:06,137.96876157407408,22,35385,31205,66590
2017-04-12 08:53:44,0.5340046296296296,1,10,4,14
2017-07-28 18:12:19,107.98685185185185,1,145,3,148
2017-04-10 07:13:09,0.7507291666666667,1,72,0,72
2017-04-22 06:44:39,12.77417824074074,1,20,0,20
2017-06-21 06:54:43,73.37556712962963,2,36,16,52
2017-04-18 14:36:44,11.178599537037037,1,18,1,19
2017-04-10 14:40:27,3.2004282407407407,1,6,3,9
2017-04-19 11:32:46,13.54599537037037,3,34,26,60
2017-06-18 04:13:37,73.42120370370371,3,50,12,62
2017-04-09 12:46:51,4.091550925925926,1,1,0,1
2017-04-09 12:54:34,4.35119212962963,1,36,13,49
2017-04-05 09:22:41,1.477627314814815,3,9,2,11
2017-08-18 14:23:43,136.77278935185186,6,69,13,82
2017-04-09 13:17:31,5.80650462962963,1,16,9,25
2017-04-27 20:20:54,24.18511574074074,9,8421,280,8701
2017-04-04 12:09:53,1.6893981481481481,1,16,0,16
2017-04-18 08:40:23,16.422268518518518,2,57,23,80
2017-04-04 12:06:14,4.640023148148148,2,20,2,22
2017-03-30 20:19:00,0.10203703703703704,1,31,1079,1110
2017-03-30 12:12:14,0.06454861111111111,1,8,8,16
2017-03-29 13:56:28,0.01792824074074074,1,1,1,2
2017-08-19 05:09:47,143.0569675925926,4,25983,12818,38801
2017-03-30 10:27:55,1.3112037037037036,2,4,3,7
2017-03-27 21:08:16,0.09657407407407408,1,11,10,21
2017-03-26 11:58:32,0.20583333333333334,1,23,398,421
2017-03-26 12:01:24,0.4161458333333333,1,32,1,33
2017-03-26 02:32:36,0.2911111111111111,1,31,0,31
2017-03-25 19:17:28,0.07326388888888889,2,114,2,116
2017-03-26 05:12:36,2.3771064814814813,1,22,15,37
2017-03-25 17:57:05,3.0565046296296297,14,262,1,263
2017-03-25 18:01:26,4.051620370370371,4,37,15,52
2017-03-25 17:59:24,4.337835648148148,10,227,0,227
2017-04-19 15:20:12,30.78741898148148,2,60,0,60
2017-03-19 21:59:45,1.1301157407407407,1,72,0,72
2017-03-26 01:31:04,9.48550925925926,1,23,6,29
2017-03-16 18:54:51,0.22641203703703705,1,11,1,12
2017-07-27 20:38:34,133.53034722222222,12,8682,2511,11193
2017-03-21 23:28:19,5.92244212962963,3,22,11,33
2017-03-25 18:10:19,9.84650462962963,8,103,37,140
2017-03-16 12:23:29,0.6534143518518518,2,17,9,26
2017-03-15 20:56:02,0.08288194444444444,1,1,1,2
2017-03-14 22:10:16,0.28378472222222223,1,1,1,2
2017-03-14 07:52:22,0.7263773148148148,1,1,0,1
2017-03-22 21:56:26,68.20777777777778,1,47,20,67
2017-03-21 22:42:43,9.254849537037037,3,82,19,101
2017-03-12 20:47:28,0.929224537037037,1,10,5,15
2017-03-12 10:57:08,0.5937731481481482,2,23,7,30
2017-03-11 06:42:11,1.8323148148148147,1,1,1,2
2017-03-11 19:55:00,1.1832060185185185,1,46,0,46
2017-03-10 02:08:38,0.1414351851851852,4,5,7,12
2017-03-12 11:08:08,2.619537037037037,2,90,96,186
2017-03-10 01:19:28,0.21159722222222221,1,0,2,2
2017-03-09 20:03:15,0.08805555555555555,2,88,1,89
2017-03-09 23:43:20,0.3144212962962963,1,24,5,29
2017-03-09 05:46:10,0.0959375,2,78,13,91
2017-03-11 19:33:22,2.738252314814815,3,27,11,38
2017-03-08 09:17:19,0.32525462962962964,1,87,90,177
2017-03-07 19:42:24,0.04957175925925926,2,38,1,39
2017-03-07 21:04:54,0.17056712962962964,1,2,1,3
2017-08-12 21:46:44,162.90186342592594,114,17737,9971,27708
2018-02-24 17:13:59,359.3854050925926,1,885,2,887
2017-03-04 18:30:42,2.526597222222222,1,4,17,21
2017-12-04 12:26:34,278.1271990740741,4,145,49,194
2017-03-04 18:32:08,3.9080555555555554,1,1,1,2
2017-02-28 23:21:56,0.14907407407407408,1,1,1,2
2017-03-01 13:20:10,1.4695023148148147,1,19,0,19
2017-03-25 18:19:49,26.787372685185186,3,74,15,89
2017-02-26 19:03:09,0.17030092592592594,1,2,2,4
2017-02-25 08:43:11,0.277337962962963,1,5,3,8
2017-02-25 09:04:56,0.3319328703703704,1,1,1,2
2017-02-26 14:04:41,1.8483449074074074,1,3,3,6
2017-02-24 15:23:46,-0.06900462962962962,2,5,2,7
2017-02-26 22:42:52,3.0179050925925925,6,57,40,97
2017-02-23 19:13:10,7.237615740740741,5,22,10,32
2017-02-24 13:47:34,0.9199074074074074,1,2,1,3
2017-03-12 11:10:00,16.904305555555556,2,2,2,4
2017-02-22 23:39:53,0.3502777777777778,1,4,0,4
2017-03-21 22:50:52,7.259270833333333,3,88,9,97
2017-03-12 10:54:49,18.613333333333333,2,93,65,158
2017-02-26 14:39:52,4.855659722222223,1,8,4,12
2017-02-18 12:57:41,1.1857754629629629,1,7,7,14
2017-02-18 13:20:49,0.21258101851851852,1,5,3,8
2017-02-18 15:01:28,0.5916666666666667,2,92,54,146
2017-02-18 07:57:15,1.0277662037037036,1,0,7,7
2017-08-21 11:36:20,185.20150462962962,3,132,51,183
2017-02-17 23:04:33,1.2315046296296297,2,13,13,26
2017-02-16 19:21:37,0.8852083333333334,1,21,12,33
2017-02-16 21:34:22,0.4830671296296296,1,2,2,4
2017-02-24 13:40:00,8.431747685185185,5,58,15,73
2017-02-16 07:41:19,1.3836342592592592,1,1,1,2
2017-02-15 09:29:49,1.5004976851851852,1,397,394,791
2017-02-14 19:07:09,0.9523611111111111,2,21,16,37
2017-02-16 09:53:07,2.634189814814815,1,59,41,100
2017-02-14 09:32:50,0.6436111111111111,1,4,1,5
2017-02-13 19:25:58,0.5529976851851852,1,3,0,3
2017-02-15 17:32:36,2.648229166666667,2,89,25,114
2017-02-15 19:48:17,3.0514236111111113,7,540,19,559
2017-02-12 12:17:38,0.9007291666666667,2,20,6,26
2017-02-16 09:39:00,5.064837962962963,1,23,0,23
2017-02-18 06:23:56,6.940358796296296,1,42,19,61
2017-03-26 12:09:54,43.40100694444445,5,174,35,209
2017-02-15 16:39:27,4.732268518518518,1,18,0,18
2017-02-10 22:11:59,0.31277777777777777,1,2,1,3
2017-02-09 15:44:44,0.2385648148148148,1,2,2,4
2017-02-09 10:08:17,0.026261574074074073,1,2,2,4
2017-02-08 17:07:41,0.05078703703703704,1,1,1,2
2017-02-10 07:45:49,1.752650462962963,2,2,2,4
2017-02-07 21:51:07,0.8153703703703704,2,40,33,73
2017-02-09 13:17:16,3.388761574074074,1,29,3,32
2018-03-09 17:26:04,397.96099537037037,21,95109,109854,204963
2017-02-16 09:16:11,13.898877314814815,1,1,1,2
2017-02-08 20:56:51,7.038807870370371,1,2,2,4
2017-02-01 19:21:30,0.05033564814814815,1,1,1,2
2017-02-09 22:32:10,8.27648148148148,1,1,1,2
2017-02-09 22:43:10,9.014444444444445,1,32,33,65
2017-02-14 22:20:35,18.418125,17,322,167,489
2017-01-25 21:38:56,4.2113657407407405,3,23,5,28
2017-01-21 15:59:24,0.9908796296296296,2,5,9,14
2017-02-09 22:37:20,20.559247685185184,2,3,3,6
2017-01-19 23:09:12,0.0038425925925925928,1,1,1,2
2017-01-19 20:13:23,0.23163194444444443,1,18,20,38
2017-01-19 14:39:32,268.80042824074076,2,24,13,37
2017-02-15 17:11:49,29.833587962962962,1,4,2,6
2017-01-17 09:29:42,0.5370254629629629,1,3,0,3
2017-01-15 13:24:51,0.1296064814814815,2,3,25,28
2017-01-15 16:56:43,3.486412037037037,1,19,6,25
2017-01-16 10:26:51,4.604305555555555,2,6,3,9
2017-08-03 07:53:58,207.28988425925925,3,435,42,477
2017-01-16 09:11:25,5.565486111111111,2,95,6,101
2017-01-17 09:47:12,7.625196759259259,3,296,71,367
2017-01-18 07:03:45,8.696782407407408,3,30,7,37
2017-01-17 09:25:21,7.811354166666667,1,16,10,26
2017-01-19 11:43:46,10.158946759259258,1,38,4,42
2017-02-16 08:58:18,130.52688657407407,30,1339,1227,2566
2017-01-15 17:02:53,6.786331018518519,1,247,1,248
2017-01-09 10:10:01,0.666724537037037,1,30,15,45
2017-01-08 16:46:24,0.4660532407407407,1,9,3,12
2017-01-08 17:29:28,2.1561805555555558,1,6,5,11
2017-01-07 20:07:45,0.2247800925925926,1,18,0,18
2017-01-08 15:31:43,1.7477199074074075,2,55,29,84
2017-01-08 17:34:59,1.893761574074074,1,8,1,9
2017-01-08 15:29:28,2.196712962962963,1,26,6,32
2017-01-08 15:32:50,406.63832175925927,2,15,12,27
2017-01-04 23:30:58,0.02060185185185185,1,24,6,30
2017-03-28 12:06:51,113.61079861111111,1,959,18,977
2017-01-03 22:47:25,0.682025462962963,3,6,4,10
2017-01-03 05:35:32,0.015196759259259259,1,6,0,6
2017-01-03 05:31:35,0.5506365740740741,1,4,3,7
2017-01-03 04:41:00,0.531400462962963,1,15,1,16
2017-01-08 17:05:26,6.522048611111111,3,931,479,1410
2017-01-15 17:05:07,14.829722222222221,2,73,1,74
2017-01-03 07:26:41,2.8512731481481484,2,23,0,23
2016-12-31 07:55:30,0.38,1,6,0,6
2016-12-28 20:35:04,0.1490625,1,1,0,1
2016-12-28 20:54:44,0.8273379629629629,1,13,1,14
2016-12-27 12:07:05,0.10560185185185185,1,53,38,91
2016-12-27 12:11:56,0.24739583333333334,1,2,2,4
2016-12-26 12:43:16,0.9058449074074074,1,1,1,2
2016-12-26 12:44:09,6.576365740740741,2,27,2,29
2016-12-26 20:05:07,2.4396180555555556,2,2,1,3
2016-12-26 20:08:53,4.541296296296296,1,10,0,10
2017-01-08 17:28:35,18.046631944444446,3,43,10,53
2016-12-21 20:48:33,2.003645833333333,1,1,1,2
2016-12-18 22:04:56,0.959375,2,4,1,5
2016-12-18 21:10:51,1.0692592592592594,2,91,85,176
2016-12-18 22:31:55,1.1432523148148148,6,30,5,35
2016-12-18 21:21:07,2.3129976851851852,1,17,1,18
2016-12-18 21:09:18,2.3630555555555555,1,1,1,2
2016-12-18 21:17:45,3.9181944444444445,1,51,50,101
2017-01-03 17:27:19,20.141064814814815,1,3,310,313
2016-12-21 20:50:01,7.4003125,1,2,2,4
2017-07-19 19:17:16,218.01744212962964,8,136,54,190
2017-02-10 08:16:32,59.744375,5,82,20,102
2016-12-18 22:28:43,7.192025462962963,1,23,5,28
2016-12-18 21:22:41,8.395,3,54,3,57
2017-01-03 05:19:48,26.38361111111111,1,4,6,10
2016-12-18 21:28:17,11.233865740740741,1,7,7,14
2016-12-07 18:15:43,0.4870138888888889,3,13,7,20
2016-12-06 07:19:36,0.5502662037037037,1,1,1,2
2016-12-21 21:06:37,19.36486111111111,11,43,21,64
2016-11-30 19:54:18,0.9851273148148149,1,9,0,9
2016-11-27 15:05:22,0.36128472222222224,1,1,1,2
2016-12-18 21:35:53,23.481006944444445,1,209,28,237
2016-11-26 05:12:32,1.5589814814814815,1,16,1,17
2016-12-06 15:57:48,13.616851851851852,2,233,42,275
2016-11-24 06:03:22,0.4856828703703704,1,14,1,15
2016-11-24 06:08:22,0.6311342592592593,1,1,1,2
2016-11-27 18:18:58,5.140729166666667,10,324,31,355
2016-11-27 04:30:39,6.355208333333334,4,112,71,183
2016-11-20 00:35:33,0.08190972222222222,2,10,17,27
2017-01-25 15:57:42,67.02002314814816,5,454,78,532
2017-01-19 11:46:08,60.85201388888889,3,81,6,87
2017-07-30 15:10:04,181.92650462962962,4,5669,2482,8151
2016-11-19 17:19:01,0.5741319444444445,1,51,0,51
2016-11-17 11:35:11,0.08391203703703703,2,13,14,27
2016-11-17 11:24:05,0.08146990740740741,1,30,34,64
2017-01-03 05:33:57,46.90677083333333,1,56,0,56
2016-11-17 06:02:56,0.6175578703703704,1,12,1,13
2016-11-16 07:32:40,0.4830671296296296,1,9,1,10
2016-11-15 09:40:35,0.003923611111111111,1,2,0,2
2016-11-16 07:38:37,1.0562731481481482,1,6,6,12
2016-11-19 17:08:20,5.862372685185186,5,399,329,728
2016-11-16 03:12:26,2.665138888888889,1,160,7,167
2016-11-15 07:04:59,3.3230208333333335,1,4,4,8
2016-11-11 08:29:25,0.49971064814814814,1,6,4,10
2016-11-11 07:39:54,0.6742361111111111,1,33,32,65
2017-01-08 16:09:20,59.03483796296296,10,985,299,1284
2016-11-09 20:01:55,1.485150462962963,1,9,7,16
2017-06-18 09:02:34,222.39318287037037,1,116,21,137
2016-12-06 10:00:39,28.91920138888889,7,174,93,267
2016-11-10 09:26:08,3.081701388888889,1,7,0,7
2016-12-30 09:47:31,54.544699074074074,25,841,344,1185
2016-12-07 00:43:38,31.29994212962963,3,86,39,125
2017-01-16 20:15:54,73.07203703703703,6,285,114,399
2016-11-16 07:28:18,12.539826388888889,5,414,364,778
2016-11-05 12:30:57,1.6857754629629629,1,1,1,2
2017-02-12 16:41:34,102.00163194444444,5,581,134,715
2016-11-02 12:39:34,0.04722222222222222,1,1,1,2
2017-01-03 07:12:21,62.382719907407406,3,3314,1304,4618
2016-11-01 15:16:57,0.16771990740740741,3,4,39,43
2016-11-01 09:36:31,0.22030092592592593,4,210,72,282
2016-11-01 09:37:12,1.7311342592592593,2,123,269,392
2016-10-31 19:18:00,1.2575,1,21,4,25
2016-10-30 09:39:46,0.053078703703703704,1,1,0,1
2016-11-15 08:20:28,16.18986111111111,1,32,3,35
2016-10-30 08:35:15,0.3955324074074074,2,70,303,373
2016-10-30 08:31:08,28.16701388888889,5,44,20,64
2016-10-30 08:21:52,0.781412037037037,1,39,4,43
2016-10-28 22:21:40,0.08611111111111111,1,1,1,2
2016-10-30 01:34:23,1.9219907407407408,1,12,12,24
2016-10-28 18:46:14,0.8786111111111111,1,8,11,19
2016-10-29 12:49:16,1.6525231481481482,2,13,56,69
2016-11-01 09:51:30,4.612858796296297,1,31,4,35
2016-10-27 07:31:49,0.7161574074074074,1,12,0,12
2016-11-01 17:41:46,7.028981481481481,9,126,55,181
2016-10-29 09:20:07,4.158530092592593,1,6,1,7
2016-10-24 20:47:16,1.2695717592592592,1,20,0,20
2016-10-23 18:38:19,0.21491898148148147,2,40,3,43
2016-10-29 10:27:41,6.513055555555556,1,16,51,67
2016-10-23 18:40:43,1.3250810185185184,1,1427,1416,2843
2016-10-22 10:13:37,0.09986111111111111,3,28,17,45
2016-10-22 07:50:42,0.09137731481481481,1,40,2,42
2016-10-22 09:32:07,0.4645949074074074,1,2,2,4
2017-02-18 19:55:58,119.90728009259259,1,33,11,44
2017-02-18 14:51:01,119.84643518518519,2,39,12,51
2016-10-22 07:04:53,0.6513078703703704,1,14,1,15
2016-10-22 16:16:13,1.1287847222222223,3,20,2,22
2016-10-21 18:32:56,0.20900462962962962,1,19,18,37
2016-11-15 08:02:59,25.259097222222223,1,68,21,89
2016-11-01 17:25:40,16.796863425925928,5,21,5,26
2016-10-24 13:12:32,9.08837962962963,2,44,3,47
2016-10-20 19:27:51,6.236805555555556,2,55,19,74
2016-11-01 17:46:30,37.91665509259259,10,13848,142096,155944
2016-10-20 19:32:50,7.6403125,1,9,2,11
2016-11-05 15:15:19,23.69480324074074,3,47,26,73
2016-10-12 20:05:06,0.1441087962962963,1,0,96,96
2016-10-12 17:03:05,0.3650115740740741,1,2,1,3
2016-10-11 13:43:07,0.15579861111111112,1,1,1,2
2016-10-19 21:21:25,9.53357638888889,1,18,1,19
2016-10-08 21:49:56,15.923784722222223,2,4,2,6
2016-10-10 09:24:55,19.51642361111111,1,22,0,22
2017-02-16 08:58:31,130.52703703703705,5,80,14,94
2016-10-08 17:46:42,0.019537037037037037,1,1,1,2
2016-10-08 17:49:06,0.597199074074074,5,409,308,717
2016-10-12 20:15:41,5.113900462962963,8,59,51,110
2017-01-03 02:25:13,88.49253472222222,6,16186,6251,22437
2016-10-13 18:26:05,8.90642361111111,20,1168,267,1435
2016-10-03 20:09:44,0.6147569444444444,1,41,0,41
2016-10-04 09:02:29,1.484212962962963,1,18,1,19
2016-10-03 20:12:33,1.2061226851851852,6,83,33,116
2016-12-30 06:30:00,88.56571759259259,20,479,186,665
2016-10-02 16:45:23,0.04137731481481482,1,176,1,177
2016-10-03 16:24:23,1.0596875,2,5,5,10
2016-10-02 12:16:33,0.528425925925926,2,18,50,68
2016-10-08 22:07:15,7.137476851851852,3,332,294,626
2016-11-15 14:48:10,45.1690625,3,32,22,54
2016-10-03 04:37:43,1.7860532407407408,2,30,25,55
2016-10-07 08:51:00,6.003865740740741,2,122,6,128
2016-11-03 08:45:43,33.074872685185184,4,8,5,13
2016-10-01 02:33:37,0.1638888888888889,1,2,2,4
2016-09-30 21:00:43,0.11934027777777778,1,1,1,2
2016-09-30 17:25:55,0.5450347222222223,1,6,0,6
2016-09-30 02:20:54,0.041122685185185186,1,2,2,4
2016-09-30 17:20:14,0.9177777777777778,2,8,3,11
2016-10-06 18:33:54,6.922395833333334,4,103,61,164
2016-09-28 07:35:27,0.17993055555555557,1,16,5,21
2016-09-29 17:26:16,3.0508796296296294,2,1005,65,1070
2016-12-01 06:22:03,62.13282407407407,2,19,10,29
2016-09-30 17:30:51,5.346203703703703,2,115,62,177
2016-09-25 07:41:30,0.003159722222222222,1,1,1,2
2016-10-13 09:55:21,19.870289351851852,16,1683,887,2570
2016-09-23 08:20:12,0.4558217592592593,1,3,0,3
2016-09-22 18:56:31,0.1369212962962963,2,4,3,7
2016-09-22 19:51:21,0.4524537037037037,1,2,2,4
2016-09-22 09:30:50,0.028958333333333332,1,5,0,5
2016-09-22 09:30:01,0.3845949074074074,1,4,5,9
2016-10-12 19:11:51,22.088564814814816,1,56,117,173
2016-09-28 09:39:52,7.730555555555555,1,7,1,8
2016-09-21 19:57:45,1.2486689814814815,1,3,3,6
2016-09-20 22:20:24,0.8461111111111111,1,1,1,2
2016-09-19 19:20:03,5.067256944444445,1,50,0,50
2016-10-29 09:50:56,39.723368055555554,2,6,1,7
2016-09-18 08:44:58,0.12275462962962963,1,16,12,28
2016-10-02 12:11:18,14.29758101851852,2,2,137078,137080
2016-09-18 01:11:16,0.23280092592592594,1,1,1,2
2018-04-08 18:00:48,568.0630787037037,1,13,0,13
2016-09-17 12:37:08,0.23094907407407408,1,4,3,7
2016-09-16 22:24:43,0.2951388888888889,1,9,3,12
2016-09-16 10:19:33,0.5871759259259259,1,1,1,2
2016-09-18 14:47:45,2.885289351851852,3,203,105,308
2016-09-15 17:05:51,0.10444444444444445,1,3,3,6
2016-10-23 09:21:54,41.65103009259259,7,53,12,65
2016-09-14 21:12:00,0.0487037037037037,1,1,0,1
2016-09-19 20:50:45,6.733761574074074,20,717,493,1210
2016-09-12 18:11:26,0.7641666666666667,1,2,1,3
2016-09-15 19:19:48,3.9739699074074073,2,207,41,248
2016-09-19 08:34:10,8.321909722222221,1,7,7,14
2016-10-11 18:38:04,30.9178125,1,7,3,10
2016-10-07 11:00:46,29.363738425925927,1,19,3,22
2016-09-09 06:51:04,4.363425925925926,1,14,4,18
2016-09-13 10:47:57,8.83605324074074,3,14,57,71
2016-09-06 20:20:54,2.3173958333333333,1,16,2,18
2016-09-12 10:09:56,46.44114583333333,2,20,4,24
2016-09-16 19:59:26,13.009236111111111,4,464,68,532
2016-09-03 16:52:36,0.0784375,4,77,54,131
2016-09-03 02:05:02,1.2808680555555556,1,58,58,116
2016-09-03 21:30:27,2.138275462962963,1,6,0,6
2016-09-06 15:16:08,5.558275462962963,3,63,7,70
2016-09-01 18:05:07,1.7490162037037038,1,5,1,6
2016-08-30 13:49:39,0.6242245370370371,1,8,2,10
2016-09-17 17:48:24,21.81818287037037,1,2,2,4
2016-09-30 16:20:39,35.654467592592596,14,115,64,179
2017-01-04 22:07:31,136.28563657407406,32,4898,3137,8035
2016-09-03 16:41:41,11.986087962962962,1,12,1,13
2016-08-24 13:59:39,2.7982060185185187,2,7,0,7
2016-08-21 16:05:24,1.1495949074074074,1,23,0,23
2016-08-20 10:34:10,0.799212962962963,1,253,134,387
2016-11-03 15:59:17,76.94483796296296,3,305,21,326
2016-09-28 09:33:00,41.52211805555555,4,133,132,265
2016-08-20 13:26:10,2.716226851851852,1,45,4,49
2016-08-30 13:47:54,13.208564814814816,1,147,32,179
2016-09-01 08:39:56,15.51568287037037,1,16,5,21
2016-08-16 08:47:27,3.7121412037037036,3,5,5,10
2017-01-21 00:12:16,168.87766203703703,4,55,35,90
2016-08-13 03:41:10,2.4310532407407406,1,20,18,38
2017-03-17 21:51:32,219.19414351851853,1,3,14,17
2016-08-10 19:07:55,0.17880787037037038,1,15,17,32
2016-08-12 09:03:02,2.416400462962963,1,2,2,4
2016-08-12 20:15:53,3.499953703703704,1,6,0,6
2016-08-19 16:21:56,11.038738425925926,2,150,39,189
2016-08-10 16:44:42,1.7477430555555555,5,369,48,417
2016-08-08 07:30:28,0.3171643518518519,1,7,0,7
2016-08-07 21:10:00,0.03232638888888889,1,2,0,2
2016-08-20 13:27:04,12.791875,1,6,1,7
2016-08-06 09:27:24,1.2252430555555556,3,23,4,27
2016-09-18 05:20:10,44.49960648148148,1,108,126,234
2016-08-05 15:49:01,0.9227430555555556,1,2,1,3
2016-08-04 18:44:34,0.2615046296296296,2,3,0,3
2016-08-20 13:29:37,16.35190972222222,1,10,9,19
2016-08-09 00:27:28,4.843634259259259,3,36,6,42
2016-08-15 16:58:18,26.704386574074075,1,29,16,45
2016-10-27 18:34:49,86.60583333333334,41,1004,425,1429
2016-08-02 10:13:50,0.6110300925925926,1,1,1,2
2016-08-06 09:30:38,4.971643518518518,1,19,0,19
2016-08-06 09:34:07,6.6570833333333335,7,2099,1518,3617
2016-07-28 23:15:14,0.053599537037037036,1,5,3,8
2016-08-04 14:19:41,6.773599537037037,4,40,15,55
2016-07-31 10:07:24,3.0003703703703706,1,3,0,3
2016-07-26 17:37:04,0.8943634259259259,1,18,3,21
2016-08-15 16:48:17,3.294467592592593,2,21,36,57
2016-08-04 17:00:00,12.642962962962963,6,264,286,550
2016-07-31 10:26:09,10.793402777777779,5,515,81,596
2016-08-01 18:07:01,9.938888888888888,1,20,5,25
2016-09-04 23:31:31,45.331319444444446,1,361,4,365
2016-08-07 20:30:44,16.717280092592592,3,82,31,113
2016-07-22 06:31:37,0.2136574074074074,1,2,2,4
2016-08-20 13:33:21,32.51056712962963,5,354,289,643
2016-08-31 16:44:35,0.3091435185185185,1,161,0,161
2016-07-30 13:03:52,11.490092592592593,4,298,255,553
2016-07-31 11:17:29,12.835104166666667,2,50,15,65
2016-10-21 13:23:04,104.62658564814815,17,759,189,948
2016-07-13 22:11:26,2.079976851851852,1,2,0,2
2016-07-11 19:41:14,0.0694675925925926,1,5,2,7
2016-07-11 20:03:27,2.7228125,1,104,2,106
2016-07-08 18:38:57,0.3202199074074074,1,1,1,2
2016-07-06 09:00:32,0.17403935185185185,1,1,1,2
2016-07-06 09:08:44,0.9692824074074075,1,9,1,10
2016-07-07 18:01:45,2.956516203703704,1,35,6,41
2016-07-05 20:40:58,2.3651851851851853,1,16,15,31
2016-07-05 20:35:20,859.2256018518518,3,72,30,102
2016-07-02 20:07:17,1.3503935185185185,2,17,2,19
2016-07-06 09:02:02,5.942800925925926,2,35,4,39
2016-07-01 13:27:00,1.4067824074074073,1,3,3,6
2016-06-30 08:28:25,0.4222222222222222,1,12,7,19
2016-06-30 07:52:33,0.35711805555555554,1,50,38,88
2016-06-30 07:21:44,0.4454166666666667,1,73,66,139
2016-07-17 20:57:04,539.8207407407407,4,447,60,507
2016-06-29 20:32:05,1.1525347222222222,1,1,1,2
2017-04-21 16:33:57,297.17065972222224,94,5796,2228,8024
2016-06-27 12:29:43,0.06763888888888889,1,1,1,2
2016-08-02 11:53:36,198.99594907407408,2,41,6,47
2016-10-08 22:02:37,104.0571875,5,347,92,439
2016-06-26 13:33:55,0.38265046296296296,1,1,1,2
2016-06-27 11:21:51,2.236273148148148,2,131,81,212
2017-01-21 15:57:36,215.49712962962963,1,15,6,21
2016-08-07 15:07:41,56.28542824074074,7,1835,199,2034
2016-06-23 08:15:19,0.35913194444444446,1,2,2,4
2016-06-23 06:09:35,0.3278240740740741,1,6,6,12
2016-06-25 10:33:15,3.444236111111111,1,24,3,27
2016-09-17 21:45:50,87.27635416666666,1,10,13,23
2016-06-22 14:30:36,0.17083333333333334,1,1,1,2
2016-06-23 06:10:40,1.1131365740740742,1,12,12,24
2016-06-21 21:00:31,0.16039351851851852,1,10,1,11
2016-09-29 17:31:59,100.60078703703704,1,657,649,1306
2016-06-30 08:01:34,8.753125,1,1,1,2
2016-07-20 20:01:35,29.929236111111113,1,35,16,51
2016-06-20 12:30:34,0.013055555555555556,3,497,7,504
2016-06-20 16:35:29,0.2732175925925926,1,1,1,2
2016-06-19 17:44:10,0.8836574074074074,2,15,2,17
2016-06-17 19:01:18,0.0346875,2,4,0,4
2016-06-17 18:17:09,0.16295138888888888,1,25,12,37
2016-06-17 10:29:28,0.03501157407407408,1,0,2,2
2016-07-19 16:01:35,32.58005787037037,6,145,251,396
2016-06-20 11:15:18,3.575636574074074,1,12,0,12
2016-06-17 10:21:41,0.564837962962963,1,156,22,178
2016-06-19 23:28:52,4.143148148148148,1,202,70,272
2016-06-27 11:55:42,7.941134259259259,2,33,59,92
2016-06-16 16:51:17,1.0920023148148148,3,14,5,19
2016-12-06 07:17:34,174.0298611111111,4,16,6,22
2016-06-28 19:36:42,13.626354166666667,2,411,52,463
2016-06-14 23:51:50,0.09086805555555555,2,11,7,18
2016-06-14 20:19:34,0.07657407407407407,3,20,13,33
2016-06-14 05:51:27,0.31582175925925926,1,3,3,6
2016-07-13 22:08:53,30.179594907407406,7,111,43,154
2016-06-17 08:04:16,3.547523148148148,1,11,11,22
2016-06-13 21:45:50,0.3020717592592593,4,24,4,28
2016-06-18 19:34:14,6.142511574074074,1,30,7,37
2016-06-13 19:17:47,1.1658333333333333,1,45,1,46
2016-06-14 20:28:05,2.250960648148148,1,0,2,2
2016-06-12 14:12:33,0.13252314814814814,1,21,7,28
2016-06-12 12:41:18,0.0728587962962963,1,8,8,16
2016-06-12 10:46:12,0.02087962962962963,1,2,2,4
2016-06-11 20:26:57,0.16778935185185184,1,11,11,22
2016-06-17 08:42:53,5.746875,1,129,56,185
2016-06-11 10:19:15,0.3277083333333333,1,8,1,9
2016-06-15 06:41:12,4.352048611111111,4,49,21,70
2016-06-10 22:50:57,0.13194444444444445,1,13,3,16
2016-06-10 22:49:27,0.1734375,1,29,1,30
2016-06-10 23:21:06,0.2278125,1,19,2,21
2016-06-10 22:47:08,0.22591435185185185,1,33,2,35
2016-06-09 21:54:22,0.4862268518518518,1,17,0,17
2016-06-15 06:44:44,6.672106481481482,1,19,1,20
2016-06-17 08:01:17,11.675914351851851,3,206,86,292
2016-06-12 07:26:51,4.437083333333334,1,17,0,17
2016-06-18 11:17:36,11.752800925925927,2,103,61,164
2016-06-07 14:42:03,0.026875,1,2,1,3
2016-06-07 21:06:22,0.7432060185185185,2,51,9,60
2016-06-11 14:04:57,4.708773148148148,2,76,16,92
2016-06-17 08:41:19,11.769467592592592,6,242,47,289
2016-06-06 10:37:35,0.8628009259259259,1,27,10,37
2016-06-05 12:16:46,0.8985300925925926,3,62,49,111
2016-06-05 12:04:13,1.4498032407407409,3,58,56,114
2016-06-04 16:25:59,5.383298611111111,1,1,1,2
2016-07-21 19:21:38,53.89685185185185,19,7305,2417,9722
2016-06-20 12:05:10,23.639027777777777,2,75,13,88
2016-05-29 07:48:10,26.69152777777778,1,16,0,16
2016-06-13 19:48:31,21.310462962962962,10,318,138,456
2016-06-05 12:27:02,13.640277777777778,1,2,2,4
2016-05-23 05:49:41,3.9915046296296297,1,27,25,52
2016-05-24 14:39:54,0.9750810185185185,1,40,1,41
2016-06-04 13:13:32,151.9214699074074,17,745,426,1171
2016-05-19 18:54:30,0.10289351851851852,1,1,1,2
2016-05-19 18:53:30,0.11703703703703704,1,8,0,8
2016-05-21 14:34:40,2.4069212962962965,1,16,7,23
2016-05-18 19:11:28,0.23186342592592593,1,1,1,2
2016-05-18 05:47:46,0.22144675925925925,1,22,9,31
2016-05-21 14:35:12,3.641412037037037,1,5,0,5
2016-07-12 14:05:52,56.45533564814815,1,13,2,15
2016-05-18 07:29:04,2.474074074074074,1,18,14,32
2016-06-19 11:20:03,34.77494212962963,1,412,5,417
2016-05-15 07:59:36,0.02802083333333333,1,1,1,2
2016-05-29 11:24:56,15.228425925925926,2,13,3,16
2016-05-12 08:57:58,0.3662037037037037,1,14,14,28
2016-05-10 14:23:54,0.004895833333333334,1,1,1,2
2016-05-13 02:26:55,3.994409722222222,3,79,33,112
2016-06-05 12:40:25,28.44462962962963,1,1525,478,2003
2016-05-07 17:48:15,0.07414351851851853,2,531,531,1062
2016-05-12 08:36:23,5.066157407407408,5,77,11,88
2016-05-06 18:15:32,0.049305555555555554,1,1,7,8
2016-05-19 15:46:41,14.899699074074075,1,49,0,49
2016-05-05 18:41:03,0.9814930555555555,2,9,2,11
2016-06-17 19:54:52,46.20143518518518,2,8,3,11
2016-05-07 18:11:24,6.110555555555556,4,669,171,840
2016-05-04 19:42:54,3.093599537037037,4,175,168,343
2016-05-05 18:41:54,4.2403356481481485,1,2,0,2
2016-05-01 13:14:17,0.0503587962962963,1,4,2,6
2016-04-30 19:10:29,0.05708333333333333,1,4,8,12
2016-06-06 09:35:14,36.88519675925926,2,35,6,41
2016-04-30 13:12:21,0.7104976851851852,3,44,18,62
2016-04-27 15:09:02,0.0076851851851851855,1,1,1,2
2016-05-05 06:52:10,10.188865740740741,1,90,42,132
2016-04-24 13:10:59,0.4152430555555556,1,2,1,3
2016-04-25 20:07:43,2.2707407407407407,3,66,67,133
2016-04-23 12:52:39,1.8783796296296296,1,2,2,4
2016-04-23 12:54:05,1.8876388888888889,1,3,3,6
2016-04-22 15:11:04,1.1993865740740741,1,7,4,11
2016-04-23 18:17:22,2.351875,1,18,1,19
2016-04-21 05:05:18,0.27435185185185185,1,4,2,6
2016-04-21 05:56:12,0.49148148148148146,1,1,2,3
2016-04-23 19:03:38,4.683599537037037,4,760,157,917
2016-04-19 18:30:15,1.1525578703703703,1,62,38,100
2016-04-24 04:16:55,8.045462962962963,2,12,12,24
2016-12-21 21:05:18,253.11097222222222,1,465,62,527
2017-02-07 17:56:42,334.715625,11,1426,528,1954
2016-04-10 12:57:26,0.41096064814814814,1,12,27,39
2016-04-09 22:31:38,0.009571759259259259,1,6,0,6
2016-04-09 20:51:36,0.2526388888888889,2,309,51,360
2016-04-07 12:36:44,0.018252314814814815,1,1,1,2
2016-04-06 12:13:29,0.060300925925925924,1,4,2,6
2016-04-05 19:03:24,0.26415509259259257,1,9,0,9
2016-04-05 12:52:44,0.04092592592592593,1,1,0,1
2016-04-05 19:06:57,1.4947800925925927,2,66,81,147
2016-04-09 11:05:18,5.303738425925926,12,232,53,285
2016-04-05 12:54:01,1.4090625,1,13,1,14
2016-05-08 17:33:20,35.1028125,23,2223,511,2734
2016-06-05 12:27:28,63.70729166666667,3,78,37,115
2016-04-05 12:58:30,3.9688078703703704,1,10,4,14
2016-10-30 09:00:30,502.96105324074074,2,52,2,54
2016-04-09 10:59:11,5.758831018518518,4,167,48,215
2016-03-29 18:56:48,0.5836342592592593,1,64,14,78
2016-03-28 14:40:20,0.005115740740740741,1,6,6,12
2016-03-28 08:23:58,0.4243865740740741,1,3,1,4
2016-05-01 00:38:26,36.97400462962963,1,731,233,964
2016-03-27 03:50:17,1.0771875,2,32,8,40
2016-03-27 19:55:56,3.8114583333333334,1,77,44,121
2016-03-25 22:00:53,2.7913657407407406,6,98,70,168
2016-03-28 09:10:11,5.540821759259259,1,189,25,214
2016-03-23 15:39:23,1.5174189814814816,2,61,26,87
2016-03-22 15:32:36,0.5575694444444445,1,2,2,4
2016-06-04 12:56:27,392.6144444444444,4,435,151,586
2016-03-28 07:20:17,8.477627314814814,2,76,19,95
2016-03-28 07:22:10,9.184513888888889,1,24,19,43
2016-06-19 12:47:58,0.25971064814814815,4,104,12,116
2016-03-28 07:26:53,11.637673611111111,1,32,30,62
2016-04-08 17:02:49,26.778657407407408,2,140,38,178
2016-03-14 18:37:05,0.0344212962962963,1,1,1,2
2016-04-26 12:07:25,42.843969907407406,6,35,42,77
2016-03-28 08:44:07,146.96901620370372,3,164,72,236
2016-04-07 20:52:41,193.89465277777776,7,51052,20927,71979
2016-03-13 14:44:36,1.0283680555555557,1,6,6,12
2016-03-11 21:52:29,0.06564814814814815,1,9,1,10
2016-04-06 12:18:46,26.754560185185184,3,47,46,93
2016-03-11 01:55:46,0.28251157407407407,1,15,14,29
2016-03-10 22:54:29,0.47324074074074074,1,23,23,46
2016-03-09 19:44:16,0.285625,1,5,3,8
2016-03-28 07:41:49,20.290775462962962,2,73,94,167
2016-03-08 23:04:58,0.04636574074074074,1,2,1,3
2016-03-28 17:21:43,20.020081018518518,2,118,134,252
2016-03-08 17:28:20,0.06959490740740741,1,9,0,9
2016-03-08 15:06:05,0.09444444444444444,1,1,1,2
2016-04-07 20:54:45,30.34369212962963,1,1,1,2
2016-03-21 08:23:00,13.40613425925926,6,109,69,178
2016-03-27 23:56:48,20.25267361111111,1,68,15,83
2016-03-07 11:45:10,0.4284837962962963,2,10,1,11
2016-03-06 22:23:20,0.03621527777777778,1,1,1,2
2016-03-28 08:16:49,22.194988425925924,10,1100,558,1658
2016-03-08 17:31:59,2.149837962962963,1,13,2,15
2016-03-07 14:34:49,1.8731481481481482,1,4,1,5
2016-04-26 23:09:32,53.16072916666667,1,141,33,174
2016-04-06 12:21:11,32.64980324074074,4,14315,14053,28368
2016-03-03 13:31:06,0.0011921296296296296,1,12,1,13
2016-03-03 15:37:18,0.35141203703703705,1,0,3,3
2016-03-03 13:52:29,0.5390162037037037,1,7,1,8
2016-03-03 08:16:50,1.299074074074074,2,23,42,65
2016-03-01 17:14:32,0.0022569444444444442,1,2,2,4
2017-08-24 10:40:25,541.8648148148148,6,838,270,1108
2016-03-10 11:24:12,6.388865740740741,7,74,61,135
2016-03-06 22:18:36,5.985474537037037,4,66,53,119
2016-06-17 08:07:59,254.52556712962962,3,69,50,119
2016-03-12 12:43:45,11.891527777777778,3,103,35,138
2016-03-09 19:56:07,9.1903125,1,239,70,309
2016-03-01 18:08:44,1.3710763888888888,1,18,3,21
2016-02-29 22:19:15,0.9567013888888889,3,150,2674,2824
2016-02-28 19:25:29,0.15797453703703704,1,1,2,3
2016-02-26 20:26:34,0.20118055555555556,1,14,10,24
2016-02-27 00:00:17,0.43203703703703705,1,14,1,15
2016-03-03 22:49:02,664.7122569444444,10,153,64,217
2016-02-22 08:17:04,0.370787037037037,1,5,1,6
2016-02-23 06:26:32,1.6269675925925926,2,136,119,255
2016-02-21 20:48:37,0.2332986111111111,1,12,6,18
2016-02-21 10:46:18,0.024722222222222222,1,0,1,1
2016-02-20 23:20:53,0.22165509259259258,1,8,5,13
2016-04-26 22:44:50,67.62026620370371,7,1473,1289,2762
2016-02-19 13:54:03,0.679837962962963,2,8,2,10
2016-02-18 17:57:59,0.031689814814814816,1,0,1,1
2016-02-19 19:08:49,1.2837847222222223,1,32,0,32
2016-02-18 15:54:14,0.04622685185185185,1,6,1,7
2016-02-18 15:38:28,0.04131944444444444,1,4,4,8
2016-02-16 21:10:18,49.19369212962963,11,164,34,198
2016-02-16 17:41:58,12.895532407407407,1,1,1,2
2016-02-16 15:36:45,0.03383101851851852,1,20,16,36
2016-02-17 11:31:25,0.9211805555555556,1,8,0,8
2016-02-20 22:53:25,4.976435185185185,6,4051,3728,7779
2016-02-17 12:18:02,1.5589351851851851,2,185,48,233
2016-02-16 13:02:17,384.50341435185186,2,24,8,32
2016-02-14 08:01:24,0.20583333333333334,1,28,28,56
2016-02-13 21:00:22,0.06465277777777778,1,2,1,3
2016-02-13 08:21:30,0.44755787037037037,1,1,1,2
2016-02-13 19:01:34,0.987175925925926,1,20,0,20
2016-02-13 14:19:51,113.44905092592593,2,8,6,14
2016-03-08 15:08:11,25.400324074074074,1,153,13,166
2016-02-19 23:44:50,8.943495370370371,1,26,7,33
2016-02-26 15:09:30,15.685729166666667,2,64,212,276
2016-03-07 02:12:59,25.4365625,1,156,47,203
2016-02-17 22:13:48,0.3721759259259259,4,272,53,325
2016-02-17 19:24:04,284.3378472222222,8,1040,87,1127
2016-02-16 19:14:41,6.967337962962963,2,20,72,92
2016-02-09 19:48:17,0.018784722222222223,1,1,1,2
2016-02-07 11:16:58,0.005659722222222222,1,2,2,4
2016-02-07 09:23:42,0.03824074074074074,1,2,2,4
2016-02-07 10:05:49,0.49462962962962964,3,8,35,43
2016-02-07 11:13:35,0.5633217592592593,1,8,3,11
2016-02-09 19:59:49,3.3005324074074074,4,17,9,26
2016-02-05 20:04:46,0.018958333333333334,1,1,1,2
2016-02-13 20:06:41,8.985324074074073,3,121,141,262
2016-02-15 19:32:12,11.124837962962962,1,37,22,59
2016-02-04 10:03:42,0.3601736111111111,1,2,2,4
2016-02-06 19:47:17,18.67732638888889,3,3119,293,3412
2016-02-03 21:33:02,0.03396990740740741,1,1,1,2
2016-02-13 19:13:21,10.879421296296297,2,6,1,7
2016-02-02 21:04:06,0.12233796296296297,2,54,53,107
2016-02-04 10:02:35,1.811273148148148,1,27,1,28
2016-02-02 23:25:21,0.44197916666666665,1,1,1,2
2017-06-25 05:56:30,5.472581018518518,4,680,406,1086
2016-02-02 20:57:54,0.8774537037037037,1,1,4,5
2016-02-15 19:41:19,38.14628472222222,4,7951,2095,10046
2016-02-02 00:38:09,0.1100462962962963,1,6,9,15
2016-02-01 22:01:47,0.0024189814814814816,1,0,3,3
2016-02-01 21:46:03,715.0242245370371,7,556,105,661
2016-03-22 14:26:36,50.41628472222222,3,93,31,124
2016-02-10 23:35:46,10.252349537037038,2,20,7,27
2016-01-31 17:27:17,0.09569444444444444,1,15,18,33
2016-01-31 17:24:00,0.10212962962962963,1,4,2,6
2016-01-31 09:03:05,0.17938657407407407,1,10,1,11
2016-01-31 20:36:10,0.6874074074074074,1,5,7,12
2016-01-31 09:03:48,0.24535879629629628,1,2,2,4
2016-01-31 09:12:28,0.6611342592592593,2,49,22,71
2016-01-29 00:24:20,0.5883333333333334,2,5,4,9
2016-01-27 23:35:02,0.13045138888888888,1,7,1,8
2016-02-15 19:44:52,19.148252314814815,2,2,2,4
2016-02-16 19:39:48,20.97369212962963,6,136,233,369
2016-01-29 12:26:20,3.5555555555555554,4,48,38,86
2016-01-31 16:34:41,7.820798611111111,12,84,328,412
2016-02-09 13:39:53,19.62121527777778,5,440,250,690
2016-02-01 22:25:40,11.99392361111111,1,192,18,210
2016-02-09 20:50:06,20.828425925925927,2,15,12,27
2016-02-03 17:27:58,14.695949074074074,1,10,15,25
2016-02-15 22:16:22,27.995104166666668,5,3300,42,3342
2016-01-20 19:06:53,1.6803125,1,23,0,23
2016-01-19 07:39:09,0.2960069444444444,1,13,0,13
2016-01-27 07:48:48,8.513715277777777,1,48,48,96
2016-01-18 20:31:53,0.04621527777777778,1,0,1,1
2016-01-18 18:30:42,0.2512847222222222,2,147,145,292
2016-01-16 23:04:21,0.9833217592592592,1,4,1,5
2016-01-17 12:09:10,1.061585648148148,2,45,24,69
2016-01-15 18:46:40,0.595474537037037,1,13,9,22
2016-01-14 12:46:37,0.36681712962962965,1,1,1,2
2016-01-31 22:02:10,19.22375,1,41,52,93
2016-01-13 20:49:23,1.1689699074074074,1,2,2,4
2016-01-13 08:53:46,0.40850694444444446,1,1,1,2
2016-01-12 22:40:04,0.02318287037037037,1,13,13,26
2016-02-02 21:25:38,21.08559027777778,1,9,8,17
2016-01-15 21:03:57,4.475578703703704,2,5,1,6
2016-01-17 17:54:32,7.093668981481481,1,44,63,107
2016-01-17 12:12:18,7.657569444444444,3,124,7,131
2016-01-17 13:20:17,7.788576388888889,2,56,59,115
2016-01-09 23:19:22,0.2500462962962963,1,3,3,6
2016-01-08 18:27:34,0.03778935185185185,1,2,6,8
2016-02-13 20:08:47,36.51673611111111,1,4,10,14
2016-01-08 11:31:07,0.2382175925925926,1,10,2,12
2016-01-17 13:11:54,9.973425925925927,1,15,5,20
2016-01-07 12:08:26,14.462094907407407,1,286,53,339
2016-01-06 21:42:44,0.07390046296296296,1,36,37,73
2016-01-07 22:46:21,1.1511342592592593,2,60,78,138
2016-01-06 16:54:54,0.08388888888888889,1,0,6,6
2016-06-12 12:10:00,158.9185300925926,10,289,158,447
2016-01-06 07:54:00,1.0417013888888889,1,1,1,2
2016-01-07 23:02:24,2.7861689814814814,2,24,24,48
2016-01-13 09:47:25,8.52517361111111,2,41,41,82
2016-01-18 15:43:20,13.822766203703704,1,8,100,108
2016-01-04 18:19:56,0.8925925925925926,2,36,51,87
2016-01-14 12:48:28,18.66528935185185,1,15,15,30
2016-01-03 21:37:10,0.08728009259259259,1,2,4,6
2016-01-04 21:46:37,1.3998032407407408,3,18,784,802
2016-01-10 14:34:00,7.412083333333333,1,5,3,8
2016-01-10 14:14:22,14.822256944444444,1,75,7,82
2016-02-02 00:28:56,30.534606481481482,14,391,76,467
2016-01-02 08:36:55,0.13239583333333332,1,1,1,2
2016-01-03 19:51:15,1.6099537037037037,1,19,3,22
2016-01-08 18:41:08,6.601793981481482,1,50,2,52
2016-01-02 01:29:53,0.011689814814814814,1,1,1,2
2016-11-18 20:34:20,370.8744560185185,42,105850,180701,286551
2015-12-31 06:39:55,0.17832175925925925,4,121,171,292
2016-01-07 10:45:27,7.079375,1,1,1,2
2015-12-30 12:32:38,0.018645833333333334,1,3,3,6
2015-12-29 09:48:02,0.47984953703703703,3,40,2,42
2015-12-30 12:09:15,1.7556828703703704,1,35,22,57
2015-12-29 19:39:00,1.1006018518518519,1,4,0,4
2016-01-17 14:11:37,21.964513888888888,2,1415,252,1667
2015-12-28 16:50:50,3.8321296296296294,1,10,7,17
2015-12-29 17:57:36,5.607465277777778,2,18,6,24
2016-02-21 20:54:18,61.94309027777778,1,1472,34,1506
2016-01-19 12:38:12,26.980543981481482,1,225,3,228
2015-12-22 06:44:02,0.2929513888888889,1,5,5,10
2015-12-28 16:59:29,9.074641203703704,2,165,977,1142
2015-12-19 08:48:20,0.5739583333333333,1,1,1,2
2015-12-29 18:10:52,12.385046296296297,1,2,2,4
2015-12-29 14:17:23,13.79375,2,22,2,24
2016-07-20 03:10:57,217.99467592592592,13,783,351,1134
2016-01-03 20:21:33,54.899675925925926,6,302,199,501
2015-12-15 05:53:03,2.7583449074074076,5,97,53,150
2015-12-12 11:09:41,0.1769212962962963,1,0,2,2
2015-12-12 11:16:04,0.2296875,1,16,16,32
2015-12-11 19:48:24,0.06439814814814815,1,2,2,4
2015-12-30 21:55:35,26.236273148148147,1,8,1,9
2015-12-09 21:15:49,1.064837962962963,1,4,4,8
2015-12-08 06:07:42,0.3192361111111111,1,10,2,12
2015-12-07 23:15:18,0.04828703703703704,1,27,14,41
2015-12-05 07:54:05,0.39078703703703704,3,108,114,222
2015-12-08 06:08:41,3.363310185185185,1,1,1,2
2016-01-08 19:32:17,34.96616898148148,5,140,115,255
2015-12-08 00:44:58,3.534074074074074,1,2,2,4
2015-12-22 06:55:49,18.146493055555556,4,3031,2,3033
2015-12-03 00:54:52,1.1055439814814816,1,44,12,56
2015-12-02 20:47:32,0.3924537037037037,1,2,2,4
2015-12-02 08:12:42,0.40207175925925925,1,1,1,2
2015-12-02 08:11:30,0.4121412037037037,1,2,5,7
2015-12-02 08:03:28,0.4423842592592593,1,20,10,30
2015-11-30 21:14:41,0.6930324074074075,1,8,4,12
2016-02-09 19:59:02,72.9424074074074,3,117,59,176
2015-12-02 17:23:28,3.9285069444444445,5,32,6,38
2016-01-28 21:18:28,61.99237268518519,1,55,102,157
2015-12-01 20:59:03,4.3812037037037035,3,136,47,183
2016-01-02 18:38:45,36.236736111111114,4,236,65,301
2016-04-10 17:09:36,135.55158564814815,6,150,173,323
2015-11-28 09:54:13,1162.010497685185,1,1,1,2
2015-11-27 05:46:50,0.09446759259259259,1,1,1,2
2015-11-25 22:09:54,0.31351851851851853,1,4,2,6
2016-02-21 19:49:59,91.24295138888888,7,96,38,134
2015-11-28 14:40:02,3.7618055555555556,1,2,2,4
2015-12-30 09:59:43,36.54221064814815,1,14,10,24
2015-11-25 17:55:19,2.0944560185185184,1,1,1,2
2016-06-19 19:20:09,1.933101851851852,3,358,77,435
2015-11-23 15:09:24,0.19512731481481482,1,1,1,2
2015-12-03 17:56:10,10.811006944444445,1,46,4,50
2015-11-22 23:19:06,0.0705324074074074,1,3,3,6
2015-12-19 08:59:33,26.523842592592594,3,3,3,6
2015-11-22 20:56:11,0.03929398148148148,1,2,1,3
2015-12-02 13:04:39,8.833587962962962,4,29,364,393
2015-11-22 19:29:18,11.571076388888889,1,28,6,34
2015-12-02 13:07:34,10.655266203703704,1,104,85,189
2015-11-22 14:19:21,4.012152777777778,2,26,1,27
2015-11-24 20:36:33,6.654768518518519,3,85,44,129
2015-11-15 21:20:14,0.09813657407407407,2,12,5,17
2015-11-15 18:13:11,28.719953703703705,1,1,2,3
2015-11-21 18:49:55,6.097835648148148,1,65,24,89
2015-11-21 12:06:46,7.765821759259259,1,14,0,14
2015-11-15 13:16:21,1.7805092592592593,1,21,1,22
2015-11-13 13:13:03,0.1343287037037037,2,12,12,24
2015-11-13 10:39:46,0.739537037037037,1,6,1,7
2015-11-12 22:04:36,0.2680439814814815,2,2,1,3
2015-11-15 21:38:19,5.972905092592592,2,90,44,134
2015-11-24 07:33:37,0.8689699074074074,3,84,44,128
2015-11-25 20:40:00,24.81247685185185,2,16,2,18
2015-11-09 19:39:03,0.9708796296296296,1,23,21,44
2015-11-09 11:59:36,8.569756944444444,1,70,7,77
2015-11-08 21:03:13,0.23322916666666665,2,294,87,381
2016-02-29 12:31:46,113.00861111111111,3,71,47,118
2015-11-15 17:31:44,7.899120370370371,1,11,0,11
2015-11-08 14:15:45,1.097210648148148,1,94,132,226
2015-11-07 14:29:17,0.10581018518518519,1,1,1,2
2015-11-07 14:29:41,0.11244212962962963,1,8,8,16
2015-11-07 11:51:19,0.05528935185185185,1,2,1,3
2015-11-05 23:42:44,0.11104166666666666,2,72,3,75
2015-11-07 11:40:06,6.513321759259259,1,13,0,13
2015-10-31 23:36:45,0.05271990740740741,1,21,9,30
2015-11-15 21:42:49,15.131099537037038,4,70,24,94
2016-02-15 21:02:33,108.4059375,2,21,21,42
2015-10-29 18:25:40,0.013865740740740741,1,1,1,2
2015-11-07 14:53:50,9.083831018518518,1,50,47,97
2015-10-30 13:25:37,1.163136574074074,1,5,4,9
2015-10-27 06:59:31,0.6814236111111112,1,18,10,28
2016-03-14 15:59:29,309.31542824074074,9,660,438,1098
2015-10-25 12:15:24,0.0023263888888888887,1,17,0,17
2015-10-26 19:16:33,1.5722337962962962,1,5,5,10
2015-10-25 09:17:09,0.45381944444444444,1,2,0,2
2015-10-25 19:30:11,0.9746875,1,4,3,7
2015-11-15 13:25:44,21.736064814814814,1,32,2,34
2015-10-25 19:31:45,1.1351967592592593,1,8,1,9
2015-10-25 19:33:01,1.183275462962963,2,24,25,49
2015-10-24 17:46:04,0.12377314814814815,1,100,56,156
2015-10-25 10:18:19,0.8603356481481481,1,103,43,146
2015-10-24 19:59:25,0.38305555555555554,1,5,3,8
2015-10-24 00:44:03,0.19208333333333333,2,11,15,26
2015-10-23 19:53:29,0.8815393518518518,1,38,5,43
2015-10-20 15:24:28,0.17239583333333333,1,6,2,8
2015-10-20 15:11:07,0.5879166666666666,1,32,0,32
2016-02-22 20:57:03,132.90782407407409,2,92,150,242
2015-10-19 20:43:24,0.04019675925925926,1,4,4,8
2016-03-14 15:59:58,146.8964699074074,2,168,64,232
2015-10-19 19:26:47,0.3834837962962963,1,2,2,4
2015-10-24 12:13:08,5.758449074074074,1,18,3,21
2015-10-24 11:35:54,5.8872685185185185,2,25,39,64
2015-10-18 15:15:35,0.15494212962962964,1,3,5,8
2015-10-18 10:15:53,0.009166666666666667,2,8,0,8
2016-01-26 20:01:43,100.65555555555555,1,134,109,243
2015-10-17 22:32:07,6.331840277777777,1,34,1,35
2015-10-17 16:27:14,0.15041666666666667,1,4,4,8
2015-10-17 13:14:15,0.7250347222222222,2,15,3,18
2015-10-16 14:57:34,0.1474074074074074,1,4,4,8
2015-10-19 18:32:12,3.5413194444444445,7,58,61,119
2015-10-16 04:33:02,0.5991782407407408,1,11,11,22
2015-10-24 14:30:12,9.184606481481481,1,58,51,109
2015-10-17 14:08:22,2.2392708333333333,2,3,3,6
2015-10-15 18:03:24,0.5795138888888889,1,1,1,2
2015-10-15 18:46:38,1.1680208333333333,6,107,22,129
2015-11-15 13:28:07,31.85590277777778,3,79,19,98
2015-10-17 14:57:27,3.7170717592592593,2,19,2,21
2015-10-15 18:07:14,1.8729166666666666,1,10,37,47
2015-10-15 14:27:36,1.935162037037037,1,19,1,20
2015-10-13 17:27:04,0.8401273148148148,1,2,1,3
2015-10-17 13:49:24,7.749849537037037,4,119,34,153
2015-10-17 16:25:36,4.8670023148148145,15,350,137,487
2015-11-25 00:48:45,0.14677083333333332,1,94,0,94
2015-10-28 20:37:47,19.12070601851852,5,41,73,114
2015-10-12 18:40:28,4.888506944444444,2,141,136,277
2015-10-07 15:15:58,0.1610300925925926,1,14,3,17
2015-10-10 16:50:26,3.894699074074074,5,146,129,275
2015-10-07 09:58:19,0.8113657407407407,1,19,0,19
2015-10-10 16:12:30,4.39712962962963,3,51,772,823
2015-10-06 06:53:32,1.024212962962963,1,25,11,36
2015-11-21 13:22:23,47.22587962962963,2,27,6,33
2015-10-05 08:58:27,1.277662037037037,1,33,34,67
2015-10-06 19:27:28,3.139236111111111,1,0,44,44
2015-10-06 19:50:27,5.0213425925925925,3,91,206,297
2015-10-03 18:37:37,2.7981944444444444,1,93,40,133
2015-09-30 16:00:28,0.3460300925925926,2,67,27,94
2015-11-09 11:15:04,45.80258101851852,14,1027,458,1485
2015-10-10 11:47:55,12.623784722222222,2,52,21,73
2015-10-03 09:05:20,5.688773148148148,1,0,16,16
2015-10-04 10:03:21,6.902488425925926,1,27,41,68
2015-10-06 19:20:47,10.272337962962963,1,36,0,36
2015-11-08 20:57:51,44.31395833333333,2,127,52,179
2016-03-25 13:57:35,184.45149305555555,7,896,423,1319
2015-10-09 15:45:08,16.556655092592592,2,54,69,123
2015-10-06 07:10:46,13.992106481481482,1,1,1,2
2015-10-06 19:18:42,14.819791666666667,1,17,15,32
2015-09-22 04:51:39,0.22644675925925925,1,4,4,8
2015-10-06 19:17:03,14.867418981481482,1,4,4,8
2015-09-22 04:57:18,250.53601851851852,4,71,71,142
2015-09-22 16:53:56,4.103680555555556,2,21,2,23
2015-10-06 23:23:39,0.12799768518518517,1,14,2,16
2015-09-17 15:57:52,0.11885416666666666,1,1,1,2
2015-10-19 21:59:29,34.93908564814815,1,7,4,11
2015-10-09 14:46:49,24.744074074074074,3,133,32,165
2015-09-15 14:14:32,0.7261805555555556,1,3,2,5
2015-11-15 16:44:58,65.00387731481482,21,923,695,1618
2015-10-06 19:24:00,33.04043981481482,2,53,39,92
2015-10-10 16:33:34,33.72767361111111,1,30,0,30
2015-09-11 14:39:43,28.25252314814815,1,10,14,24
2015-10-11 00:33:33,32.29693287037037,2,8,8,16
2015-09-09 18:15:51,1.0533796296296296,2,3,10,13
2016-02-16 18:07:08,171.03755787037036,80,1623,1173,2796
2015-09-14 16:06:59,8.038912037037036,1,2,2,4
2015-11-15 15:13:58,70.48722222222223,1,92,6,98
2015-10-03 18:59:19,29.219166666666666,1,22,4,26
2015-09-04 18:30:25,0.22282407407407406,1,9,2,11
2015-10-10 15:39:13,36.12898148148148,2,6,16,22
2015-09-04 12:26:52,2.6378587962962965,1,1,1,2
2015-11-15 16:27:31,75.67427083333334,5,56,52,108
2015-10-10 13:20:55,40.764386574074074,1,15,15,30
2015-11-08 09:27:17,0.669525462962963,1,3,3,6
2015-10-10 16:39:30,88.79743055555555,5,99,29,128
2015-08-30 16:55:33,1.8850694444444445,1,4,1,5
2015-08-28 16:06:45,0.1285300925925926,1,2,0,2
2015-08-28 16:30:55,0.18640046296296298,1,2,0,2
2015-08-28 16:23:36,0.7094328703703704,2,172,120,292
2015-08-28 18:51:30,0.9265740740740741,3,207,174,381
2016-01-20 17:57:15,146.1279861111111,3,577,137,714
2015-08-29 17:29:17,15.078333333333333,1,19,5,24
2015-08-23 09:43:07,0.13458333333333333,1,6,5,11
2015-10-10 15:32:05,49.439791666666665,2,15,4,19
2015-09-09 16:40:28,19.234224537037036,2,17,9,26
2015-10-10 16:52:55,50.941550925925924,1,5,2,7
2015-08-21 15:50:37,3.087627314814815,1,5,3,8
2015-10-10 15:38:32,53.80898148148148,2,38,8,46
2015-10-10 17:13:06,53.948935185185185,2,146,6,152
2015-08-17 18:42:40,0.7005787037037037,2,40,2,42
2015-08-17 18:40:37,0.7761921296296296,1,40,23,63
2015-10-10 16:11:42,0.1605787037037037,10,271,287,558
2015-08-17 19:44:03,1.6784953703703704,2,36,53,89
2015-09-14 14:29:30,31.33386574074074,4,357,20,377
2015-08-13 21:03:08,0.04092592592592593,1,5,1,6
2015-10-10 15:42:20,57.842210648148146,1,2,1,3
2015-11-22 17:10:19,101.8936574074074,2,138,61,199
2015-08-16 07:14:13,3.010324074074074,1,1,1,2
2015-10-17 12:57:34,86.91098379629629,5,228,94,322
2015-08-16 06:44:24,3.395960648148148,7,95,9,104
2015-08-13 16:37:37,0.8277893518518519,1,2,0,2
2015-09-14 09:02:09,33.47380787037037,1,11,21,32
2015-10-05 15:41:32,54.88986111111111,2,374,30,404
2015-08-11 14:53:52,0.04252314814814815,1,17,0,17
2016-02-16 21:39:35,189.7554976851852,2,13,5,18
2015-10-12 21:44:24,63.14445601851852,3,97,32,129
2015-08-10 11:00:49,88.95063657407407,32,1129,982,2111
2015-10-13 07:09:06,64.17716435185186,3,80,59,139
2015-08-16 07:18:51,6.261550925925926,1,20,14,34
2015-08-10 12:06:27,0.658599537037037,1,9,2,11
2015-08-15 14:47:53,6.016550925925926,1,21,0,21
2015-08-13 18:58:05,4.2011921296296295,1,26,12,38
2015-08-09 18:46:46,1.0250694444444444,2,49,14,63
2015-11-25 22:01:19,110.01608796296296,2,136,84,220
2015-08-06 17:54:10,0.16505787037037037,1,31,2,33
2015-08-07 12:14:35,3.809247685185185,4,35,6051,6086
2015-09-23 10:20:26,44.71313657407408,3,1108,90,1198
2015-08-13 16:52:57,19.02145833333333,5,60901,77,60978
2015-08-16 20:02:00,7.195034722222222,1,28,11,39
2015-08-04 21:31:11,3.5357291666666666,2,26,15,41
2015-07-31 05:25:49,0.4144791666666667,2,2,2,4
2015-08-04 21:16:36,5.317245370370371,1,98,93,191
2015-07-30 09:34:35,0.36248842592592595,1,1,1,2
2015-08-05 06:11:16,8.487256944444445,1,12,0,12
2015-08-07 12:16:06,10.766655092592593,1,25,1,26
2015-10-10 12:52:54,76.34866898148148,1,15,27,42
2015-10-10 16:29:18,76.83765046296297,3,53,5,58
2015-08-05 06:16:53,10.417766203703703,2,509,21,530
2015-07-26 13:12:50,1.682951388888889,1,3,0,3
2015-07-26 00:22:25,1.2633912037037036,1,8,4,12
2015-08-04 22:38:48,11.1971875,1,37,7,44
2015-07-25 12:11:05,1.450763888888889,1,0,0,0
2015-07-24 14:05:02,1.8866203703703703,4,204,204,408
2015-07-24 14:16:24,2.6245717592592595,1,5,3,8
2015-07-23 17:14:03,2.7892592592592593,2,211,167,378
2015-10-10 15:46:51,81.97292824074074,4,14,69,83
2015-07-20 13:31:23,0.027337962962962963,1,5,3,8
2015-08-10 06:29:52,23.38607638888889,3,121,55,176
2015-07-17 14:23:26,0.06289351851851852,1,6,12,18
2015-08-03 20:14:03,17.60814814814815,2,127,34,161
2015-10-10 17:07:23,86.01913194444444,3,34,14,48
2015-07-27 05:28:40,292.3570023148148,1,20,4,24
2015-08-12 06:52:12,27.110069444444445,1,10,7,17
2015-07-15 00:08:50,0.032337962962962964,1,13,1,14
2015-07-14 22:59:45,0.17983796296296295,1,9,0,9
2015-07-17 17:48:55,4.283206018518518,2,32,245,277
2015-09-21 11:48:33,77.45903935185186,69,6623,2757,9380
2016-02-25 20:53:39,227.04783564814815,3,125,76,201
2015-07-14 11:48:48,0.9517361111111111,3,33,23,56
2015-07-12 13:21:29,0.5733796296296296,1,34,7,41
2015-07-27 19:42:58,15.947465277777777,46,1382,763,2145
2015-07-15 10:04:23,3.8539583333333334,2,41,34,75
2015-07-28 20:11:17,17.424699074074073,1,0,464,464
2015-07-11 15:37:49,1.4283564814814815,1,2,2,4
2015-10-24 12:22:04,107.92402777777778,1,14,2,16
2015-10-13 17:52:36,102.41318287037036,1,31,0,31
2015-07-12 05:38:28,8.018831018518519,4,167,138,305
2015-07-04 08:21:58,0.41724537037037035,1,16,0,16
2015-07-04 08:32:29,0.5235069444444445,1,1,1,2
2015-07-03 07:57:57,0.28122685185185187,2,38,6,44
2015-07-04 09:05:19,2.4754745370370372,1,5,5,10
2015-07-01 19:49:22,0.4752662037037037,1,1,3,4
2015-07-04 08:35:44,3.269814814814815,2,6,6,12
2015-08-13 17:00:52,43.76289351851852,16,1496,542,2038
2015-07-27 18:19:49,26.880520833333332,2,18,15,33
2015-10-11 13:14:09,106.60336805555555,1,124,177,301
2015-07-28 19:07:29,31.659918981481482,4,98,31,129
2015-07-05 09:38:18,8.727847222222222,3,42,7,49
2015-06-30 20:56:56,6.565972222222222,2,5,5,10
2015-06-29 09:34:17,3.9007407407407406,2,6,5,11
2015-07-01 06:05:19,6.233425925925926,3,71,10,81
2015-06-26 06:27:57,2.4320833333333334,2,12,11,23
2015-06-24 11:37:56,1.3019097222222222,1,1,2,3
2015-07-05 09:40:40,12.67113425925926,6,97,13,110
2015-06-21 15:58:59,0.018425925925925925,1,1,1,2
2015-10-15 14:10:44,115.64936342592593,7,119,34,153
2017-02-17 15:23:40,609.0718402777778,1,204,86,290
2015-06-22 18:18:48,4.008101851851852,1,7,1,8
2015-07-04 18:34:36,16.956493055555555,2,15,8,23
2015-06-17 14:22:41,0.0437037037037037,1,1,1,2
2015-06-17 18:38:27,0.35988425925925926,1,2,2,4
2015-07-04 20:16:59,17.612199074074073,2,119,45,164
2015-06-21 16:00:02,4.790254629629629,1,9,0,9
2015-06-30 21:03:31,14.185335648148149,1,37,1,38
2015-06-22 12:41:29,6.1375,2,9,11,20
2015-06-21 19:26:45,6.0320833333333335,3,75,22,97
2015-06-27 15:14:21,12.93130787037037,7,983,199,1182
2015-06-16 05:38:13,6.642291666666667,4,53,19,72
2015-06-08 23:45:48,0.09959490740740741,1,2,2,4
2015-06-21 14:09:43,14.399965277777778,4,45,35,80
2015-06-04 08:32:54,0.8810069444444445,3,16,8,24
2021-05-11 18:41:47,2170.0631712962963,60,562997,332769,895766
2015-10-25 19:47:55,146.9723611111111,1,92,19,111
2015-05-30 08:47:05,0.03832175925925926,1,1,1,2
2015-10-24 12:26:29,147.60856481481483,1,22,19,41
2015-06-01 00:30:06,3.2124305555555557,1,21,6,27
2015-05-31 12:14:38,4.437407407407408,2,26,32,58
2015-05-26 20:33:39,0.002511574074074074,1,1,1,2
2015-06-21 14:16:26,25.779618055555556,7,260,101,361
2015-05-27 21:57:30,1.138425925925926,1,0,1,1
2015-05-30 10:22:09,4.909479166666666,2,537,6,543
2015-05-25 21:55:58,1.093773148148148,1,8,15,23
2015-06-29 12:49:22,36.002546296296295,3,152,5,157
2016-01-18 15:53:24,239.77980324074073,2,95,11,106
2015-06-29 09:41:50,37.88650462962963,3,54,23,77
2015-06-14 16:22:39,23.784756944444446,1,165,48,213
2015-05-21 16:46:38,0.12931712962962963,3,3,5,8
2015-05-29 14:47:29,9.002523148148148,1,805,1285,2090
2015-07-05 21:49:38,47.96824074074074,5,348,110,458
2015-05-19 04:56:51,0.008935185185185185,1,1,1,2
2015-11-22 18:28:32,187.7326273148148,64,12641,8839,21480
2015-07-10 16:18:55,53.062662037037036,1,696,2,698
2015-05-20 20:07:53,2.5516782407407406,1,4,4,8
2016-06-13 17:15:40,393.33064814814816,16,3107,1518,4625
2015-05-15 15:20:08,0.6945601851851851,1,1,1,2
2015-05-22 16:16:03,8.436018518518518,1,1,1,2
2015-05-19 12:45:35,6.158275462962963,1,44,0,44
2015-06-22 20:29:04,40.98319444444444,3,51,49,100
2015-08-06 18:51:03,86.12746527777777,8,66,47,113
2015-07-05 12:03:24,54.576574074074074,6,120,31,151
2015-05-12 20:02:10,1.0318981481481482,1,3,1,4
2015-05-24 08:15:06,12.818506944444444,1,11,9,20
2015-05-11 09:37:38,0.4758449074074074,3,23,6,29
2015-05-11 06:10:28,0.21465277777777778,1,2,1,3
2015-05-10 20:55:43,0.14208333333333334,1,1,2,3
2015-06-04 07:58:28,25.353090277777778,1,27,6,33
2015-05-10 13:32:20,0.8817013888888889,1,2,2,4
2015-05-09 14:07:32,0.012615740740740742,1,101,47,148
2015-05-10 20:13:44,1.2960532407407408,1,13,10,23
2015-05-10 20:14:15,2.6118055555555557,1,2,2,4
2015-05-07 19:25:24,0.08359953703703704,1,2,1,3
2015-05-07 17:01:03,0.020891203703703703,1,3,1,4
2021-01-11 12:19:58,2076.3377662037037,42,524059,322170,846229
2015-05-08 17:03:19,28.71869212962963,2,168,33,201
2015-11-30 08:06:18,295.5602083333333,3,126,7,133
2015-05-06 21:14:06,1.5703125,2,63,27,90
2015-05-10 15:32:04,5.110601851851852,2,426,92,518
2015-05-09 15:05:44,3.8681134259259258,1,15,14,29
2015-08-25 17:56:50,112.0575,1,3,3,6
2015-05-06 19:05:40,1.7569097222222223,2,13,1,14
2015-05-18 23:37:14,14.295057870370371,3,155,126,281
2015-05-04 13:53:58,0.04417824074074074,1,6,2,8
2015-05-04 13:32:25,1.9190046296296297,1,1,1,2
2015-05-05 18:34:30,3.886712962962963,2,54,2,56
2015-05-09 14:17:51,7.817997685185185,2,3,0,3
2015-05-07 17:27:02,6.1151736111111115,4,75,39,114
2015-05-01 17:02:36,0.7808796296296296,4,66,6,72
2015-05-06 19:06:34,6.995428240740741,2,10,4,14
2015-04-29 20:45:56,0.06575231481481482,1,18,30,48
2015-05-05 15:06:32,94.81460648148148,8,150,111,261
2015-05-06 19:16:31,7.24224537037037,1,15,1,16
2015-04-29 18:12:35,0.2190625,1,13,0,13
2015-04-30 18:10:39,1.7106018518518518,1,62,58,120
2015-05-05 15:09:15,7.8705439814814815,1,22,0,22
2015-05-05 12:57:48,8.959583333333333,1,46,8,54
2015-04-26 15:11:22,0.09408564814814815,1,5,5,10
2015-05-02 20:08:48,7.467766203703704,3,130,16,146
2015-04-25 11:28:27,0.40849537037037037,1,4,4,8
2015-05-03 14:35:04,9.17199074074074,13,205,115,320
2015-05-05 15:52:04,11.65162037037037,3,16,3,19
2015-04-23 13:24:25,0.6427546296296296,2,60,7,67
2015-04-24 01:30:52,23.029641203703704,2,59,5,64
2015-04-27 20:32:23,6.909490740740741,1,7,2,9
2015-04-27 15:12:43,9.911840277777777,2,90,3,93
2015-04-21 18:53:21,1.1827199074074075,1,3,2,5
2015-04-27 20:30:35,7.906053240740741,1,85,19,104
2015-04-22 16:45:30,5.504363425925926,3,8,7,15
2015-04-21 05:52:34,4.346446759259259,1,24,1,25
2015-04-17 00:55:02,0.08645833333333333,1,11,8,19
2015-04-14 23:18:19,0.10378472222222222,1,2,0,2
2015-04-15 16:11:27,0.8912152777777778,1,22,0,22
2015-04-14 20:08:50,0.0781712962962963,1,1,1,2
2015-04-15 05:25:17,0.471875,1,22,10,32
2015-04-14 17:14:17,0.11519675925925926,1,4,1,5
2015-04-13 23:21:54,0.09724537037037037,1,1,0,1
2015-04-13 19:54:59,0.0014583333333333334,1,1,0,1
2015-04-13 19:33:42,0.25604166666666667,1,7,0,7
2015-04-26 08:51:16,12.831597222222221,1,8,3,11
2015-04-20 18:03:28,7.901678240740741,1,70,3,73
2015-04-28 19:30:58,16.233877314814816,1,35,16,51
2015-04-12 20:52:48,0.46793981481481484,1,19,13,32
2015-04-16 19:02:51,4.476782407407407,2,79,83,162
2015-05-07 19:37:41,25.713981481481483,2,78,4,82
2015-04-17 23:25:12,6.166064814814815,1,13,10,23
2015-04-16 15:45:12,5.085196759259259,2,82,22,104
2015-04-26 08:54:39,15.545324074074074,2,7,2,9
2015-05-06 16:10:59,26.64732638888889,9,750,250,1000
2015-04-14 05:31:12,4.485,2,178,108,286
2015-05-09 14:12:28,29.900381944444444,1,27,17,44
2015-04-10 12:13:11,1.0576851851851852,1,21,0,21
2015-05-09 14:23:37,30.948414351851852,2,169,7,176
2015-04-17 21:25:32,9.940289351851852,3,3,8,11
2015-04-12 21:29:32,5.100555555555555,1,10,12,22
2015-04-11 15:21:48,4.780300925925926,2,89,13,102
2015-04-11 15:52:30,5.844490740740741,2,25,5,30
2015-04-12 19:38:36,7.551851851851852,8,122,49,171
2015-04-05 08:56:10,0.5950347222222222,1,1,5,6
2015-04-05 08:59:22,3.0227430555555554,1,1,1,2
2015-04-01 21:16:33,2.1802083333333333,1,34,96,130
2015-05-06 13:00:01,35.96778935185185,2,311,187,498
2015-05-06 17:35:00,48.79908564814815,17,1379,587,1966
2015-04-02 19:02:18,3.1082060185185183,3,161,77,238
2016-02-23 13:58:09,329.8962384259259,1,117,7,124
2015-04-01 12:55:42,1.8794328703703704,1,1,1,2
2015-05-05 15:48:10,36.771342592592596,5,258,110,368
2015-04-04 14:51:46,7.8329050925925925,1,8,1,9
2015-10-24 12:43:09,211.36013888888888,3,141,25,166
2015-03-25 00:00:56,0.38766203703703705,1,0,3,3
2015-04-04 14:07:09,11.834756944444445,1,9,5,14
2015-04-17 00:26:13,24.739189814814814,1,11,3,14
2015-03-23 07:13:33,0.25560185185185186,1,25,0,25
2015-04-03 21:18:38,12.862881944444444,1,14,6,20
2015-04-03 21:17:41,12.87369212962963,1,4,2,6
2015-03-21 15:34:06,0.20967592592592593,2,24,13,37
2015-03-20 23:45:20,0.18140046296296297,1,1,1,2
2015-03-21 00:55:49,0.48540509259259257,2,30,16,46
2015-03-20 14:36:57,0.0893287037037037,2,5,2,7
2015-04-04 12:39:17,13.407893518518518,1,68,7,75
2015-03-20 23:40:29,2.230590277777778,2,16,42,58
2015-04-30 08:06:46,45.334131944444444,1,92,84,176
2015-04-04 14:58:54,17.78415509259259,10,112,37,149
2015-03-17 19:19:07,0.004571759259259259,1,1,1,2
2015-03-24 12:57:20,7.869791666666667,1,13,2,15
2015-03-16 13:31:23,0.02550925925925926,1,5,5,10
2015-03-14 20:00:32,0.31506944444444446,1,1,3,4
2015-03-13 22:26:07,0.0509375,1,0,2,2
2015-03-13 22:27:27,1.0041319444444445,1,7,1,8
2015-05-06 21:34:05,55.31503472222222,2,75,9,84
2015-03-13 22:28:19,2.1200810185185186,1,49,43,92
2015-03-13 22:33:03,2.454363425925926,4,160,56,216
2015-03-14 10:22:50,3.3730555555555557,1,16,1,17
2015-03-14 10:11:05,3.397800925925926,1,27,19,46
2015-03-14 13:29:51,3.6167824074074075,2,14,1,15
2015-03-14 10:59:05,20.351655092592594,3,1427,1363,2790
2015-03-17 21:00:52,7.252083333333333,3,380,125,505
2015-03-12 00:11:55,2.956724537037037,1,48,26,74
2015-03-11 09:09:17,17.30523148148148,1,21,7,28
2015-03-14 10:47:21,5.995590277777778,1,27,28,55
2021-12-02 17:12:24,2525.5758796296295,85,2003,1216,3219
2016-08-10 00:24:54,14.93082175925926,8,156,26,182
2015-03-13 22:26:56,7.519479166666667,1,167,94,261
2015-03-08 20:21:00,3.1400694444444444,1,19,7,26
2015-03-06 06:08:12,1.2451736111111111,1,58,56,114
2019-10-28 13:40:02,6.707118055555555,5,139,25,164
2015-04-08 12:54:39,35.946469907407405,30,749,301,1050
2015-03-16 13:36:51,19.04869212962963,2,132,10,142
2015-03-03 14:46:05,0.6702083333333333,1,0,4,4
2015-03-05 21:21:33,3.365972222222222,2,2,3,5
2015-03-03 14:10:12,1.5314583333333334,1,569,542,1111
2015-05-09 12:32:37,69.05556712962964,25,1142,546,1688
2015-04-02 19:45:40,33.76481481481481,2,159,11,170
2015-03-02 19:48:15,0.3885763888888889,1,16,9,25
2015-03-04 13:32:12,5.898854166666666,3,11,98,109
2015-03-02 20:08:05,4.191168981481481,3,7,5,12
2015-04-04 16:07:17,48.520810185185184,5,221,80,301
2015-03-14 13:36:45,17.047118055555554,9,257,73,330
2015-02-27 14:45:54,2.810474537037037,1,12,3,15
2015-03-11 17:59:01,15.287233796296297,5,72,22,94
2015-03-14 09:52:28,0.03643518518518519,1,155,3,158
2015-02-23 20:25:02,0.8982291666666666,1,4,14,18
2015-02-26 14:54:20,1.3485648148148148,1,32,36,68
2015-02-25 15:31:06,2.904826388888889,2,13,2,15
2015-02-22 04:54:10,0.19899305555555555,2,19,6,25
2015-02-21 22:50:35,0.10842592592592593,9,135,160,295
2015-03-11 17:48:57,18.805671296296296,4,341,87,428
2015-02-23 19:09:02,54.167824074074076,3,160,18,178
2015-02-20 07:13:26,0.8820717592592593,1,1,1,2
2015-02-18 20:36:57,1.0882523148148149,1,81,28,109
2015-03-08 17:06:37,18.00378472222222,1,115,6,121
2015-02-18 14:41:11,3.9127083333333332,1,20,17,37
2015-02-22 00:57:38,11.33013888888889,1,1,1,2
2015-02-11 18:47:43,1.873761574074074,4,25,8,33
2015-02-09 10:12:48,0.003310185185185185,1,1,1,2
2015-02-14 13:25:08,5.42431712962963,1,2,2,4
2015-02-24 18:20:34,380.80539351851854,15,540,302,842
2015-02-24 18:12:30,102.52841435185185,1,35,8,43
2015-02-14 13:29:15,5.6640856481481485,2,545,43,588
2015-03-02 20:35:12,23.11880787037037,1,19,0,19
2015-02-14 13:44:52,6.880590277777777,14,2396,3168,5564
2015-02-22 05:31:42,19.26712962962963,15,384,378,762
2015-02-05 07:18:37,0.4060416666666667,1,3,34,37
2015-02-04 21:07:03,0.07324074074074075,1,4,4,8
2015-03-06 15:16:14,23.97540509259259,3,71,5,76
2015-02-04 16:39:50,313.1788425925926,6,137,53,190
2015-02-22 01:01:30,25.014664351851852,4,65,25,90
2015-02-23 19:17:13,24.946770833333332,3,132,66,198
2015-02-20 07:02:08,23.437962962962963,1,3,2,5
2015-01-28 19:04:58,1.1240625,1,58,17,75
2015-01-26 13:14:29,0.2701388888888889,1,0,4,4
2015-01-25 10:58:47,0.8514814814814815,1,4,4,8
2015-01-23 06:36:26,0.4288310185185185,1,9,5,14
2015-05-10 20:34:10,108.92065972222223,1,11,0,11
2015-01-21 22:03:24,0.02962962962962963,2,2,2,4
2015-01-21 21:14:01,0.12685185185185185,2,204,135,339
2015-01-23 13:40:35,2.555162037037037,3,99,0,99
2015-01-20 08:59:23,0.008946759259259258,1,9,8,17
2015-01-20 04:38:47,0.18346064814814814,3,61,55,116
2015-01-19 20:12:46,0.03635416666666667,1,2,2,4
2015-01-20 21:39:36,12.881666666666666,2,69,0,69
2015-01-19 22:00:04,0.8849537037037037,1,16,0,16
2015-01-19 09:59:27,0.707488425925926,3,33,22,55
2015-01-19 06:58:08,0.5969560185185185,1,0,1,1
2015-01-18 16:49:49,1.1940277777777777,4,1778,1656,3434
2015-01-23 20:38:55,5.342905092592592,2,16,5,21
2015-01-18 11:33:35,0.0594212962962963,1,9,4,13
2015-01-19 08:02:08,0.9622222222222222,1,6,3,9
2015-01-18 00:27:08,0.1418287037037037,1,11,11,22
2015-01-20 08:56:37,2.593599537037037,3,138,24,162
2015-01-17 22:06:49,0.3718518518518519,2,527,1,528
2015-01-18 11:42:39,1.0802430555555556,1,1,1,2
2015-01-17 22:54:07,0.5637847222222222,1,7,7,14
2015-01-16 21:10:40,0.08290509259259259,1,9,5,14
2015-01-16 20:28:55,0.08717592592592592,1,1,1,2
2015-01-18 13:21:46,1.972349537037037,1,0,5,5
2015-01-14 21:10:07,0.08622685185185185,1,2,1,3
2015-01-15 09:43:38,1.4115625,1,5,4,9
2015-01-14 09:36:02,0.8223148148148148,2,10,1,11
2015-01-12 16:46:12,0.15462962962962962,1,22,1,23
2015-01-15 20:46:24,3.480115740740741,1,567,2,569
2015-01-14 22:08:34,5.939282407407408,2,22,19,41
2015-01-20 20:38:54,55.16899305555555,6,811,118,929
2015-11-30 20:39:05,323.56761574074073,2,76,8,84
2015-01-11 13:54:53,0.8343287037037037,1,2,7,9
2015-01-10 12:47:19,1.9852777777777777,2,45,10,55
2015-04-28 17:07:18,0.9797337962962963,1,247,130,377
2015-01-08 07:36:40,0.251724537037037,1,0,29,29
2015-01-28 20:08:04,21.044247685185184,6,284,234,518
2015-01-07 23:18:43,0.12346064814814815,1,0,9,9
2015-01-15 22:04:14,8.322025462962962,3,64,13,77
2015-05-10 20:51:52,123.40657407407407,12,2049,893,2942
2015-01-21 12:19:05,15.599872685185185,1,257,21,278
2016-02-16 20:22:26,407.3300810185185,2,23,14,37
2015-01-04 17:49:07,0.013518518518518518,1,4,4,8
2015-04-27 19:26:24,114.03456018518519,5,41,21,62
2015-01-03 18:58:12,0.11878472222222222,1,1,1,2
2015-01-04 13:50:12,1.5035416666666668,6,249,241,490
2015-01-03 15:54:53,0.32513888888888887,1,0,6,6
2015-01-03 08:40:09,0.303599537037037,1,0,3,3
2015-01-03 08:42:25,0.38778935185185187,1,1,15,16
2015-01-07 17:02:47,93.52119212962963,3,613,88,701
2015-01-20 18:56:42,17.995555555555555,2,12,3,15
2016-02-17 18:30:25,411.1939814814815,3,149,66,215
2015-01-04 13:52:48,6.115439814814815,2,20,7,27
2015-01-03 08:56:39,0.9460416666666667,3,26,14,40
2015-01-06 16:53:01,5.021655092592592,5,121,83,204
2015-01-24 14:55:18,23.12173611111111,2,64,21,85
2015-01-19 20:39:55,19.45866898148148,4,136,4584,4720
2014-12-31 12:29:28,0.13927083333333334,2,30,15,45
2015-01-17 09:01:52,17.16199074074074,3,34,26,60
2014-12-31 17:00:03,1.7667824074074074,3,65,2,67
2014-12-31 00:29:36,0.2590046296296296,1,1,6,7
2014-12-30 21:42:45,0.16625,1,35,69,104
2014-12-30 15:08:26,0.07792824074074074,2,13,8,21
2014-12-30 13:36:55,0.6504398148148148,1,14,17,31
2014-12-30 13:35:58,0.7714004629629629,5,199,300,499
2014-12-29 21:54:42,0.07105324074074074,1,6,6,12
2014-12-29 08:53:49,0.2915740740740741,1,23,23,46
2015-01-11 23:02:15,14.278263888888889,2,80,96,176
2014-12-30 13:41:47,2.101122685185185,1,34,27,61
2014-12-28 09:29:29,0.26836805555555554,1,12,12,24
2014-12-29 08:49:27,1.2852199074074073,2,37,51,88
2014-12-28 09:18:56,0.33542824074074074,1,6,12,18
2014-12-28 14:23:37,0.7324189814814814,1,17,1,18
2015-01-16 13:26:33,25.80358796296296,3,355,231,586
2015-02-06 15:17:34,109.83501157407407,13,572,249,821
2014-12-27 12:12:50,0.4959027777777778,1,4,17,21
2014-12-31 14:32:46,4.7193402777777775,8,875,856,1731
2015-02-23 07:10:49,58.418761574074075,3,34,23,57
2014-12-26 21:45:53,0.08011574074074074,1,1,5,6
2014-12-26 19:28:44,2.396087962962963,3,7,3,10
2014-12-24 06:57:22,0.36420138888888887,1,1,1,2
2014-12-27 01:30:35,3.295324074074074,3,118,34,152
2015-01-24 13:25:12,32.51576388888889,1,380,2,382
2014-12-22 00:52:45,0.1738773148148148,4,14,11,25
2014-12-21 20:11:24,0.2401736111111111,4,97,434,531
2014-12-18 22:07:44,0.13674768518518518,3,19,3,22
2015-01-15 22:14:27,29.769872685185184,5,143,80,223
2014-12-18 17:41:53,0.014780092592592593,1,1,1,2
2014-12-18 22:32:33,1.0622800925925926,1,7,0,7
2014-12-21 10:33:15,4.398969907407407,2,25,6,31
2014-12-18 22:22:22,2.675451388888889,1,10,0,10
2014-12-16 15:43:27,11.241724537037037,2,60,58,118
2014-12-15 20:33:27,0.034965277777777776,2,6,6,12
2014-12-15 18:31:43,0.009027777777777777,1,1,1,2
2014-12-15 20:55:28,0.18792824074074074,1,1,19,20
2014-12-15 01:19:38,0.045856481481481484,1,4,4,8
2014-12-15 06:40:53,0.36061342592592593,1,7,7,14
2014-12-14 22:35:15,0.03791666666666667,1,1,1,2
2014-12-14 18:42:09,0.08145833333333333,1,30,30,60
2014-12-14 19:43:03,0.14842592592592593,2,20,15,35
2014-12-19 00:18:01,4.38287037037037,1,31,125,156
2014-12-13 17:38:54,0.09238425925925926,3,88,113,201
2015-01-02 14:01:35,20.223240740740742,3,30,14,44
2014-12-13 11:08:43,0.41640046296296296,1,62,61,123
2014-12-12 22:00:50,1.1919907407407409,1,17,12,29
2015-01-15 09:39:46,35.378055555555555,2,39,84,123
2014-12-10 23:49:48,0.05736111111111111,1,9,9,18
2014-12-13 11:45:15,2.5553125,1,6,6,12
2014-12-14 11:32:52,3.595138888888889,1,0,1,1
2014-12-21 19:45:34,11.856284722222222,3,151,226,377
2014-12-13 10:58:57,3.3006828703703706,5,22,92,114
2015-04-12 07:26:41,144.4769560185185,24,5267,1385,6652
2014-12-08 13:23:13,0.5773148148148148,1,29,3,32
2014-12-11 05:12:57,3.3045601851851854,2,6,114,120
2014-12-17 20:07:51,13.29574074074074,3,56,64,120
2014-12-07 21:41:32,3.359988425925926,2,1,32,33
2014-12-07 20:28:14,0.10615740740740741,2,12,12,24
2014-12-13 21:49:47,6.272835648148148,2,5,5,10
2014-12-08 22:32:03,1.298761574074074,1,94,12,106
2014-12-06 23:34:45,2.1883333333333335,2,8,8,16
2014-12-03 22:35:15,0.003171296296296296,1,4,3,7
2014-12-07 13:58:02,4.878993055555555,3,17,8,25
2014-12-07 13:44:53,4.848229166666667,2,8,2,10
2014-12-02 18:31:26,0.08498842592592593,1,0,2,2
2014-12-13 11:34:41,12.907581018518519,1,73,78,151
2014-12-01 22:10:15,1.1379976851851852,1,1,0,1
2014-12-21 10:39:54,20.834467592592592,1,20,10,30
2014-12-08 22:25:29,8.619525462962963,2,11,2,13
2014-11-30 23:09:08,0.9312847222222222,3,218,12,230
2014-11-28 16:17:25,0.4266087962962963,1,14,0,14
2014-11-28 19:06:43,1.0030208333333333,1,3,2,5
2014-11-28 07:28:58,152.55745370370371,2,38,16,54
2014-11-26 20:36:32,1.1857754629629629,1,4,4,8
2014-12-07 16:52:06,12.609074074074075,2,159,30,189
2014-11-25 19:45:54,10.636898148148148,3,73,26,99
2016-02-16 22:14:13,502.93391203703703,28,25502,15408,40910
2014-11-23 22:59:39,0.033136574074074075,3,22,10,32
2014-11-23 21:58:42,0.0020601851851851853,1,2,2,4
2014-11-23 20:37:46,84.45297453703704,2,39,8,47
2014-11-23 18:43:58,27.747152777777778,1,319,16,335
2014-11-22 22:19:12,40.0724537037037,4,158,61,219
2014-11-22 21:38:36,0.11170138888888889,2,6,7,13
2014-11-22 21:09:47,163.13193287037038,10,2061,540,2601
2014-11-22 21:41:08,0.20450231481481482,1,59,72,131
2014-11-22 11:26:07,0.03712962962962963,1,9,9,18
2014-11-22 11:17:55,0.7167361111111111,1,8,0,8
2014-11-22 02:41:22,0.4421759259259259,1,6,6,12
2014-11-22 16:43:57,2.079861111111111,2,1,2,3
2014-11-18 21:29:51,1.0591550925925926,1,128,67,195
2014-11-23 15:45:59,6.14025462962963,1,1,10,11
2015-02-19 10:45:38,94.62756944444445,2,9,1,10
2014-11-18 17:48:36,2.1137615740740743,1,1,1,2
2014-11-22 21:49:46,8.325266203703704,2,78,10,88
2014-11-22 11:11:14,8.766747685185186,2,52,18,70
2014-11-13 21:57:29,0.24775462962962963,1,3,2,5
2014-11-22 12:52:07,8.94457175925926,1,36,23,59
2014-11-13 22:12:31,0.3978703703703704,1,45,12,57
2014-12-26 19:52:26,45.61806712962963,13,1625,110,1735
2014-12-19 00:52:27,38.16564814814815,1,11,0,11
2014-11-09 20:48:59,0.018483796296296297,1,2,2,4
2014-11-22 16:25:33,13.34792824074074,1,172,71,243
2014-12-07 15:11:19,29.61244212962963,1,178,61,239
2014-11-22 11:52:37,15.11505787037037,1,46,11,57
2014-11-22 11:14:43,83.05133101851852,2,52,33,85
2014-12-09 07:46:57,36.407673611111115,1,24,20,44
2014-11-03 17:31:06,0.8681712962962963,2,9,14,23
2014-11-02 16:38:55,0.011770833333333333,1,2,2,4
2014-10-29 14:06:47,0.7051851851851851,1,6,2,8
2014-10-28 11:55:21,0.13475694444444444,1,52,52,104
2014-10-28 21:52:14,2.179826388888889,2,39,15,54
2014-11-19 14:26:19,26.06300925925926,1,18,8,26
2014-10-29 00:41:17,5.3753125,1,1,1,2
2014-11-22 19:13:33,31.997881944444444,1,27,1,28
2014-10-21 10:38:44,0.08918981481481482,1,11,12,23
2014-11-24 19:39:47,35.20693287037037,3,22,35,57
2014-10-20 13:24:57,0.005520833333333333,1,1,1,2
2014-11-22 16:36:42,34.48134259259259,2,8,3,11
2014-10-22 18:05:29,4.956006944444445,3,25,16,41
2014-10-17 14:46:47,0.21335648148148148,1,7,7,14
2014-10-30 10:48:12,13.98917824074074,1,7,3,10
2014-11-22 22:19:17,40.07251157407408,3,100,16,116
2014-10-29 00:46:23,19.434166666666666,1,6,0,6
2014-10-14 20:01:22,6.824513888888889,1,13,2,15
2014-11-23 20:34:49,46.91684027777778,1,22,11,33
2014-10-07 15:01:49,0.06858796296296296,1,1,0,1
2014-10-07 06:36:44,0.3697800925925926,1,13,7,20
2014-11-23 10:06:00,47.69413194444444,1,71,29,100
2014-10-04 16:52:03,0.87,2,14,5,19
2014-10-08 17:10:04,7.892928240740741,2,52,51,103
2014-09-26 14:37:50,0.1526736111111111,1,2,2,4
2014-09-26 21:31:24,1.3834722222222222,1,5,5,10
2015-03-27 12:24:50,124.18494212962963,40,28418,10909,39327
2014-09-23 21:56:30,0.09878472222222222,1,6,5,11
2014-09-26 06:48:10,3.6410300925925925,2,18,10,28
2014-09-22 15:10:39,0.0484375,1,1,0,1
2014-12-21 10:20:45,90.32409722222222,3,151,3,154
2014-09-23 13:09:31,2.899050925925926,4,2560,2881,5441
2014-09-19 21:02:37,0.07319444444444445,1,6,5,11
2014-09-19 01:50:35,0.08606481481481482,1,5,3,8
2014-09-20 11:23:37,1.6375347222222223,1,1,1,2
2014-09-25 12:13:31,6.769780092592592,3,25,16,41
2015-01-01 10:59:55,105.63043981481482,3,89,35,124
2014-09-23 12:30:41,6.678287037037037,3,33,7,40
2014-09-16 21:06:38,1.0367708333333334,1,4,4,8
2014-09-15 20:34:08,0.06053240740740741,2,14,4,18
2014-12-21 20:39:37,97.08357638888889,4,91,75,166
2014-09-16 21:07:33,1.7463773148148147,1,4,0,4
2014-10-16 12:46:44,35.6928125,5,81,125,206
2014-09-23 16:23:57,14.835046296296296,2,272,6,278
2014-09-23 14:06:26,13.40150462962963,9,606,149,755
2014-09-08 13:54:08,1.4477314814814815,2,56,20,76
2014-09-06 10:40:55,0.07982638888888889,1,2,2,4
2014-09-09 14:03:12,5.633541666666667,2,46,20,66
2014-09-04 13:58:41,0.2191087962962963,1,43,0,43
2014-09-04 14:12:08,0.35072916666666665,2,24,14,38
2017-11-09 20:03:44,1162.8374537037037,18,300745,273648,574393
2014-09-04 20:51:48,0.9675810185185185,1,20,10,30
2014-09-16 21:08:56,16.233900462962964,5,82,28,110
2014-09-03 18:52:31,0.07567129629629629,1,0,32,32
2014-09-02 21:35:53,0.4350115740740741,1,0,1,1
2016-05-05 18:06:05,837.5442939814815,4,194,21,215
2014-09-02 05:33:00,0.19440972222222222,5,15,8,23
2014-09-01 20:07:34,0.0353125,1,3,3,6
2014-09-02 21:34:14,1.2193402777777778,1,3,2,5
2014-09-02 21:34:41,1.3024305555555555,1,1,4,5
2014-09-01 14:06:28,0.0490625,1,7,12,19
2014-10-29 01:58:08,147.7047685185185,3,1170,1899,3069
2014-09-01 14:29:05,0.8161342592592593,2,119,168,287
2014-09-02 21:37:51,0.5944675925925926,1,2,1,3
2014-09-02 22:12:22,2.293148148148148,2,17,8,25
2014-09-02 21:54:37,2.424826388888889,1,160,31,191
2014-08-31 15:02:41,0.006655092592592593,1,2,1,3
2014-09-02 21:55:53,2.3019907407407407,1,4,5,9
2014-08-31 14:45:13,0.006493055555555556,1,5,1,6
2014-08-31 17:34:59,0.1282986111111111,1,4,2,6
2014-08-31 13:44:32,0.009375,1,570,0,570
2014-08-31 11:40:26,0.00587962962962963,1,24,18,42
2014-08-31 14:28:28,0.1220949074074074,2,11,10,21
2014-11-22 18:28:46,83.33063657407408,4,26,8,34
2014-08-31 11:08:33,0.015347222222222222,1,2,1,3
2014-09-05 15:24:18,5.20369212962963,3,52,17,69
2014-08-31 11:06:13,0.042326388888888886,2,2,2,4
2014-08-31 11:43:35,0.09123842592592593,2,79,75,154
2014-08-31 19:49:53,0.41596064814814815,5,37,5,42
2014-08-31 09:26:58,0.017083333333333332,1,25,34,59
2014-08-31 08:44:14,0.012881944444444444,1,4,2,6
2014-09-02 21:58:51,2.984050925925926,5,24,12,36
2014-08-30 11:06:14,0.03005787037037037,1,8,19,27
2014-08-31 12:44:41,195.04358796296296,4,79,31,110
2014-09-03 16:57:03,5.926099537037037,1,918,223,1141
2014-08-28 19:09:34,0.08332175925925926,1,2,2,4
2014-08-31 13:01:41,2.8846527777777777,2,2,2,4
2014-08-29 14:07:22,1.0217013888888888,2,5,3,8
2014-08-29 12:52:36,7.996539351851852,4,12,17,29
2014-08-29 23:36:59,2.4636921296296297,1,1,1,2
2014-08-26 19:19:21,0.032303240740740743,1,10,4,14
2014-08-24 15:45:19,0.10721064814814815,1,1,0,1
2014-08-30 13:34:38,6.066886574074074,3,12,2,14
2014-08-30 13:48:35,6.95644675925926,1,7,8,15
2014-08-23 10:54:11,0.5526620370370371,5,11,10,21
2014-08-22 12:28:06,0.03239583333333333,1,2,2,4
2014-08-28 11:52:06,6.480358796296296,1,2,2,4
2014-08-21 16:28:20,0.06873842592592593,1,2,2,4
2014-08-21 14:39:51,0.8760069444444445,1,1,1,2
2014-08-19 20:21:48,0.2495138888888889,3,13,6,19
2014-08-23 17:01:56,6.503449074074074,1,40,13,53
2014-08-17 11:55:44,0.7042824074074074,2,8,5,13
2014-08-17 11:57:14,1.6197800925925927,1,156,96,252
2014-08-17 12:00:08,1.7453125,2,16,6,22
2014-08-15 15:22:01,1.4589467592592593,1,200,1290,1490
2014-08-14 16:30:19,0.7723032407407407,1,1,1,2
2014-08-15 17:50:49,1.872349537037037,1,7,6,13
2014-08-14 16:31:37,0.9070717592592593,3,178,513,691
2014-08-31 10:29:34,17.954305555555557,1,32,2,34
2016-01-03 20:18:04,3.058923611111111,5,169,89,258
2014-08-12 14:29:28,4.329756944444444,1,5,2,7
2014-08-26 03:17:43,20.249108796296298,2,67,12,79
2014-08-17 15:37:04,11.840208333333333,1,2,2,4
2014-08-12 14:17:44,6.800474537037037,1,7,0,7
2014-08-13 17:50:05,8.069525462962963,2,10,10,20
2014-08-05 03:57:05,0.08337962962962962,2,68,1,69
2014-08-13 21:51:38,12.115555555555556,1,15,6,21
2014-08-12 21:06:55,11.128541666666667,1,1,1,2
2014-07-31 09:54:19,0.06049768518518518,2,10,2,12
2014-08-11 18:43:12,11.735891203703703,4,599,31,630
2014-07-28 18:07:27,4.817407407407408,1,4,1,5
2014-08-31 14:22:20,37.763321759259256,8,233,135,368
2014-07-24 21:36:27,0.0010763888888888889,1,0,9,9
2014-07-24 18:05:48,0.015196759259259259,1,2,2,4
2014-08-12 21:25:40,20.473425925925927,1,14,4,18
2014-08-29 23:13:46,38.005636574074074,2,10,6,16
2014-08-29 15:01:23,43.974826388888886,20,596,152,748
2014-07-31 21:55:09,11.249212962962963,3,120,75,195
2014-08-18 17:03:15,30.92732638888889,8,298,32,330
2014-07-18 06:06:31,0.3431018518518518,1,2,1,3
2014-07-19 13:48:24,2.7348032407407405,4,91,52,143
2014-07-16 23:27:35,0.2821064814814815,1,8,0,8
2014-08-29 14:04:09,43.952152777777776,1,15,2,17
2014-07-15 12:09:02,0.041631944444444444,1,18,18,36
2014-08-23 16:11:57,39.72738425925926,4,243,207,450
2014-08-12 15:41:18,35.02002314814815,1,994,2264,3258
2014-07-15 12:11:32,2.1534375,3,39,37,76
2014-07-16 16:36:13,4.627928240740741,1,2,2,4
2014-07-10 21:38:23,0.01685185185185185,1,1,1,2
2014-07-13 10:09:05,3.0129282407407407,2,30,9,39
2014-07-21 20:20:25,12.16869212962963,2,25,15,40
2014-07-08 22:47:22,0.038703703703703705,1,3,1,4
2014-07-07 19:16:22,0.9983564814814815,1,7,5,12
2014-08-17 15:31:27,42.535381944444445,6,315,140,455
2014-08-17 15:59:13,43.105613425925924,1,2,4,6
2014-07-05 09:45:38,0.9399652777777778,1,10,1,11
2014-07-23 00:28:10,19.16085648148148,1,2,1,3
2014-09-08 19:06:49,68.69491898148148,9,6960,1851,8811
2014-06-30 15:14:48,1.1720717592592593,1,591,871,1462
2014-06-26 19:29:15,0.2893634259259259,1,7,2,9
2014-06-26 06:59:27,0.3637962962962963,1,2,2,4
2014-06-24 11:58:37,0.8021412037037037,1,5,0,5
2014-08-31 14:13:19,71.37880787037037,19,34722,34366,69088
2014-06-21 09:38:50,0.7174768518518518,1,5,0,5
2014-08-31 10:37:12,72.54252314814815,4,203,93,296
2014-07-13 10:06:58,24.632083333333334,2,22,0,22
2015-02-23 06:29:28,251.22822916666667,5,63,67,130
2014-06-15 22:18:20,0.44104166666666667,1,17,0,17
2014-06-15 20:59:04,0.19414351851851852,1,17,4,21
2014-06-15 20:59:30,0.1996527777777778,1,11,22,33
2014-08-31 11:04:16,77.97494212962962,1,8,8,16
2014-06-14 15:06:59,4.5789583333333335,2,16,8,24
2014-06-10 19:46:46,1.397361111111111,1,3,1,4
2014-06-14 18:35:48,12.04712962962963,1,57,203,260
2014-08-23 16:30:19,77.73606481481481,3,195,64,259
2014-06-09 17:54:48,2.74,3,5,5,10
2015-01-20 23:11:07,234.15636574074074,13,1842,645,2487
2014-07-06 02:25:47,32.97635416666667,3,269,147,416
2014-06-14 16:13:49,12.814710648148148,1,1,1,2
2014-06-14 18:16:46,10.366400462962963,2,6,3,9
2014-06-10 19:32:09,6.505671296296296,1,22,5,27
2014-06-18 15:15:18,15.757766203703703,1,53,7,60
2014-06-04 15:48:24,1.1002777777777777,3,30,16,46
2014-06-02 04:35:20,0.3426736111111111,1,8,0,8
2014-06-01 20:09:45,0.01068287037037037,1,43,43,86
2014-06-14 15:23:46,16.261157407407406,3,216,37,253
2014-05-27 17:14:19,0.08439814814814815,2,22,22,44
2014-06-14 16:49:09,18.72508101851852,1,9,0,9
2014-07-05 15:33:12,39.699756944444445,1,12,1,13
2014-05-27 04:12:26,0.4638657407407407,7,489,49,538
2014-06-01 11:26:16,10.89917824074074,4,467,743,1210
2014-05-26 19:18:42,1.357164351851852,1,16,1,17
2014-12-18 20:08:22,0.9707638888888889,4,332,308,640
2015-01-02 15:11:50,223.79805555555555,1,13,15,28
2014-06-15 21:10:44,26.145810185185184,2,85,37,122
2014-05-20 12:30:55,0.5043981481481481,1,14,3,17
2014-08-31 14:38:56,103.99622685185186,2,7,3,10
2014-05-24 13:31:31,6.501759259259259,1,2,2,4
2014-05-18 12:56:20,1.3734490740740741,3,331,259,590
2014-05-17 00:31:40,0.03467592592592592,1,10,8,18
2014-05-17 12:14:03,0.5992013888888889,1,1,1,2
2014-05-16 23:21:44,0.07956018518518519,1,2,0,2
2014-05-24 14:09:58,7.788483796296297,1,159,3,162
2014-05-15 16:10:23,0.041574074074074076,1,1,1,2
2014-05-29 20:57:19,16.076863425925925,1,20,15,35
2014-06-14 16:55:50,32.64579861111111,3,40,22,62
2014-08-23 17:31:31,102.80510416666667,5,61,18,79
2014-05-12 06:03:38,60.59888888888889,1,1,4,5
2014-06-14 17:15:53,34.12824074074074,4,233,36,269
2014-05-12 14:46:39,1.9028935185185185,2,63,19,82
2014-05-12 03:50:42,1.4577083333333334,1,11,16,27
2014-05-10 15:22:39,0.024467592592592593,2,16,16,32
2014-05-10 15:59:20,0.9169560185185185,1,19,35,54
2014-05-10 14:20:45,0.8999074074074074,1,29,14,43
2014-08-29 19:58:28,113.048125,2,338,20,358
2014-05-07 21:18:33,0.04392361111111111,1,0,5,5
2014-05-10 13:45:32,2.7874652777777778,2,21,23,44
2014-05-11 11:58:42,3.6919791666666666,2,37,7,44
2014-05-10 13:53:37,2.882349537037037,1,4,1,5
2014-05-07 17:50:04,0.7547337962962963,1,18,0,18
2014-06-14 17:19:35,39.50694444444444,4,18,6,24
2014-05-17 12:38:28,12.854756944444444,1,0,5854,5854
2014-09-04 16:55:13,235.06730324074073,6,552,191,743
2014-05-06 07:27:00,4.2076620370370375,18,711,640,1351
2014-05-20 19:18:10,19.131203703703704,10,357,517,874
2014-05-02 10:14:45,0.7776620370370371,1,4,1,5
2014-05-01 14:37:22,1.3798032407407408,1,74,19,93
2014-05-26 19:29:19,29.099166666666665,3,63,25,88
2014-04-25 18:51:27,0.05427083333333333,1,2,2,4
2014-05-17 13:46:17,22.93650462962963,9,267,152,419
2014-04-22 20:03:21,0.23376157407407408,2,70,64,134
2014-05-17 12:40:40,25.707175925925927,2,13,1,14
2014-04-27 12:12:25,6.059930555555556,1,25,5,30
2014-04-22 20:50:48,3.2609837962962964,5,62,37,99
2014-04-19 13:33:28,0.8406134259259259,1,19,10,29
2014-04-18 06:44:05,5.699710648148148,5,132,12,144
2014-04-27 12:07:38,13.063287037037037,1,55,53,108
2014-04-28 21:37:10,15.058645833333333,1,5,0,5
2014-04-23 06:26:26,9.476585648148149,1,28,2,30
2014-04-13 20:39:36,0.6174305555555556,1,40,40,80
2014-04-12 02:27:39,0.030706018518518518,1,1,1,2
2014-04-27 14:44:44,16.956956018518518,1,27,281,308
2014-04-22 21:45:58,13.760509259259258,3,20,8,28
2014-04-07 21:00:38,1.8787152777777778,1,8,4,12
2014-04-05 08:09:06,0.3853125,1,6,1,7
2014-04-13 20:35:54,10.002962962962963,1,2,2,4
2014-04-08 03:48:35,4.594131944444444,1,2,2,4
2014-04-02 18:27:36,0.6041435185185186,1,87,14,101
2014-04-02 23:14:58,1.0888310185185186,3,246,224,470
2014-04-01 21:03:15,1.059247685185185,1,1,1,2
2014-04-01 21:21:07,2.074664351851852,8,493,571,1064
2014-04-23 20:19:12,24.163993055555554,1,51,5,56
2014-05-12 04:21:56,45.068275462962966,1,45,15,60
2014-03-27 19:42:43,17.399178240740742,3,4,16,20
2014-04-03 01:13:37,6.470486111111111,2,7,1,8
2014-03-27 20:59:58,0.3792476851851852,1,5,4,9
2014-04-27 20:31:23,34.93357638888889,1,1,1,2
2014-03-23 21:29:57,0.06383101851851852,1,3,3,6
2014-03-23 20:31:50,0.13751157407407408,2,20,7,27
2014-03-22 18:12:30,0.1252199074074074,1,11,10,21
2014-04-27 13:14:43,35.97415509259259,3,72,15,87
2014-03-22 19:15:07,3.9449189814814813,4,181,110,291
2014-03-21 21:33:48,0.9225347222222222,1,2,1,3
2014-03-22 14:35:10,3.8086805555555556,5,86,15,101
2014-03-18 19:37:02,0.08385416666666666,2,6,4,10
2014-03-17 14:50:05,0.07170138888888888,2,152,0,152
2014-03-21 21:23:56,4.481087962962963,2,10,1,11
2014-03-17 20:02:24,0.630474537037037,1,1,1,2
2014-04-13 20:34:45,146.10696759259258,15,987,567,1554
2014-03-23 11:27:12,7.4518402777777775,1,2,6,8
2014-03-12 15:32:59,0.5169097222222222,1,0,11,11
2014-05-16 15:48:21,73.42771990740741,43,3598,2105,5703
2015-01-01 09:21:52,1053.1969444444444,5,616,213,829
2014-03-15 22:55:35,7.289560185185185,18,1319,466531,467850
2014-03-06 21:15:55,0.946400462962963,1,18,4,22
2014-03-08 19:40:50,2.978969907407407,3,289,83,372
2014-03-05 07:02:52,0.3200810185185185,1,1,0,1
2014-03-04 16:42:49,0.7783217592592593,1,2,0,2
2014-03-02 14:57:36,0.5620138888888889,1,2,0,2
2014-03-02 15:27:03,1.0916782407407408,1,1,1,2
2014-02-28 07:11:58,0.34230324074074076,1,2,2,4
2014-02-27 22:34:14,0.08055555555555556,6,84,25,109
2014-02-27 22:19:27,0.026122685185185186,2,4,3,7
2014-02-27 21:49:37,0.06569444444444444,1,26,7,33
2014-03-12 16:21:07,12.80375,3,10,7,17
2014-02-27 20:06:59,0.028333333333333332,4,120,78,198
2014-04-20 22:32:06,52.25212962962963,6,104,66,170
2014-06-14 17:30:35,107.12108796296296,1,10,3,13
2014-02-27 19:16:58,0.8059837962962964,1,17,17,34
2014-02-27 07:19:08,0.3130324074074074,1,10,3,13
2014-03-09 16:37:01,10.813402777777778,2,35,5,40
2014-02-26 07:19:35,0.30712962962962964,1,54,3,57
2014-02-25 23:44:42,0.11521990740740741,1,38,20,58
2014-02-25 22:21:34,0.08965277777777778,1,15,4,19
2014-02-25 20:58:16,0.03210648148148148,1,82,10,92
2014-02-25 20:41:54,0.052453703703703704,1,53,0,53
2014-02-25 18:17:22,0.22592592592592592,5,24,14,38
2014-02-25 07:39:44,0.36797453703703703,7,41,61,102
2014-02-24 22:58:30,0.006608796296296297,1,7,0,7
2014-08-30 12:58:18,186.61011574074075,2,134,35,169
2014-02-24 21:04:50,0.017083333333333332,1,4,4,8
2014-02-23 21:15:28,0.00443287037037037,1,106,92,198
2014-02-23 16:29:22,0.06592592592592593,1,4,2,6
2014-02-27 20:28:06,4.253715277777777,1,7,5,12
2014-02-25 22:34:53,3.3560300925925928,1,41,0,41
2014-02-23 17:08:25,1.239074074074074,1,1,0,1
2014-02-27 07:18:58,5.300682870370371,1,228,9,237
2014-02-23 16:32:04,1.8684027777777779,4,303,144,447
2014-02-21 19:43:59,0.0565162037037037,1,689,607,1296
2014-02-20 08:30:43,0.17866898148148147,1,33,18,51
2014-02-20 00:13:18,0.009143518518518518,1,11,11,22
2014-02-23 17:04:19,3.774826388888889,1,17,1,18
2014-02-24 20:38:54,7.830428240740741,8,467,180,647
2014-02-19 23:00:41,0.08423611111111111,1,12,0,12
2014-05-28 17:40:31,98.71787037037036,1,216,11,227
2014-02-18 21:45:45,0.008460648148148148,1,5,0,5
2014-05-11 11:07:36,81.57346064814814,2,6,1,7
2014-02-18 21:42:52,0.05207175925925926,1,6,1,7
2014-02-18 21:30:28,0.06274305555555555,1,41,0,41
2014-02-19 11:36:38,0.7680324074074074,1,1,1,2
2014-05-01 22:55:46,211.22810185185185,86,376020,590632,966652
2016-02-01 21:46:05,715.0242476851852,5,369,94,463
2014-02-19 17:25:20,3.665474537037037,1,6,4,10
2014-02-16 02:23:13,0.15480324074074073,1,3,3,6
2014-02-23 17:42:51,8.176296296296297,1,3,4,7
2014-02-15 13:12:35,0.5719675925925926,3,2825,787,3612
2014-02-14 20:57:17,0.2442013888888889,2,16,5,21
2014-02-13 10:01:16,0.07972222222222222,1,9,9,18
2014-02-13 18:25:13,7.7294328703703705,4,142,34,176
2014-02-19 11:47:30,6.506759259259259,2,4,6,10
2014-02-12 22:33:04,0.08462962962962962,3,11,14,25
2014-02-24 21:54:13,12.412280092592592,2,59,2,61
2014-02-12 22:07:53,0.5622916666666666,1,5,0,5
2014-02-12 14:05:57,0.7312962962962963,1,5,6,11
2014-02-16 14:59:54,5.192152777777777,1,18,12,30
2014-02-12 22:40:59,1.7542708333333332,1,141,96,237
2014-02-24 07:10:35,13.23394675925926,1,36,1,37
2014-02-12 21:40:36,2.6365046296296297,3,32,5,37
2014-02-09 18:50:32,0.24717592592592594,1,8,6,14
2014-02-09 14:01:32,0.9289120370370371,2,5,5,10
2014-02-09 12:10:20,0.887974537037037,1,1,1,2
2014-02-12 21:41:38,4.9312962962962965,1,46,3,49
2014-02-12 22:17:39,5.476689814814815,3,50070,833,50903
2014-02-07 13:38:49,0.5467824074074074,1,50,0,50
2014-02-23 16:37:42,16.76417824074074,1,33,30,63
2014-02-06 19:45:08,0.03900462962962963,1,8,0,8
2014-02-08 12:32:06,2.5525231481481483,1,36,22,58
2014-02-07 13:36:07,2.025023148148148,1,39,15,54
2014-02-09 12:14:58,4.015740740740741,2,165,39,204
2014-02-04 22:56:41,0.1401273148148148,2,55,9,64
2014-02-04 21:19:01,0.14377314814814815,1,3,0,3
2014-02-07 15:14:40,3.724039351851852,1,54,19,73
2014-03-09 16:44:24,40.82440972222222,3,185,138,323
2014-02-25 21:31:00,23.257453703703703,1,129,19,148
2014-02-14 21:33:29,12.50087962962963,2,4799,4046,8845
2014-02-09 12:09:39,7.1613541666666665,4,89,125,214
2014-02-07 13:27:17,5.417731481481481,1,6,59,65
2014-02-13 18:22:13,11.848472222222222,7,363,239,602
2014-02-01 18:29:57,0.26644675925925926,1,2,2,4
2014-01-30 00:30:28,0.33244212962962966,1,1,64,65
2014-02-01 17:25:09,3.691053240740741,5,199,37,236
2014-01-30 17:52:43,1.8159375,3,55,27,82
2014-01-29 00:03:41,0.3639351851851852,3,91,4,95
2014-01-30 19:31:16,2.7691550925925927,10,178,137,315
2014-01-29 00:13:17,1.809189814814815,1,91,18,109
2014-02-02 11:56:19,6.582592592592593,1,35,1,36
2014-02-07 23:10:52,12.755335648148149,12,221,261,482
2014-01-31 13:14:27,8.752893518518519,7,38,37,75
2014-01-25 20:24:54,22.03761574074074,1,1,4,5
2014-01-24 14:32:18,0.07078703703703704,1,27,20,47
2014-01-25 20:15:18,1.428275462962963,1,11,5,16
2014-01-23 18:54:35,23.128113425925925,4,146,6,152
2014-02-01 18:22:21,9.889039351851851,8,2031,1748,3779
2014-01-25 14:53:26,2.8357060185185183,1,8,6,14
2014-01-22 08:53:16,1.4611689814814814,3,315,135,450
2014-01-23 06:05:27,2.359560185185185,1,4,2,6
2014-09-09 14:23:55,233.64792824074075,5,205,83,288
2014-02-01 17:29:48,13.85519675925926,5,338,50,388
2014-01-31 12:05:12,12.791296296296297,4,43,122,165
2014-02-24 19:36:06,38.31690972222222,4,66,32,98
2014-01-16 13:27:39,1.8234837962962962,3,8536,1421,9957
2014-02-04 03:48:14,26.52037037037037,9,278,234,512
2014-01-11 17:40:06,0.12818287037037038,1,29,9,38
2014-01-11 15:19:43,0.04013888888888889,1,2,1,3
2014-01-11 14:28:38,1.6947800925925927,4,78,77,155
2014-01-09 21:45:37,65.30082175925926,1,2,2,4
2014-01-05 09:56:09,0.09398148148148149,1,4,4,8
2014-01-31 12:27:36,27.01653935185185,4,57,23,80
2014-02-16 18:09:37,46.227407407407405,12,417,669,1086
2013-12-31 10:33:29,0.9782060185185185,8,195,148,343
2013-12-30 12:37:46,0.022581018518518518,1,1,0,1
2013-12-31 00:23:51,0.6486111111111111,2,10,10,20
2013-12-29 11:26:10,1.3471064814814815,2,4,26,30
2016-10-21 21:17:21,1033.542986111111,39,4909,1786,6695
2013-12-26 22:28:06,2.9754976851851853,6,295,72,367
2013-12-26 08:58:06,5.566331018518518,1,18,1,19
2013-12-19 07:59:33,0.1605324074074074,1,3,3,6
2015-04-06 13:18:13,474.55368055555556,1,291,2,293
2013-12-18 11:00:09,0.5726273148148148,2,112,109,221
2014-02-19 18:47:03,64.92127314814815,3,44,20,64
2013-12-27 17:13:16,11.235497685185186,3,23,3,26
2013-12-15 22:31:58,0.09167824074074074,1,1,0,1
2013-12-15 14:04:15,0.11648148148148148,2,177,165,342
2013-12-14 17:51:30,0.42520833333333335,1,147,3,150
2013-12-13 08:49:11,0.1809375,1,11,1,12
2013-12-15 13:32:17,2.8003935185185185,1,71,11,82
2014-02-02 13:50:09,84.80966435185185,2,59,9,68
2014-06-23 16:39:14,195.9442013888889,11,328,234,562
2014-02-01 19:12:00,54.62021990740741,7,245,22,267
2013-12-09 15:19:27,0.7724189814814815,6,20,9,29
2013-12-15 19:09:03,7.279270833333333,5,44,112,156
2013-12-15 13:35:00,7.095011574074074,1,4,0,4
2013-12-25 16:08:40,18.075243055555557,6,10126,10058,20184
2013-12-07 19:30:26,0.30215277777777777,1,33,1,34
2013-12-06 18:30:40,1.1141782407407408,2,607,554,1161
2014-02-24 21:00:12,81.9234375,2,43,32,75
2013-12-15 13:36:29,10.678113425925925,1,4,7,11
2013-12-04 20:32:58,0.18480324074074075,1,5,3,8
2013-12-04 09:44:13,0.13565972222222222,2,14,2,16
2013-12-07 12:37:25,3.632037037037037,1,1,1,2
2015-05-05 19:02:58,518.0106597222223,2,25,15,40
2013-12-03 17:24:05,0.20398148148148149,3,19,4,23
2014-10-17 10:18:49,318.1634490740741,2,168,60,228
2015-11-24 19:14:38,722.0723726851852,9,795,468,1263
2013-12-02 19:14:31,3.340659722222222,9,237,435,672
2013-11-30 16:15:50,0.545150462962963,1,1,1,2
2013-12-01 18:35:27,279.80805555555554,4,96,38,134
2013-12-03 17:46:16,6.6225,12,260,165,425
2013-11-29 18:30:58,0.11039351851851852,1,2,2,4
2013-12-03 17:49:22,15.04298611111111,3,366,52,418
2013-11-24 21:17:17,0.0641087962962963,1,2,2,4
2013-11-23 04:45:15,0.027037037037037037,1,1,1,2
2013-12-03 17:52:45,12.750196759259259,2,10,2,12
2013-11-28 21:02:15,10.26074074074074,8,452,146,598
2014-01-31 13:37:28,77.45153935185185,31,2419,344,2763
2013-11-24 16:22:12,5.001435185185185,2,14,0,14
2013-12-15 19:34:18,60.960601851851855,11,564,101,665
2013-11-28 18:38:47,10.284456018518519,3,15,9,24
2013-11-28 20:48:25,11.906331018518518,5,35,286,321
2013-11-17 10:18:02,0.4516435185185185,3,19,2,21
2013-11-17 15:07:19,0.674675925925926,1,1,1,2
2013-11-16 18:17:39,0.03576388888888889,1,36,36,72
2013-11-16 15:38:25,0.02511574074074074,1,11,3,14
2013-11-16 14:25:34,1.5901157407407407,1,2,1,3
2013-11-16 15:07:45,2.3946064814814814,2,17,10,27
2013-11-14 15:07:05,1.6143402777777778,2,8,3,11
2013-11-12 19:50:31,0.41587962962962965,6,60,25,85
2013-11-16 14:40:42,4.75130787037037,1,14,1,15
2013-11-16 22:33:11,3.9121296296296295,1,197,144,341
2013-11-09 15:58:37,1.2469097222222223,2,23,4,27
2013-11-09 18:06:05,1.5842361111111112,2,15,5,20
2013-11-09 17:01:48,4.07068287037037,2,3,3,6
2013-11-06 04:09:28,0.6244212962962963,4,26,7,33
2013-11-09 14:06:43,6.540960648148148,1,95,3,98
2013-11-09 14:10:43,9.771446759259259,2,35,7,42
2013-10-29 14:17:27,0.5049305555555555,1,4,0,4
2013-10-29 00:23:24,0.19778935185185184,1,4,0,4
2013-10-28 23:58:37,0.2036689814814815,1,2,2,4
2013-10-29 17:23:18,1.0072337962962963,3,20,4,24
2015-08-05 23:42:51,650.0790277777778,2,52,17,69
2013-10-26 09:31:05,0.6241898148148148,1,84,1,85
2013-10-25 18:26:13,1.0172916666666667,1,3,3,6
2013-11-09 17:17:35,15.811481481481481,1,31,13,44
2013-11-09 14:11:57,15.958692129629629,1,9,9,18
2013-10-24 14:16:44,0.06987268518518519,3,0,5,5
2013-10-24 03:06:42,0.11334490740740741,2,20,20,40
2013-11-05 22:40:42,14.066793981481482,3,106,30,136
2013-10-22 18:13:09,0.004178240740740741,1,1,1,2
2013-11-09 14:13:19,18.231064814814815,2,15,14,29
2013-10-20 13:46:06,0.22789351851851852,1,1,1,2
2013-11-10 14:52:42,101.38092592592592,6,219,85,304
2013-11-09 14:14:36,20.864722222222223,2,13,11,24
2013-10-19 20:53:37,0.17056712962962964,1,8,0,8
2013-10-19 13:43:13,0.11923611111111111,1,13,4,17
2013-10-19 14:00:28,3.8046527777777777,2,2,2,4
2013-10-19 14:30:43,6.511296296296297,5,115,75,190
2013-10-20 21:02:02,7.301180555555556,4,256,113,369
2013-10-14 20:01:57,0.9953240740740741,1,18,20,38
2013-10-14 19:34:05,1.038148148148148,1,37,16,53
2013-10-13 11:43:09,0.5810648148148149,1,1,1,2
2013-10-12 13:27:55,0.04320601851851852,1,5,0,5
2013-11-12 19:52:52,31.966875,1,96,50,146
2013-10-11 22:10:56,0.12152777777777778,1,7,16,23
2013-10-11 18:55:22,1.8236805555555555,2,174,14,188
2013-10-12 14:29:18,2.83037037037037,2,296,220,516
2013-10-09 08:27:20,0.7442824074074074,1,18,29,47
2013-11-09 14:21:47,32.461030092592594,2,46,2,48
2013-10-07 19:27:14,0.21913194444444445,1,4,4,8
2013-10-06 17:14:23,0.14480324074074075,8,250,283,533
2013-10-04 08:34:28,0.03481481481481481,1,69,69,138
2013-10-06 15:29:25,3.1368055555555556,3,42,16,58
2013-10-03 19:01:37,3.057071759259259,2,40,31,71
2013-09-29 22:37:34,0.08950231481481481,2,4,4,8
2013-09-29 11:01:34,0.7493287037037037,1,0,6,6
2013-10-11 19:39:54,13.303564814814814,2,148,28,176
2013-10-04 15:06:31,7.8836458333333335,1,15,8,23
2013-09-26 17:46:52,0.006701388888888889,1,5,5,10
2013-10-09 08:30:22,13.501909722222223,1,10,1,11
2013-09-25 21:23:40,0.054293981481481485,1,23,9,32
2013-09-25 17:59:44,0.8916550925925926,1,1,1,2
2013-09-29 13:41:10,9.03486111111111,4,571,220,791
2013-09-29 13:37:25,5.027430555555555,4,14,13,27
2013-09-24 20:14:13,0.601574074074074,2,16,2,18
2013-10-04 16:30:38,10.966666666666667,4,48,6756,6804
2013-09-25 21:57:04,2.220810185185185,1,5,5,10
2013-09-25 18:09:56,7.93837962962963,1,25,9,34
2013-09-25 21:54:01,3.025787037037037,2,26,7,33
2013-09-22 20:22:27,0.014456018518518519,1,2,2,4
2013-10-12 11:40:16,19.849525462962962,4,120,62,182
2013-09-27 12:07:15,4.941111111111111,1,4,4,8
2013-09-22 21:49:15,1.074699074074074,1,9,5,14
2016-09-19 06:16:49,1121.7505671296296,14,1031,226,1257
2013-09-21 15:01:23,0.1570138888888889,4,23,11,34
2013-09-21 12:54:33,0.7313310185185186,2,62,12,74
2013-09-20 20:16:17,0.20435185185185184,1,2,1,3
2013-09-19 11:00:56,0.5194791666666667,1,24,5,29
2013-09-19 12:22:53,0.3996527777777778,1,18,12,30
2013-09-20 19:49:00,2.0167129629629628,1,50,6,56
2013-09-18 19:37:22,0.03190972222222222,1,24,24,48
2013-09-20 17:56:12,3.8034375,6,267,151,418
2013-09-17 17:01:10,0.9011111111111111,1,14,16,30
2013-11-24 20:01:07,70.17800925925926,42,3506,957,4463
2013-09-19 18:16:40,17.277766203703703,9,164,132,296
2013-09-22 14:29:51,6.9859837962962965,6,123,108,231
2013-09-14 16:52:49,0.03679398148148148,1,63,0,63
2013-09-14 16:40:15,0.8198263888888889,1,2,2,4
2013-09-14 13:38:11,0.03306712962962963,1,4,1,5
2013-09-22 13:19:43,37.405,16,402,181,583
2013-09-15 12:02:59,1.750949074074074,1,39,28,67
2013-09-13 15:40:20,1.7692476851851853,4,138,77,215
2013-09-15 14:29:33,3.5914814814814813,5,254,156,410
2013-09-12 08:36:49,0.14429398148148148,1,4,1,5
2013-09-13 17:48:12,1.8807175925925925,1,18,0,18
2013-09-15 11:49:00,5.088159722222223,4,75,36,111
2013-09-15 14:26:33,5.893449074074074,3,42,5,47
2013-09-15 11:00:13,6.563599537037037,6,75,50,125
2013-09-08 03:38:09,0.4933101851851852,3,53,54,107
2013-09-09 17:57:02,4.479930555555556,1,120,30,150
2013-09-09 17:47:26,5.149548611111111,2,6,0,6
2013-09-10 18:34:49,6.901215277777778,5,360,67,427
2013-09-09 17:58:38,5.954583333333333,3,4,4,8
2013-09-07 02:56:15,3.4106944444444443,1,1,1,2
2013-10-01 11:52:55,27.904247685185187,2,53,16,69
2013-09-07 03:13:15,3.772997685185185,1,23,23,46
2013-09-03 18:27:26,0.4847916666666667,2,1,3,4
2013-09-07 02:28:11,4.8503125,1,23,8,31
2013-09-01 19:21:04,0.10752314814814815,1,67,5,72
2013-09-01 13:22:35,0.05310185185185185,1,1,1,2
2013-09-08 03:54:55,13.576331018518518,3,12,6,18
2013-09-19 18:49:25,21.177141203703705,3,82,29,111
2013-09-01 12:55:07,3.3837152777777777,5,505,237,742
2013-09-01 09:49:41,3.5162962962962965,2,31,24,55
2013-09-01 10:54:28,4.137650462962963,1,21,0,21
2013-08-31 16:34:54,3.6413310185185184,2,82,39,121
2013-08-27 19:37:06,1.2314699074074074,1,58,171,229
2013-08-26 12:38:46,-0.0121875,1,100,82,182
2013-08-26 20:55:52,0.7262152777777777,2,16,31,47
2013-08-25 14:31:17,0.003935185185185185,1,4,0,4
2013-08-27 19:32:55,2.226400462962963,1,137,13,150
2013-09-08 03:54:58,13.57636574074074,2,11,5,16
2014-09-07 11:57:41,377.92471064814816,1,6,0,6
2013-08-27 22:28:04,2.396446759259259,2,9,3,12
2013-08-31 16:55:28,6.178368055555556,1,20,88,108
2013-08-25 11:41:31,0.03045138888888889,1,4,2,6
2013-08-25 10:36:53,0.041608796296296297,1,1,1,2
2013-08-25 09:36:20,0.011539351851851851,1,3,2,5
2013-08-25 10:15:36,0.13241898148148148,1,8,89,97
2013-09-01 13:15:39,7.16832175925926,1,2,0,2
2013-08-25 09:20:58,0.0017476851851851852,1,1,1,2
2013-09-15 20:52:06,22.003703703703703,2,111,268,379
2013-09-09 18:04:20,16.006747685185186,2,43,3,46
2013-08-25 09:28:17,1.7559143518518519,6,103,46,149
2013-09-15 10:31:40,22.903472222222224,7,78,24,102
2013-08-24 10:25:32,1.0462731481481482,2,17,10,27
2013-08-24 12:08:56,0.9178472222222223,1,20,0,20
2013-08-25 11:09:01,3.2585416666666664,2,83,17,100
2013-08-21 21:28:43,0.04332175925925926,2,26,28,54
2013-09-09 18:06:53,461.40105324074074,3,72,18,90
2013-08-26 07:30:02,4.457430555555556,1,0,81,81
2013-08-21 17:00:42,1.2963773148148148,5,91,23,114
2013-08-21 08:49:32,0.060856481481481484,2,17,17,34
2013-09-11 20:28:11,22.006215277777777,2,81,0,81
2013-09-15 20:06:19,27.010844907407407,4,211,44,255
2013-08-20 17:46:20,0.7711458333333333,2,67,28,95
2013-09-22 12:37:45,33.770833333333336,1,16,1,17
2013-09-01 10:02:04,12.742835648148148,5,457,172,629
2013-08-20 18:07:23,1.2956597222222221,2,38,0,38
2013-08-19 18:10:03,0.6877199074074074,1,31,7,38
2013-08-18 19:03:51,0.007361111111111111,1,1,0,1
2013-08-20 17:24:12,2.0660185185185185,3,13,4,17
2013-08-19 16:22:42,1.1112847222222222,1,87,50,137
2013-08-19 17:45:20,1.6991319444444444,3,109,2,111
2013-09-02 08:44:26,18.467407407407407,3,160,11,171
2013-08-18 14:01:43,0.9302199074074075,3,25,8,33
2013-08-21 09:10:50,3.827141203703704,2,19,13,32
2013-08-17 11:42:25,0.7904629629629629,4,396,312,708
2013-08-21 09:41:10,4.6004398148148145,2,10,3,13
2013-08-17 11:49:44,0.968738425925926,1,6,1,7
2013-08-18 14:05:03,3.255613425925926,2,8,11,19
2013-09-22 10:03:19,74.60982638888889,9,370,498,868
2013-08-17 13:41:17,3.783726851851852,1,72,24,96
2013-08-13 17:38:32,0.010833333333333334,2,37,7,44
2013-09-01 13:34:30,19.893391203703704,1,23,2,25
2013-08-12 06:23:36,0.14483796296296297,1,4,4,8
2013-08-16 03:36:52,4.442986111111111,2,130,261,391
2013-08-17 14:46:46,94.86247685185185,10,1051,85,1136
2013-08-15 05:29:02,3.6053703703703706,1,9,3,12
2013-08-11 10:17:24,0.32613425925925926,1,5,1,6
2013-08-08 14:43:56,0.03533564814814815,1,8,6,14
2013-08-21 08:09:27,13.033854166666666,8,177,324,501
2013-08-08 12:20:58,0.2309375,1,2,34,36
2013-08-07 22:10:29,0.025104166666666667,1,52,2,54
2013-08-08 19:14:12,1.0819675925925927,1,5,2,7
2013-08-07 20:34:56,0.1761574074074074,2,32,7,39
2013-08-08 21:31:49,1.406574074074074,2,241,241,482
2013-08-07 18:46:46,0.37440972222222224,1,23,4,27
2013-08-06 16:27:14,0.9650578703703704,1,4,1,5
2013-08-13 17:34:21,1.9368634259259259,4,59,60,119
2013-08-05 21:15:34,0.7216203703703704,1,4,4,8
2013-08-05 05:47:46,0.3405787037037037,1,0,5,5
2013-08-06 17:41:22,1.9906018518518518,1,20,20,40
2013-08-11 13:44:56,6.997534722222222,3,138,4,142
2013-08-06 16:54:49,11.288692129629629,1,24,4,28
2013-08-04 10:27:02,0.4582175925925926,1,14,5,19
2013-08-02 16:00:31,0.024224537037037037,1,18,54,72
2013-08-02 17:33:30,0.3734837962962963,4,51,21,72
2013-08-02 09:48:11,0.4843865740740741,1,3,11,14
2013-08-01 20:47:36,0.9880092592592593,4,19,6,25
2013-07-30 19:50:09,0.03111111111111111,1,6,3,9
2013-08-02 05:35:39,4.061180555555556,1,11,2,13
2013-07-25 20:42:26,0.3041435185185185,1,4,4,8
2013-08-08 18:48:41,143.38569444444445,1,7,0,7
2013-08-06 17:50:48,12.89773148148148,1,8,6,14
2013-08-06 17:53:18,11.759479166666667,1,491,427,918
2013-07-24 19:09:19,0.11011574074074074,1,4,0,4
2013-07-24 19:18:29,0.1550925925925926,1,3,2,5
2013-07-25 20:40:56,1.536689814814815,4,160,110,270
2013-07-23 16:44:41,0.46225694444444443,1,209,0,209
2013-07-22 19:45:44,126.44381944444444,1,1,1,2
2013-07-22 06:35:54,0.39622685185185186,1,25,10,35
2013-07-21 15:37:08,0.023344907407407408,1,1,1,2
2013-07-14 13:42:37,0.26221064814814815,1,1,0,1
2013-07-15 06:12:31,2.192858796296296,1,20,3,23
2013-08-11 10:13:09,29.653657407407408,3,112,42,154
2013-07-11 19:51:38,0.11266203703703703,2,2,9,11
2013-07-11 21:10:59,1.2679398148148149,1,6,3,9
2013-07-09 18:47:28,0.05797453703703704,2,9,6,15
2013-07-23 01:04:25,131.0758449074074,7,23202,3181,26383
2013-07-07 14:14:25,8.014618055555555,4,119,310,429
2013-07-01 18:36:07,0.8054629629629629,1,8,1,9
2013-06-29 21:45:16,2.877673611111111,6,66,10,76
2013-06-29 21:25:14,1.7202777777777778,1,22,12,34
2013-08-07 09:20:50,250.77493055555556,7,263,95,358
2013-06-24 18:54:14,1.6643287037037038,5,12037,12010,24047
2013-06-22 12:59:52,25.587858796296295,1,32,16,48
2013-06-24 20:13:43,3.713425925925926,1,30,23,53
2013-08-08 20:34:28,52.80519675925926,14,1096,735,1831
2013-06-27 21:50:08,9.199872685185186,8,50590,33,50623
2013-06-18 19:48:19,0.3658449074074074,1,1,1,2
2013-06-24 22:37:33,8.16332175925926,26,2478,1000,3478
2013-06-18 14:47:16,0.4311226851851852,1,4,4,8
2013-06-15 18:39:26,2.0112152777777776,1,7,8,15
2013-06-13 17:18:26,0.6153125,1,1,2,3
2013-06-16 12:35:24,3.463344907407407,3,36,23,59
2013-06-19 16:52:37,7.63244212962963,7,12688,14,12702
2013-08-07 19:22:29,62.31053240740741,1,644,491,1135
2013-06-13 09:09:38,2.125115740740741,1,49,22,71
2013-06-14 18:07:07,4.543483796296297,1,69,19,88
2013-07-01 19:52:09,21.960381944444446,4,38,33,71
2013-06-09 19:58:47,0.224375,1,10,15,25
2013-06-11 03:40:24,1.9257291666666667,1,63,1,64
2013-06-19 16:27:10,11.752418981481481,2,87,37,124
2013-06-11 03:28:12,2.548576388888889,4,30,6,36
2013-06-09 14:04:56,4.370578703703703,15,340,206,546
2013-06-06 06:23:11,0.10822916666666667,1,3,0,3
2013-06-02 21:28:00,0.013587962962962963,1,7,7,14
2013-06-02 21:51:55,1.255,5,48,66,114
2013-06-16 11:03:15,15.175717592592592,5,215,93,308
2013-06-04 20:17:44,3.5826273148148147,2,10,9,19
2013-06-04 08:41:16,4.24644675925926,5,14785,5557,20342
2013-05-25 16:02:07,0.20457175925925927,1,3,1,4
2013-05-25 16:08:24,0.24840277777777778,3,50,8,58
2013-05-24 07:26:48,0.38969907407407406,1,4,1,5
2013-08-15 19:53:09,85.75496527777777,1,477,33,510
2013-05-22 21:32:50,0.9607638888888889,1,8,5,13
2013-05-20 18:34:16,0.021006944444444446,1,82,29,111
2013-05-20 08:06:50,0.14912037037037038,1,0,2,2
2013-05-20 08:23:32,0.373599537037037,1,2,1,3
2013-06-18 15:00:39,31.705335648148147,6,375,98,473
2013-05-19 12:14:58,0.5149768518518518,3,198,6,204
2013-05-19 20:43:53,1.6593287037037037,2,63,13,76
2013-05-19 11:46:05,1.2986226851851852,1,7,1,8
2013-05-19 11:44:40,1.2956828703703704,1,19,15,34
2013-05-19 11:32:37,2.6943171296296295,4,20,12,32
2013-05-19 21:49:55,8.98324074074074,4,65,29,94
2013-05-19 09:44:24,3.381412037037037,1,2,2,4
2013-05-19 11:02:51,9.575266203703704,4,112,81,193
2013-05-25 12:03:50,13.476053240740741,9,685,88,773
2013-05-31 17:54:50,23.945717592592594,4,614,101,715
2013-05-11 10:29:24,0.5928009259259259,1,94,0,94
2013-05-10 17:29:09,0.8186574074074074,1,2,1,3
2013-05-29 17:13:44,38.915601851851854,15,219,62,281
2013-05-09 20:04:33,0.3606828703703704,1,23,16,39
2013-05-09 10:33:21,0.0030902777777777777,1,13,3,16
2013-05-09 16:09:49,0.6923032407407408,1,13,1,14
2013-05-08 18:00:33,0.032442129629629626,1,27,1,28
2013-05-11 22:32:00,3.884351851851852,3,42,23,65
2013-05-07 21:24:06,0.0578587962962963,1,1,1,2
2013-05-19 16:21:02,11.925543981481482,2,126,5,131
2013-05-10 17:23:51,5.790266203703704,21,1563,565,2128
2013-05-20 12:16:53,91.38142361111112,1,11,0,11
2013-05-06 19:24:36,17.76457175925926,13,8268,5443,13711
2013-05-05 21:49:57,0.4341087962962963,2,43,27,70
2013-05-05 15:17:08,0.8063078703703703,6,103,50,153
2013-06-05 19:11:41,32.954664351851854,7,388,51,439
2013-05-03 17:42:34,0.379375,2,32,12,44
2013-05-05 20:45:05,4.067476851851852,4,74,107,181
2013-05-03 17:10:51,2.3125925925925928,6,640,55,695
2013-05-01 10:24:41,0.06685185185185186,1,0,2,2
2013-05-04 22:28:39,5.079710648148148,1,2,1,3
2013-04-30 23:48:40,1.4924305555555555,1,2,0,2
2013-04-28 12:47:08,0.6783564814814815,2,20,4,24
2013-04-26 07:30:04,0.3400462962962963,1,1,1,2
2013-04-25 08:55:57,0.41173611111111114,2,405,5,410
2013-04-23 18:37:14,0.04185185185185185,1,2,16,18
2013-05-02 17:13:26,9.774583333333334,1,2,2,4
2013-04-22 21:51:27,1.5740277777777778,1,179,172,351
2013-05-04 17:29:12,14.040787037037036,8,418,48,466
2013-04-30 07:55:31,11.3665625,10,186,104,290
2013-05-05 21:52:45,23.504803240740742,25,5049,3100,8149
2013-05-05 21:18:36,19.104594907407407,1,25,106,131
2013-04-17 20:54:05,1.1216319444444445,4,25,5,30
2013-04-17 21:05:33,1.9317939814814815,1,11,3,14
2013-04-14 09:48:31,0.3378125,1,1,42,43
2013-05-06 21:35:08,29.291770833333334,17,348,104,452
2013-04-13 19:05:50,0.019421296296296298,1,2,0,2
2013-04-28 21:06:59,18.137881944444445,7,159,45,204
2013-04-17 18:07:29,5.068645833333333,2,13,7,20
2013-04-14 11:36:10,1.8615972222222221,1,36,8,44
2013-05-27 20:19:02,49.01931712962963,3,78,60,138
2013-04-14 16:00:51,8.148206018518518,2,31,10,41
2013-04-14 13:06:38,7.8490625,1,6,9,15
2013-04-07 23:13:49,12.071828703703703,5,1076,59,1135
2013-05-25 17:02:24,49.938715277777774,3,383,89,472
2013-04-06 21:54:32,2.7385069444444445,6,67,59,126
2013-04-04 17:15:03,0.7923958333333333,1,8,3,11
2013-04-05 21:27:32,2.0867708333333335,1,4,7,11
2013-04-02 06:00:58,0.2175462962962963,1,2,0,2
2013-04-01 20:25:04,1.0283796296296297,2,9,9,18
2013-04-01 20:28:34,1.082962962962963,1,3,2,5
2013-04-01 20:21:35,1.231712962962963,1,9,20,29
2013-03-30 14:11:50,0.5499652777777778,1,94,85,179
2013-03-30 14:36:06,4.140185185185185,3,2134,1110,3244
2013-03-29 20:57:02,0.9385648148148148,1,12,3,15
2013-03-29 12:57:36,0.9533333333333334,5,249,162,411
2013-03-27 21:26:19,0.622175925925926,1,38,42,80
2013-03-31 17:30:11,5.6948032407407405,1,8,21,29
2013-03-27 03:13:20,0.4142476851851852,2,23,10,33
2013-03-26 20:10:33,0.31275462962962963,2,12,1,13
2013-03-29 17:31:08,4.493912037037037,2,81,11,92
2013-05-05 10:27:02,41.90210648148148,6,137,28,165
2013-03-24 13:04:17,0.8351157407407407,13,240,200,440
2013-03-21 20:56:54,2.0340277777777778,7,69,13,82
2013-04-01 20:19:45,16.87878472222222,2,568,560,1128
2013-03-24 23:06:22,9.046979166666667,1,1,1,2
2013-09-22 13:05:53,209.7900462962963,5,614,6,620
2013-03-16 14:11:34,2.2271296296296295,6,259,21,280
2013-03-21 21:44:11,7.879467592592593,1,10,2,12
2013-03-21 21:22:14,7.898310185185185,5,291,41,332
2013-03-24 11:12:39,11.648935185185184,2,419,320,739
2013-03-24 14:11:31,29.523935185185184,3,5,5,10
2013-03-22 08:19:54,13.949722222222222,9,2338,1078,3416
2013-03-11 18:54:53,5.7198726851851855,4,299,33,332
2013-03-11 19:23:30,5.764050925925926,3,14,2,16
2013-03-11 18:57:52,7.0147916666666665,1,13,9,22
2013-03-08 18:33:19,6.135162037037037,1,7,4,11
2013-03-11 19:38:08,11.057847222222222,1,44,28,72
2013-03-24 11:59:26,42.978043981481484,10,79,77,156
2013-02-27 18:47:53,4.431747685185186,4,58,34,92
2013-03-10 19:21:19,12.062013888888888,3,38,5,43
2013-03-11 20:48:16,13.136724537037036,1,91,6,97
2013-02-26 17:30:53,0.042534722222222224,1,2,2,4
2013-03-24 13:05:43,26.97228009259259,3,13,5,18
2013-03-05 20:33:51,8.977847222222222,4,171,51,222
2013-02-23 14:15:12,0.6597569444444444,1,1,2,3
2013-02-22 20:56:43,0.055081018518518515,1,10,3,13
2013-02-25 21:29:14,6.885752314814815,3,69,78,147
2013-02-22 21:03:36,1.3831481481481482,2,29,14,43
2014-02-02 11:49:29,615.0566319444445,18,276166,93541,369707
2013-02-22 21:04:47,4.857754629629629,1,42,29,71
2013-02-23 20:35:03,5.728634259259259,1,16,12,28
2013-02-18 22:08:19,0.8336689814814815,1,1,2,3
2013-02-17 13:22:31,0.6093402777777778,1,10,10,20
2013-02-16 12:08:44,0.7453472222222223,2,274,339,613
2013-02-13 22:26:59,0.1280787037037037,4,43,44,87
2013-03-11 20:27:44,27.74892361111111,1,43,49,92
2013-02-12 21:30:11,1.9866550925925925,3,51,44,95
2013-02-14 19:56:44,5.0322453703703705,11,5090,43,5133
2013-02-12 20:18:42,792.9735416666666,2,17,4,21
2013-02-11 20:55:51,792.8589583333334,1,40,9,49
2013-03-10 19:04:37,31.13261574074074,38,1331,1112,2443
2013-02-14 07:11:22,7.1599305555555555,1,8,0,8
2013-02-06 19:12:04,0.028668981481481483,1,23,74,97
2013-02-06 18:18:19,0.24585648148148148,1,2,2,4
2013-02-05 21:07:05,0.05505787037037037,4,11,118,129
2013-02-05 20:43:54,0.08596064814814815,9,106,89,195
2013-02-05 18:56:24,0.061689814814814815,1,3,19,22
2013-02-14 03:06:49,8.60138888888889,9,268,126,394
2013-02-05 08:31:34,0.19399305555555554,1,1,1,2
2013-02-04 20:30:41,0.28734953703703703,1,27,28,55
2013-02-03 22:09:33,1.1675694444444444,1,6,24,30
2013-02-03 16:38:51,0.07716435185185185,1,1,0,1
2013-02-03 18:50:02,0.8457523148148148,1,5,5,10
2013-02-03 22:04:48,1.0835532407407407,1,4,4,8
2013-02-02 20:13:38,0.0880324074074074,2,75,81,156
2013-01-31 18:09:50,0.9756134259259259,1,1,1,2
2013-01-30 20:16:51,2.458877314814815,2,1539,1410,2949
2013-01-27 17:22:43,0.019224537037037037,1,13,7,20
2013-01-27 16:31:01,0.9561342592592592,1,45,1,46
2013-02-14 20:38:30,25.148900462962963,13,3824,2884,6708
2013-01-25 20:36:10,3.362974537037037,2,17,17,34
2013-02-16 16:17:11,56.80890046296296,13,7766,197627,205393
2013-02-04 21:27:15,11.904884259259259,1,7,2,9
2013-01-23 22:46:32,0.22225694444444444,1,1,1,2
2013-02-03 16:37:30,13.79568287037037,4,127,67,194
2013-01-20 11:06:09,14.943067129629629,43,4674,3957,8631
2013-01-05 18:01:46,0.188125,1,2,1,3
2013-02-05 21:20:47,31.335069444444443,1,10,3,13
2013-01-04 16:28:50,3.080416666666667,2,14,13,27
2013-02-02 13:48:23,37.94171296296296,1,5,4,9
2012-12-21 21:16:46,0.7285069444444444,1,10,9,19
2012-12-19 19:14:32,0.2755787037037037,1,2,2,4
2012-12-21 17:09:09,3.2994791666666665,1,13,9,22
2012-12-17 21:35:57,0.030891203703703702,2,13,8,21
2012-12-16 17:24:29,0.09699074074074074,2,1359,1385,2744
2012-12-16 13:40:01,0.13684027777777777,1,17,10,27
2012-12-15 12:30:31,0.7320023148148148,4,79,43,122
2012-12-14 09:29:47,17.335127314814816,1,38,38,76
2012-12-19 19:44:59,7.066111111111111,1,20,20,40
2012-12-16 13:40:53,4.617025462962963,1,2,0,2
2012-12-11 22:53:33,0.07189814814814814,1,1,1,2
2012-12-12 21:13:18,1.0255671296296296,1,16,5,21
2012-12-17 21:27:24,11.930243055555556,63,49787,35900,85687
2012-12-09 09:56:17,2.9870023148148146,1,66,1,67
2013-02-06 19:56:02,63.11019675925926,1,104,53,157
2013-01-05 13:50:51,32.50643518518518,17,1031,378,1409
2012-12-02 18:58:10,0.2114699074074074,1,7,2,9
2012-12-03 20:46:36,2.0687037037037035,5,10303,10408,20711
2012-12-03 15:40:05,3.652511574074074,2,9,4,13
2013-02-10 22:32:19,75.07185185185185,4,187,89,276
2012-11-18 21:15:43,0.2296527777777778,4,687,642,1329
2012-11-25 15:55:34,7.7559606481481485,2,145,592,737
2012-11-27 20:29:00,10.311886574074075,2,0,376,376
2012-11-25 14:34:16,9.449398148148148,3,3,3,6
2012-11-17 12:50:30,1.3863657407407408,2,14,7,21
2012-11-17 09:37:14,28.307881944444443,1,116,69,185
2012-11-16 05:02:17,3.9338194444444445,5,1189,360,1549
2012-11-04 17:24:55,0.006527777777777778,1,1,1,2
2012-11-03 14:05:32,0.7044444444444444,3,87,87,174
2012-11-03 14:26:04,4.6873148148148145,1,5,1,6
2013-04-04 17:12:01,163.8195949074074,11,522,569,1091
2012-12-01 16:17:27,45.64905092592593,15,8815,4473,13288
2013-02-03 20:22:11,119.23621527777777,26,1910,888,2798
2012-11-11 21:30:31,35.321875,29,10950,7375,18325
2012-10-18 19:17:30,11.813622685185186,21,27837,22333,50170
2012-10-10 18:18:45,4.285069444444445,3,851,319,1170
2012-10-30 21:28:43,27.101828703703703,1,6,4,10
2012-10-22 17:17:09,31.121921296296296,8,111,49,160
2012-09-29 13:54:21,4.885115740740741,1,3,3,6
2012-10-05 20:31:29,10.772847222222222,3,215,214,429
2012-09-23 17:34:53,4.685219907407407,1,3,3,6
2012-09-21 18:33:59,0.05137731481481481,1,1,1,2
2012-09-21 18:38:26,2.9881828703703706,2,80,80,160
2012-09-17 19:44:26,1.0477546296296296,1,2,2,4
2012-09-17 18:48:21,1.0296180555555556,1,2,2,4
2012-09-22 09:47:13,6.138518518518518,4,28,25,53
2012-11-04 16:33:30,51.1177662037037,7,233,94,327
2012-09-14 19:08:29,0.9308449074074074,5,113,120,233
2012-09-13 19:59:36,1.003113425925926,3,4754,4384,9138
2012-09-12 17:29:12,1.2000694444444444,1,0,18,18
2012-09-13 20:42:10,5.225219907407407,2,103,65,168
2012-09-08 09:14:32,9.678472222222222,1,4,4,8
2012-08-29 14:29:25,0.15416666666666667,4,18,3,21
2012-09-18 00:34:36,20.87576388888889,8,279,133,412
2012-08-28 16:40:16,1.1282407407407407,1,1,1,2
2012-08-27 18:47:42,1.147164351851852,2,22,22,44
2012-08-27 18:50:46,1.133287037037037,1,7,6,13
2012-08-27 18:53:14,1.1422106481481482,2,26,1,27
2012-09-13 20:36:46,18.347569444444446,1,10,8,18
2012-08-25 14:37:08,3.9777199074074074,1,1,1,2
2012-08-25 14:39:49,8.705289351851851,1,13,10,23
2012-08-26 11:57:55,10.644733796296297,1,13,9,22
2012-08-25 16:19:27,13.469560185185186,22,1053,614,1667
2012-08-10 13:19:39,0.08929398148148149,3,19,9,28
2012-08-29 03:19:45,21.02650462962963,10,1148,708,1856
2012-08-06 20:11:36,2.327824074074074,1,23,14,37
2012-07-29 21:26:32,1.361724537037037,1,1,1,2
2012-08-01 18:41:29,6.849270833333334,1,4,4,8
2012-07-24 21:09:34,0.6750578703703703,1,4,4,8
2012-09-21 18:48:22,62.13620370370371,1,263,2,265
2012-07-20 15:58:06,0.3727662037037037,1,1,1,2
2012-07-23 10:27:22,5.537673611111111,1,12,4,16
2012-07-17 17:00:28,3.089988425925926,1,73,46,119
2012-08-25 14:29:40,48.77079861111111,2,99,53,152
2012-07-07 09:32:53,0.48150462962962964,1,2,2,4
2012-07-10 14:59:30,9.589502314814816,2,11,5,16
2012-09-08 09:25:47,71.64784722222223,1,49,3,52
2012-07-17 17:37:11,19.027858796296297,1,4,5,9
2012-07-17 17:37:54,19.910520833333333,1,2,2,4
2012-11-02 21:03:10,141.53399305555556,3,89,4,93
2012-06-10 22:25:13,0.13310185185185186,2,16,2,18
2012-06-10 22:31:02,0.16435185185185186,1,161,73,234
2012-06-10 08:23:27,0.3589236111111111,1,1,1,2
2012-06-10 08:00:34,0.37484953703703705,1,25,10,35
2012-06-08 01:13:44,0.028668981481481483,1,4,1,5
2012-06-09 08:06:49,2.483923611111111,1,19,7,26
2012-06-09 08:02:25,3.4732523148148147,3,2217,1471,3688
2012-06-07 06:33:16,0.6886574074074074,1,1,1,2
2012-06-07 06:40:47,1.4936574074074074,4,134,125,259
2012-06-04 21:33:29,0.054421296296296294,3,1758,14138,15896
2012-06-03 20:06:11,2.8545023148148148,1,2,2,4
2012-06-05 20:12:26,8.613472222222223,8,1212,552,1764
2012-06-03 20:35:16,14.052291666666667,4,197,14,211
2012-05-20 11:38:34,0.03802083333333333,1,26,4,30
2013-02-05 20:41:42,261.89491898148145,11,843,752,1595
2012-06-09 17:52:05,20.824189814814815,1,35,11,46
2012-06-05 15:41:50,16.74525462962963,1,37,14,51
2012-06-09 18:55:36,21.36681712962963,11,469,388,857
2012-05-20 16:06:45,2.8144791666666666,1,6,0,6
2012-05-14 19:22:28,0.19238425925925925,1,1,1,2
2012-05-27 16:38:33,94.82608796296296,6,23717,5192,28909
2013-01-27 14:56:29,280.7553472222222,4,21178,6081,27259
2012-05-14 19:41:27,4.863368055555555,1,0,12,12
2012-05-27 16:32:10,125.98008101851852,5,83,23,106
2012-05-08 03:04:00,3.4514699074074073,2,6,1,7
2012-06-03 20:26:44,41.63115740740741,3,43,11,54
2012-06-04 16:15:32,48.093333333333334,15,1190,410,1600
2012-04-27 06:15:33,12.687685185185185,10,248,171,419
2012-06-03 20:15:44,59.57453703703704,1,421,177,598
2012-04-04 20:49:16,1.235,1,6,6,12
2012-05-05 15:06:55,34.03753472222222,4,113,43,156
2012-06-02 14:32:26,74.76255787037037,13,731,179,910
2012-04-14 21:40:52,31.836886574074075,9,362,77,439
2012-03-12 04:50:32,1.3288078703703703,1,6,4,10
2012-03-12 15:53:59,6.960625,4,89,28,117
2012-03-12 15:32:58,6.9760532407407405,4,25,15,40
2012-03-05 20:52:06,0.7962962962962963,1,16,38,54
2012-03-12 20:10:54,12.022673611111111,3,32,18,50
2012-03-02 00:54:21,7.221631944444445,2,24,2,26
2012-03-10 13:49:29,22.75619212962963,3,795,669,1464
2012-02-18 11:57:04,2.5493055555555557,2,20,3,23
2012-02-15 03:24:40,0.0512962962962963,1,1,1,2
2012-02-13 14:38:36,6.9539583333333335,5,182,234,416
2012-02-09 20:48:03,102.23587962962964,2,31,13,44
2012-02-05 20:10:17,34.00918981481482,2,62,11,73
2012-01-29 18:10:01,6.6406018518518515,1,16,0,16
2012-02-06 01:03:24,14.76898148148148,5,9782,8527,18309
2012-01-18 09:50:24,0.14878472222222222,1,2,2,4
2012-01-16 19:21:05,11.219675925925927,3,149,136,285
2012-01-22 05:32:14,52.433252314814816,7,831,106,937
2012-01-19 04:44:27,8.181099537037037,14,593,390,983
2012-01-21 21:55:21,15.815138888888889,5,20,23,43
2012-01-05 22:52:10,0.1220949074074074,3,144,39,183
2012-01-06 21:17:38,1.1455902777777778,1,10,2,12
2012-01-06 21:43:53,7.238402777777778,2,112,16,128
2012-05-07 15:57:06,135.97430555555556,56,103228,52425,155653
2011-11-14 12:54:11,2.394039351851852,1,7,8,15
2011-11-26 16:59:46,16.87988425925926,1,89,43,132
2011-11-27 00:34:49,24.048900462962962,1,9,4,13
2012-02-29 21:18:50,120.82621527777778,16,881,344,1225
2011-12-29 10:17:23,72.56297453703704,28,1421,557,1978
2011-10-07 05:45:34,5.574270833333333,3,43,43,86
2011-11-07 08:25:00,61.732013888888886,2,391,421,812
2011-08-29 13:23:13,2.631238425925926,3,93,15,108
2011-08-22 16:25:28,1.7169328703703703,11,302,32,334
2011-08-10 20:40:32,1.6736226851851852,1,18,0,18
2012-11-24 10:15:05,484.5000925925926,3,654,242,896
2011-07-22 20:03:52,1.209513888888889,3,213,23,236
2011-07-22 21:11:49,0.010069444444444445,1,20,129,149
2011-07-23 16:50:32,3.217928240740741,2,24,9,33
2011-07-24 20:21:34,12.275787037037038,1,92,85,177
2011-07-26 17:30:22,33.23266203703704,5,91,16,107
2011-08-28 09:46:19,94.73883101851852,1,29,6,35
2011-05-22 04:32:56,0.005706018518518518,1,113,97,210
2011-05-18 17:27:11,1.132488425925926,1,13,1,14
2011-05-23 19:03:24,85.31920138888889,16,352,189,541
